rated,turns,time_increment,white_rating,black_rating,rank_diff,opening_code,opening_moves,victory_status,winner
FALSE,13,15+2,1500,1191,309,D10,5,Out of Time,White
TRUE,16,5+10,1322,1261,61,B00,4,Resign,Black
TRUE,61,5+10,1496,1500,-4,C20,3,Mate,White
TRUE,61,20+0,1439,1454,-15,D02,3,Mate,White
TRUE,95,30+3,1523,1469,54,C41,5,Mate,White
FALSE,5,10+0,1250,1002,248,B27,4,Draw,Draw
TRUE,33,10+0,1520,1423,97,D00,10,Resign,White
FALSE,9,15+30,1413,2108,-695,B00,5,Resign,Black
TRUE,66,15+0,1439,1392,47,C50,6,Resign,Black
TRUE,119,10+0,1381,1209,172,B01,4,Mate,White
FALSE,39,20+60,1381,1272,109,A00,1,Mate,White
FALSE,38,20+60,1381,1867,-486,C02,9,Resign,Black
FALSE,60,5+40,1381,1936,-555,C00,3,Resign,Black
FALSE,31,8+0,1381,1607,-226,C00,2,Resign,Black
FALSE,31,15+15,1094,1141,-47,C50,8,Mate,White
FALSE,43,15+15,1141,1094,47,C57,7,Resign,Black
FALSE,52,15+15,1094,1141,-47,C50,8,Resign,Black
FALSE,66,15+16,1141,1094,47,C50,8,Mate,Black
FALSE,101,15+15,1094,1300,-206,C41,5,Resign,Black
FALSE,25,11+0,1500,1094,406,D00,2,Resign,White
FALSE,14,15+15,1094,1676,-582,C55,6,Resign,Black
FALSE,3,30+60,1094,1068,26,A40,2,Resign,White
FALSE,17,15+5,1500,1094,406,B20,3,Resign,White
TRUE,36,10+0,1307,1106,201,A25,4,Resign,White
TRUE,13,10+0,1113,1423,-310,B21,3,Resign,Black
TRUE,69,10+10,1078,1219,-141,D01,4,Mate,White
TRUE,43,10+10,1825,1079,746,C45,8,Resign,White
TRUE,54,10+10,1328,1038,290,D01,4,Mate,Black
TRUE,53,10+10,1056,1156,-100,D10,4,Resign,Black
TRUE,66,10+10,1077,1148,-71,D06,4,Mate,Black
TRUE,64,10+10,1358,1036,322,B21,3,Resign,Black
TRUE,64,10+10,1200,1002,198,B52,6,Mate,Black
TRUE,54,10+10,1203,1019,184,B27,3,Resign,White
FALSE,21,15+3,1019,1500,-481,D20,6,Resign,Black
FALSE,11,18+0,1422,975,447,B20,3,Resign,White
TRUE,19,10+0,976,1832,-856,B06,4,Resign,Black
TRUE,28,10+0,1569,978,591,D00,10,Resign,White
FALSE,22,15+0,978,1500,-522,A45,2,Resign,Black
FALSE,37,15+0,1500,978,522,B77,17,Resign,White
FALSE,34,30+30,2449,978,1471,A21,3,Resign,White
FALSE,32,20+25,1207,978,229,B70,10,Draw,Draw
FALSE,71,5+5,1241,978,263,B23,3,Resign,Black
FALSE,30,30+0,1500,978,522,B21,3,Resign,White
FALSE,66,40+40,2443,978,1465,B76,17,Resign,White
FALSE,41,20+0,1500,978,522,B21,3,Resign,White
FALSE,49,15+0,1500,978,522,B20,3,Resign,White
FALSE,3,15+0,978,1500,-522,B01,2,Resign,Black
FALSE,7,10+0,1343,978,365,B20,3,Resign,White
FALSE,35,40+40,2436,978,1458,B77,17,Mate,White
FALSE,41,40+40,2436,978,1458,B01,4,Mate,White
FALSE,5,10+0,978,1500,-522,C00,3,Resign,Black
FALSE,7,10+0,1500,978,522,C21,4,Resign,White
FALSE,53,10+0,978,1500,-522,A80,2,Mate,White
FALSE,36,10+0,1500,978,522,A20,2,Resign,Black
TRUE,8,16+0,1521,1162,359,A04,2,Resign,White
TRUE,3,6+10,1407,1500,-93,B23,3,Resign,White
TRUE,28,10+0,1492,1458,34,C26,5,Resign,White
TRUE,30,10+0,1414,1442,-28,C41,8,Resign,Black
TRUE,44,10+0,1457,1294,163,C44,5,Resign,Black
TRUE,29,10+0,1525,1466,59,C41,6,Resign,White
TRUE,37,8+10,1207,1579,-372,C00,3,Resign,Black
TRUE,49,8+12,1567,1573,-6,A40,2,Resign,White
TRUE,32,8+12,1578,1605,-27,A40,2,Resign,Black
TRUE,25,8+12,1939,1581,358,E10,6,Resign,White
TRUE,40,5+10,1618,1568,50,C00,2,Mate,Black
TRUE,39,7+12,1755,1574,181,A04,2,Resign,White
TRUE,57,15+10,1561,1596,-35,A45,2,Resign,White
TRUE,78,5+40,1500,1554,-54,C00,3,Resign,Black
TRUE,61,15+5,1544,1461,83,D00,3,Resign,White
TRUE,44,20+5,1563,1335,228,D00,3,Resign,Black
TRUE,62,20+5,1579,1470,109,A41,2,Mate,Black
TRUE,87,20+5,1617,1590,27,A45,2,Mate,White
TRUE,54,20+5,1207,1588,-381,C02,7,Mate,Black
TRUE,54,15+5,1595,1547,48,D00,3,Resign,Black
TRUE,37,15+5,1855,1599,256,C01,5,Resign,White
TRUE,50,15+5,1589,1547,42,A40,2,Resign,White
TRUE,131,30+0,1571,1728,-157,D02,5,Resign,White
TRUE,48,30+0,1720,1579,141,C00,3,Resign,White
TRUE,47,15+5,1579,2105,-526,D02,5,Resign,Black
TRUE,64,15+5,1768,1560,208,C00,3,Mate,Black
TRUE,61,15+5,1552,1436,116,D00,3,Resign,White
TRUE,57,15+5,1536,1667,-131,D02,5,Mate,White
TRUE,51,15+5,1521,1549,-28,A10,2,Resign,White
TRUE,58,15+5,1251,1545,-294,A00,3,Mate,Black
TRUE,71,15+5,1537,1408,129,D00,3,Resign,White
TRUE,114,15+5,1522,1512,10,A40,1,Resign,White
TRUE,39,15+5,1602,1532,70,C18,11,Resign,White
TRUE,20,15+5,1543,1593,-50,D02,5,Resign,Black
TRUE,48,30+0,1556,1539,17,D00,3,Resign,Black
TRUE,34,20+10,1409,1548,-139,C00,3,Mate,Black
TRUE,51,20+10,1539,1418,121,D02,5,Resign,White
TRUE,69,20+10,1603,1550,53,C00,3,Resign,White
TRUE,28,20+10,1542,1399,143,D00,4,Resign,White
TRUE,62,20+10,1546,1877,-331,D02,5,Resign,Black
TRUE,62,20+10,1134,1535,-401,A47,4,Mate,Black
TRUE,85,20+10,1513,1784,-271,A40,2,Mate,White
TRUE,38,20+10,1501,1445,56,D02,5,Resign,White
FALSE,14,45+0,1500,1500,0,C50,8,Resign,White
TRUE,113,15+0,1745,1714,31,D06,4,Draw,Draw
TRUE,62,15+0,1734,1748,-14,D06,4,Resign,White
TRUE,101,10+0,1942,1739,203,C10,6,Resign,White
TRUE,75,10+0,1724,1855,-131,C45,7,Out of Time,White
TRUE,135,10+0,1951,1729,222,C02,11,Mate,White
TRUE,81,10+0,1726,1388,338,C41,5,Out of Time,White
TRUE,46,10+0,1735,1806,-71,D80,6,Resign,Black
TRUE,70,10+0,1597,1728,-131,C00,3,Mate,Black
TRUE,39,10+0,1743,1738,5,C10,10,Resign,White
TRUE,91,10+0,1721,1750,-29,D30,7,Resign,White
TRUE,137,10+0,1746,1487,259,D20,5,Out of Time,White
TRUE,46,10+0,1744,1735,9,C02,9,Resign,Black
TRUE,18,10+0,1749,1631,118,D41,9,Resign,Black
TRUE,28,10+0,1769,1396,373,D20,5,Resign,Black
TRUE,40,5+8,1795,1760,35,A46,5,Resign,Black
TRUE,111,15+0,1729,1795,-66,D31,5,Mate,White
TRUE,54,10+0,1795,1784,11,C64,6,Mate,Black
TRUE,33,10+0,1770,1872,-102,D02,3,Resign,White
TRUE,90,10+0,1783,1721,62,D02,5,Resign,Black
TRUE,90,10+0,1884,1768,116,C64,7,Resign,Black
TRUE,40,10+0,1756,1756,0,C24,5,Mate,Black
TRUE,49,8+0,1724,1958,-234,A43,5,Out of Time,White
TRUE,50,10+0,2036,1706,330,A08,6,Resign,Black
TRUE,59,10+0,1706,925,781,D02,5,Mate,White
TRUE,26,15+15,1244,1219,25,B00,4,Out of Time,Black
TRUE,23,15+15,1215,921,294,C50,5,Mate,White
TRUE,118,15+15,1350,1201,149,B03,5,Mate,Black
TRUE,66,15+15,1210,1280,-70,B29,4,Mate,Black
TRUE,120,15+15,1139,1212,-73,C50,8,Draw,Draw
TRUE,36,15+15,1220,1341,-121,C57,11,Mate,Black
TRUE,26,15+15,1234,1359,-125,C55,6,Mate,Black
TRUE,62,15+15,1275,1236,39,C57,11,Resign,Black
TRUE,37,15+15,1433,1282,151,B02,3,Resign,White
TRUE,24,15+15,1132,1276,-144,D06,4,Resign,Black
FALSE,47,30+2,1276,1308,-32,C55,6,Resign,White
TRUE,37,15+15,1228,1266,-38,B02,7,Resign,Black
TRUE,24,15+15,1273,1409,-136,B13,5,Resign,Black
TRUE,9,15+15,1338,1277,61,D00,3,Resign,White
TRUE,47,15+15,1263,1336,-73,B57,8,Mate,White
TRUE,85,15+15,1316,1273,43,A20,2,Mate,White
TRUE,39,15+15,1248,1253,-5,B00,2,Mate,White
TRUE,58,15+15,1335,1233,102,E20,6,Mate,Black
TRUE,95,15+15,1223,1189,34,C57,11,Mate,White
TRUE,2,15+15,1443,1204,239,B02,2,Resign,Black
TRUE,97,15+15,1227,1216,11,D06,4,Mate,White
TRUE,12,15+15,1215,1219,-4,C50,5,Draw,Draw
TRUE,30,15+15,1227,1227,0,C50,8,Resign,White
TRUE,43,10+0,1550,1225,325,E11,8,Mate,White
TRUE,11,15+15,1325,1234,91,B02,2,Resign,White
TRUE,72,15+15,1212,1221,-9,B02,5,Mate,Black
TRUE,156,15+15,1226,1478,-252,C40,3,Mate,Black
TRUE,18,25+0,1228,1626,-398,D30,4,Resign,Black
FALSE,77,10+2,1191,1228,-37,C11,7,Mate,White
TRUE,32,30+0,1422,1210,212,B02,5,Resign,Black
TRUE,35,15+15,1186,1223,-37,C28,5,Resign,White
TRUE,85,15+15,1212,1212,0,B06,2,Mate,White
TRUE,50,15+15,1228,1343,-115,B01,6,Resign,Black
TRUE,111,10+10,1865,1862,3,A46,5,Resign,White
TRUE,65,7+2,1852,1852,0,B30,5,Out of Time,White
TRUE,73,15+0,1833,1863,-30,A56,4,Resign,White
TRUE,125,15+0,1851,1918,-67,B27,4,Resign,White
TRUE,76,15+0,1861,1844,17,C55,6,Resign,Black
TRUE,65,10+0,1853,1774,79,C65,6,Out of Time,White
TRUE,41,10+0,1910,1862,48,B90,11,Mate,White
TRUE,59,10+0,1851,1890,-39,C00,3,Resign,White
TRUE,70,15+5,1860,1840,20,B50,5,Resign,Black
TRUE,34,25+25,1828,1848,-20,B51,5,Resign,White
TRUE,69,8+0,1855,1858,-3,E00,1,Out of Time,White
TRUE,63,10+10,1847,1895,-48,C70,8,Resign,White
TRUE,107,10+10,1885,1856,29,B50,4,Resign,White
TRUE,58,30+0,1847,1802,45,A40,1,Resign,White
FALSE,34,20+5,1847,1856,-9,B11,6,Resign,Black
TRUE,100,15+0,1840,1837,3,B22,3,Out of Time,Black
TRUE,80,5+5,1848,1806,42,B40,4,Resign,Black
TRUE,44,15+0,1860,1820,40,C00,3,Resign,Black
TRUE,40,10+0,1854,1849,5,A45,3,Out of Time,Black
TRUE,105,10+0,1895,1859,36,B50,4,Out of Time,White
TRUE,50,15+0,1866,1965,-99,B31,6,Resign,Black
FALSE,144,10+0,1866,1843,23,B50,4,Out of Time,Draw
FALSE,81,10+0,1835,1866,-31,B18,11,Resign,Black
TRUE,69,15+0,1877,1860,17,C61,6,Resign,Black
TRUE,77,7+8,1849,1874,-25,B90,11,Mate,White
TRUE,158,6+6,1835,1865,-30,E10,6,Mate,Black
TRUE,107,15+5,1866,1835,31,C55,7,Draw,Draw
TRUE,117,15+0,1856,1829,27,C78,12,Mate,White
TRUE,44,10+0,1845,1846,-1,C70,8,Resign,White
TRUE,40,15+0,1834,1835,-1,B30,4,Resign,Black
TRUE,59,15+5,1846,1845,1,B10,2,Resign,White
FALSE,110,10+0,1845,1917,-72,D06,4,Resign,Black
TRUE,30,15+0,1858,1790,68,B01,4,Resign,Black
TRUE,54,10+0,1871,1847,24,B30,4,Resign,Black
TRUE,69,10+0,1846,1869,-23,C41,5,Resign,Black
TRUE,178,16+0,1843,1836,7,B22,3,Mate,Black
TRUE,136,15+0,1800,1826,-26,B20,2,Resign,Black
FALSE,124,8+0,1283,1267,16,B30,5,Mate,Black
TRUE,96,10+4,1290,1270,20,A00,1,Resign,Black
TRUE,53,12+0,1331,1281,50,D00,4,Out of Time,White
TRUE,39,10+0,1304,1292,12,A00,1,Mate,White
TRUE,10,10+0,1305,1293,12,C00,3,Mate,Black
TRUE,51,10+0,1308,1317,-9,C22,8,Mate,White
TRUE,18,15+0,1296,1305,-9,C54,13,Resign,Black
FALSE,106,30+0,968,1305,-337,C50,8,Mate,Black
FALSE,38,15+15,1293,1466,-173,C41,5,Mate,Black
TRUE,59,7+2,1500,1299,201,C68,7,Mate,White
TRUE,111,7+2,1288,1232,56,B12,3,Mate,White
TRUE,28,7+2,1289,2108,-819,C77,9,Resign,Black
FALSE,101,7+2,1431,1289,142,C22,6,Out of Time,White
FALSE,15,7+2,1806,1289,517,C45,7,Mate,White
FALSE,42,7+2,1289,1311,-22,C41,5,Resign,White
FALSE,118,7+2,1431,1289,142,A40,3,Resign,Black
FALSE,34,7+2,1289,1484,-195,C50,6,Resign,Black
FALSE,60,7+2,1289,1810,-521,A42,5,Resign,Black
FALSE,66,7+2,1806,1289,517,C44,5,Resign,Black
FALSE,21,5+8,1289,1500,-211,C41,5,Out of Time,White
TRUE,73,15+1,1409,1297,112,C70,8,Mate,White
TRUE,159,15+1,1280,1485,-205,C55,6,Mate,White
FALSE,74,15+0,1280,1211,69,B01,4,Resign,White
FALSE,28,15+0,1211,1280,-69,A00,3,Mate,Black
TRUE,112,10+0,1281,1765,-484,C41,6,Mate,Black
TRUE,104,15+1,1288,1454,-166,C42,4,Resign,Black
TRUE,40,15+1,1560,1270,290,D07,5,Mate,Black
TRUE,44,15+1,1274,1534,-260,B27,4,Mate,Black
TRUE,150,15+1,1259,1663,-404,C55,6,Draw,Draw
TRUE,60,10+0,1614,1238,376,D02,5,Mate,Black
TRUE,37,10+0,1221,1417,-196,C02,11,Mate,White
TRUE,88,10+0,1222,1732,-510,B32,7,Out of Time,Black
TRUE,113,10+0,1232,1234,-2,C68,7,Mate,White
TRUE,55,20+5,1240,1219,21,C42,8,Mate,White
TRUE,135,10+0,1590,1600,-10,A22,5,Mate,White
TRUE,137,10+0,1568,1617,-49,C50,5,Draw,Draw
TRUE,97,10+0,1500,1358,142,C46,6,Out of Time,White
FALSE,33,10+2,1384,1325,59,B07,2,Resign,Black
FALSE,29,30+0,1384,1265,119,A06,3,Resign,Black
FALSE,55,2+10,1384,1950,-566,A04,2,Resign,Black
TRUE,91,20+10,1377,1249,128,B01,4,Resign,White
TRUE,53,9+0,1375,1389,-14,C20,4,Resign,White
TRUE,49,10+2,1378,1361,17,C41,5,Mate,White
TRUE,48,10+2,1261,1371,-110,B07,4,Mate,Black
TRUE,20,10+9,1380,1429,-49,B30,4,Resign,Black
TRUE,87,10+0,1369,1368,1,C42,6,Mate,White
TRUE,11,10+0,1290,1371,-81,C77,9,Resign,White
TRUE,110,15+3,1372,1326,46,B00,2,Draw,Draw
TRUE,24,6+7,1361,1383,-22,A00,1,Resign,White
TRUE,23,15+15,1217,1399,-182,A22,4,Resign,White
TRUE,81,15+30,1387,1447,-60,C60,5,Mate,White
FALSE,34,20+0,1474,1387,87,B01,2,Resign,Black
TRUE,103,15+2,1377,1351,26,C41,4,Mate,White
TRUE,29,30+10,1389,1339,50,C40,4,Resign,Black
FALSE,22,30+15,1389,1400,-11,C41,4,Resign,Black
FALSE,38,10+0,1849,1389,460,C44,5,Resign,White
TRUE,46,8+0,1395,1378,17,C50,9,Mate,Black
TRUE,23,5+5,1370,1257,113,C61,6,Out of Time,White
TRUE,31,10+3,1360,1332,28,B00,5,Resign,White
FALSE,51,10+0,1311,1360,-49,C21,4,Resign,White
FALSE,87,20+0,1714,1360,354,C64,6,Mate,White
TRUE,31,45+30,1354,1217,137,C50,5,Mate,White
TRUE,38,15+15,1245,1346,-101,D20,5,Resign,Black
FALSE,43,10+4,1346,1099,247,C55,6,Resign,White
TRUE,105,9+2,1336,1287,49,A07,4,Resign,White
FALSE,87,10+0,1580,1555,25,A10,2,Out of Time,White
FALSE,36,10+0,1555,1580,-25,B40,6,Mate,Black
TRUE,38,6+6,1649,1547,102,C02,6,Resign,Black
TRUE,110,8+0,1426,1527,-101,C00,3,Resign,Black
TRUE,48,15+0,1557,1547,10,C70,8,Resign,Black
FALSE,95,5+8,1557,1607,-50,E20,5,Mate,White
FALSE,70,5+8,1607,1557,50,A02,1,Mate,Black
FALSE,42,10+0,1557,1632,-75,B32,7,Resign,White
TRUE,177,10+3,1535,1609,-74,C58,11,Out of Time,White
TRUE,114,10+2,1713,1558,155,A00,2,Mate,Black
TRUE,57,10+2,1497,1730,-233,B00,2,Resign,White
TRUE,57,7+3,1437,1552,-115,C50,5,Resign,White
FALSE,82,10+0,1516,1552,-36,A03,2,Draw,Draw
TRUE,29,7+3,1513,1456,57,B54,5,Mate,White
TRUE,70,10+0,1355,1478,-123,C55,7,Resign,Black
TRUE,97,10+0,1638,1614,24,C55,6,Mate,White
TRUE,99,6+5,1613,1934,-321,B12,11,Resign,White
FALSE,74,10+0,1865,1613,252,D03,5,Resign,Black
TRUE,48,8+0,1776,1587,189,D00,2,Mate,Black
TRUE,77,15+0,1568,1593,-25,C10,6,Mate,White
TRUE,80,15+0,1605,1546,59,B01,6,Resign,Black
TRUE,35,8+0,1518,1709,-191,B00,5,Resign,White
TRUE,33,10+0,1728,1527,201,D31,8,Resign,White
TRUE,87,10+0,1515,1379,136,B01,4,Mate,White
TRUE,40,10+0,1538,1501,37,B06,4,Resign,Black
TRUE,54,10+0,1511,1516,-5,D30,4,Resign,Black
TRUE,67,10+0,1464,1495,-31,C69,9,Resign,Black
TRUE,21,10+0,1470,1475,-5,C40,4,Mate,White
TRUE,14,10+0,1490,1440,50,C50,6,Mate,Black
FALSE,71,15+15,1611,1974,-363,D41,18,Resign,White
TRUE,72,10+0,1611,1945,-334,E20,8,Out of Time,Black
TRUE,62,10+0,1584,1611,-27,A31,5,Resign,Black
TRUE,48,10+0,1942,1611,331,A00,1,Resign,Black
TRUE,6,10+2,1217,1611,-394,C46,6,Out of Time,Black
TRUE,69,20+0,1611,2059,-448,D46,12,Draw,Draw
TRUE,72,15+15,1611,1478,133,B27,4,Resign,White
TRUE,40,15+15,1486,1552,-66,C44,5,Mate,Black
TRUE,29,15+15,1453,1496,-43,B06,2,Mate,White
TRUE,44,15+15,1340,1326,14,A40,2,Resign,White
TRUE,59,10+0,1532,1500,32,C00,3,Mate,White
TRUE,115,10+0,1560,1557,3,C34,6,Resign,White
TRUE,70,10+0,1571,1577,-6,A03,2,Resign,Black
TRUE,36,10+0,1580,1617,-37,A03,2,Resign,Black
TRUE,83,10+0,1531,1593,-62,C46,7,Resign,White
TRUE,99,10+0,1449,1597,-148,C48,9,Draw,Draw
TRUE,43,10+0,1743,1604,139,C34,6,Resign,White
TRUE,89,10+0,1604,1614,-10,C48,8,Resign,White
TRUE,96,10+0,1550,1605,-55,D00,3,Resign,Black
FALSE,116,10+0,1630,1605,25,C42,8,Mate,Black
FALSE,78,15+0,1475,1605,-130,A00,1,Mate,Black
FALSE,77,15+0,1605,1475,130,A02,1,Mate,White
FALSE,70,15+0,1475,1605,-130,C20,3,Mate,Black
FALSE,27,10+0,1570,1605,-35,C42,7,Resign,White
FALSE,102,10+0,1605,1500,105,A02,1,Resign,Black
FALSE,21,10+0,1500,1605,-105,C47,9,Resign,White
FALSE,33,10+0,1605,1500,105,A02,1,Resign,White
FALSE,74,10+0,1513,1605,-92,C42,5,Resign,Black
TRUE,65,25+5,1790,1874,-84,A00,1,Resign,White
TRUE,81,25+5,1864,1805,59,B24,5,Resign,White
TRUE,45,25+5,1496,1861,-365,A45,3,Resign,Black
TRUE,52,25+5,1851,1853,-2,C67,8,Resign,White
TRUE,51,10+0,1861,1863,-2,B11,4,Resign,White
TRUE,48,10+0,1618,1609,9,C00,3,Draw,Draw
TRUE,20,10+0,1620,1607,13,A00,1,Resign,Black
TRUE,50,10+0,1621,1496,125,B30,5,Mate,Black
TRUE,98,10+0,1633,1581,52,C41,5,Resign,Black
TRUE,106,10+0,1623,1623,0,C60,6,Mate,Black
TRUE,19,10+0,1612,1614,-2,C50,5,Resign,White
TRUE,22,10+0,1605,1624,-19,C50,8,Resign,White
TRUE,114,10+0,1693,1621,72,E61,4,Draw,Draw
TRUE,69,10+0,1631,1684,-53,B50,4,Resign,Black
TRUE,34,10+0,1636,1619,17,C53,8,Mate,Black
TRUE,40,10+0,1613,1617,-4,C57,8,Mate,Black
TRUE,108,10+0,1627,1495,132,C50,6,Resign,Black
TRUE,27,10+0,1480,1643,-163,C23,3,Resign,White
TRUE,63,10+0,1631,1652,-21,B30,5,Resign,White
TRUE,31,10+0,1687,1641,46,C44,5,Resign,White
TRUE,71,10+0,1630,1638,-8,C55,6,Resign,White
TRUE,92,10+0,1414,1624,-210,C60,6,Mate,Black
TRUE,47,10+0,1619,1419,200,C57,7,Mate,White
TRUE,56,10+0,1629,1659,-30,C42,5,Resign,Black
TRUE,48,10+0,1649,1639,10,C23,3,Resign,White
TRUE,124,10+0,1677,1627,50,A00,1,Resign,Black
TRUE,49,10+0,1705,1636,69,C45,8,Mate,White
TRUE,64,10+0,1647,1635,12,B96,13,Resign,Black
TRUE,29,10+0,1637,1627,10,C53,7,Resign,White
TRUE,45,10+0,1626,1631,-5,C50,5,Resign,White
TRUE,96,10+0,1602,1615,-13,C34,6,Resign,Black
TRUE,92,10+0,1634,1603,31,C23,3,Resign,Black
TRUE,40,10+0,1611,1591,20,C50,9,Mate,Black
TRUE,123,10+0,1579,1623,-44,C54,19,Mate,White
TRUE,129,10+0,1995,1581,414,A05,4,Mate,White
TRUE,120,10+0,1589,1569,20,D92,9,Mate,Black
TRUE,71,10+0,1570,1555,15,C55,6,Draw,Draw
TRUE,97,10+0,1559,1557,2,C00,3,Mate,White
TRUE,60,10+0,1546,1571,-25,A45,2,Resign,White
TRUE,57,10+0,1550,1567,-17,B21,6,Resign,White
TRUE,38,5+7,1560,1419,141,B12,5,Resign,White
TRUE,111,8+0,1840,1564,276,C45,8,Resign,White
TRUE,119,10+0,1660,1549,111,A49,4,Resign,Black
TRUE,33,10+0,1534,1678,-144,C41,5,Mate,White
TRUE,32,10+0,1789,1538,251,E10,6,Resign,White
TRUE,96,15+0,1841,1921,-80,C22,8,Resign,Black
TRUE,92,8+10,1926,1737,189,A04,2,Draw,Draw
TRUE,64,8+2,1629,1887,-258,D00,3,Resign,Black
TRUE,10,5+5,1860,1712,148,C37,7,Resign,Black
TRUE,85,20+8,1500,1568,-68,A09,4,Resign,White
TRUE,40,10+0,1780,2132,-352,B90,10,Resign,Black
TRUE,58,10+0,966,1124,-158,B01,2,Resign,Black
TRUE,26,15+15,884,951,-67,A01,2,Out of Time,Black
TRUE,4,15+15,945,1070,-125,C40,3,Out of Time,Black
TRUE,118,10+0,971,1149,-178,B00,3,Mate,Black
TRUE,11,15+15,1238,985,253,A00,1,Mate,White
TRUE,163,10+0,972,1247,-275,A20,2,Out of Time,Draw
TRUE,95,10+0,1107,961,146,B00,4,Mate,White
TRUE,37,10+0,974,1129,-155,D00,3,Resign,Black
TRUE,101,10+2,1203,970,233,C21,3,Mate,White
TRUE,80,10+0,998,937,61,C00,5,Out of Time,Black
TRUE,78,10+0,1016,1126,-110,A00,1,Resign,Black
TRUE,89,10+0,1025,1153,-128,C01,4,Out of Time,Draw
TRUE,42,10+0,1047,1151,-104,D02,4,Mate,Black
TRUE,8,10+0,998,1016,-18,C44,6,Out of Time,Black
TRUE,101,10+0,1127,1044,83,C20,3,Out of Time,White
TRUE,65,10+0,1020,1200,-180,D02,3,Out of Time,White
TRUE,60,10+0,1069,1071,-2,D02,4,Mate,Black
TRUE,71,10+0,1071,1068,3,D00,3,Draw,Draw
TRUE,44,10+0,1115,1223,-108,D01,4,Resign,Black
TRUE,20,10+0,1190,1213,-23,D01,4,Resign,Black
TRUE,41,10+0,1337,1337,0,C40,3,Resign,White
TRUE,40,10+0,1500,1500,0,B01,2,Resign,Black
TRUE,27,25+25,1500,1571,-71,C41,7,Resign,White
TRUE,59,15+10,1367,1866,-499,A00,1,Resign,Black
TRUE,19,10+0,1590,1373,217,B00,2,Mate,White
TRUE,50,10+0,1377,1667,-290,A00,1,Mate,Black
TRUE,34,10+0,1558,1358,200,C88,15,Resign,Black
TRUE,15,5+8,1476,1367,109,B00,2,Mate,White
TRUE,52,5+8,1376,1469,-93,A00,1,Resign,Black
TRUE,65,5+8,1460,1386,74,B00,2,Mate,White
TRUE,67,10+0,1372,1408,-36,C41,5,Resign,White
TRUE,31,5+5,1373,2148,-775,B40,4,Resign,Black
FALSE,130,8+0,1500,1395,105,C00,2,Mate,Black
TRUE,125,8+0,1382,1414,-32,C01,5,Mate,White
TRUE,76,15+5,1320,1400,-80,C00,3,Resign,Black
TRUE,121,15+5,1383,1330,53,A46,3,Resign,White
FALSE,53,30+0,1383,1242,141,D02,3,Resign,White
TRUE,116,16+0,1469,1357,112,C02,9,Out of Time,Black
FALSE,47,25+0,959,1357,-398,A00,4,Resign,White
FALSE,53,25+0,1357,959,398,D00,3,Resign,White
FALSE,76,25+0,959,1357,-398,A00,4,Mate,Black
TRUE,110,15+10,1588,1691,-103,C50,8,Draw,Draw
TRUE,67,15+3,1541,1586,-45,B34,9,Mate,White
TRUE,17,30+5,1517,1320,197,C40,4,Resign,White
TRUE,39,25+15,1569,1569,0,A01,2,Mate,White
TRUE,94,30+0,1563,1498,65,C03,5,Resign,Black
TRUE,37,10+10,1903,1512,391,E20,8,Resign,White
TRUE,37,20+0,1612,1450,162,B13,5,Mate,White
FALSE,34,15+15,1327,1450,-123,B00,3,Resign,White
FALSE,41,10+0,1245,1450,-205,B12,5,Out of Time,White
FALSE,30,15+7,1921,1451,470,C40,4,Resign,Black
TRUE,51,10+0,1462,1464,-2,A00,3,Resign,White
TRUE,79,10+0,1450,1486,-36,C33,6,Mate,White
TRUE,83,10+0,1439,1418,21,C33,5,Resign,White
TRUE,14,8+8,1728,1500,228,C55,6,Resign,Black
TRUE,21,10+0,1547,1563,-16,B02,4,Resign,White
TRUE,47,10+0,1863,1567,296,B02,2,Resign,White
TRUE,38,10+0,1559,1423,136,A40,2,Resign,White
TRUE,34,10+0,1570,1611,-41,B06,7,Resign,Black
TRUE,39,10+0,1562,1582,-20,B03,6,Resign,White
TRUE,43,5+9,1576,1386,190,D00,3,Resign,White
TRUE,41,5+8,1353,1595,-242,B10,3,Mate,White
TRUE,49,16+7,1591,1326,265,D00,3,Resign,White
TRUE,38,10+10,1560,1580,-20,B02,4,Out of Time,Black
TRUE,70,5+5,1727,1574,153,B01,4,Out of Time,Black
TRUE,48,10+0,1579,1841,-262,E00,4,Resign,Black
TRUE,50,10+0,1877,1558,319,C11,11,Resign,Black
TRUE,57,10+0,1536,1962,-426,A45,3,Resign,White
TRUE,148,10+0,1529,1763,-234,D00,3,Out of Time,Draw
TRUE,62,10+7,1590,1515,75,B01,4,Mate,Black
TRUE,29,10+0,1653,1522,131,A80,2,Resign,White
TRUE,52,10+0,1675,1505,170,B01,6,Mate,Black
TRUE,26,10+0,1547,1491,56,B01,6,Mate,Black
TRUE,59,10+0,1507,1399,108,A40,2,Resign,Black
TRUE,2,10+0,1641,1502,139,B01,2,Draw,Draw
TRUE,195,10+0,1496,1703,-207,A48,5,Draw,Draw
TRUE,56,10+0,1482,1484,-2,B01,4,Resign,Black
TRUE,40,10+0,1486,1909,-423,A40,2,Resign,Black
TRUE,31,10+0,1919,1488,431,A11,2,Mate,White
TRUE,60,10+0,1488,2192,-704,A45,2,Resign,Black
TRUE,45,10+0,1470,1684,-214,D00,3,Resign,White
TRUE,63,5+8,1465,1659,-194,A81,3,Draw,Draw
TRUE,17,10+0,1586,1473,113,D02,5,Resign,White
TRUE,34,10+0,1548,1488,60,B03,6,Resign,White
TRUE,36,10+0,1500,1501,-1,A45,2,Mate,Black
TRUE,62,10+0,1509,1487,22,B05,8,Mate,Black
TRUE,46,7+5,1356,1491,-135,B01,2,Draw,Draw
TRUE,34,10+0,1495,1771,-276,A45,2,Resign,Black
TRUE,38,5+5,1529,1639,-110,C00,3,Resign,White
TRUE,107,5+5,1631,1537,94,C41,6,Resign,White
TRUE,42,5+5,1546,1621,-75,B54,6,Resign,Black
TRUE,35,5+5,1568,1636,-68,C00,5,Resign,White
TRUE,122,5+5,1354,1631,-277,C00,5,Mate,Black
TRUE,71,5+5,1626,1384,242,B53,7,Mate,White
TRUE,42,5+5,1639,1813,-174,B06,6,Resign,Black
TRUE,2,5+5,1646,1795,-149,D00,2,Out of Time,Black
TRUE,11,5+5,1646,939,707,D10,4,Resign,White
TRUE,54,5+5,1657,1678,-21,B08,8,Resign,Black
TRUE,58,5+5,1667,1668,-1,B06,5,Resign,White
TRUE,42,5+5,1683,1599,84,C30,4,Resign,Black
TRUE,116,5+5,1596,1686,-90,A40,2,Draw,Draw
TRUE,74,5+5,1769,1659,110,A10,2,Mate,Black
TRUE,54,5+5,1668,1761,-93,A40,2,Mate,Black
TRUE,85,5+5,1752,1677,75,A15,2,Resign,White
TRUE,38,5+5,1688,1743,-55,B43,10,Resign,Black
TRUE,41,5+5,1582,1704,-122,C00,3,Resign,White
TRUE,121,5+5,1693,1666,27,B53,7,Mate,White
TRUE,30,5+5,1676,1680,-4,C00,3,Resign,Black
TRUE,64,10+3,1142,1679,-537,D00,3,Resign,Black
TRUE,15,10+3,1678,1148,530,C21,10,Mate,White
TRUE,40,10+3,1154,1676,-522,A00,1,Resign,Black
TRUE,128,10+3,1686,1098,588,B00,2,Draw,Draw
TRUE,48,10+3,1102,1685,-583,A00,1,Resign,Black
TRUE,51,10+3,1684,1107,577,C01,4,Mate,White
TRUE,71,5+5,1493,1678,-185,C00,2,Resign,Black
TRUE,60,5+5,1525,1693,-168,D02,3,Resign,White
TRUE,58,5+5,1709,1681,28,A40,2,Mate,Black
TRUE,60,5+5,1692,1699,-7,A03,2,Resign,Black
TRUE,40,5+5,1688,1704,-16,A10,2,Resign,White
TRUE,29,5+5,1699,1497,202,A11,2,Out of Time,White
TRUE,98,5+5,1703,1943,-240,A15,2,Resign,Black
TRUE,71,5+5,1694,1692,2,C10,6,Resign,Black
TRUE,135,5+5,1696,1564,132,A10,2,Draw,Draw
TRUE,34,5+5,1572,1688,-116,C01,5,Mate,Black
TRUE,60,5+5,1392,1684,-292,C07,6,Mate,Black
TRUE,47,5+5,1707,1696,11,A34,3,Resign,Black
TRUE,23,5+5,1684,1720,-36,D08,7,Resign,White
TRUE,78,5+5,1733,1672,61,A30,2,Mate,Black
TRUE,35,5+5,1721,1736,-15,E61,6,Mate,White
TRUE,53,5+5,1724,1733,-9,A08,4,Resign,White
TRUE,120,5+5,1746,1712,34,A11,2,Mate,Black
TRUE,41,5+5,1741,1496,245,A13,2,Mate,White
TRUE,42,15+15,1295,1240,55,D11,7,Resign,Black
TRUE,63,15+2,1430,1302,128,D03,5,Resign,White
FALSE,23,15+2,1302,1248,54,D06,4,Resign,Black
TRUE,32,10+0,1314,1270,44,D20,5,Resign,Black
FALSE,73,15+2,1445,1314,131,D31,5,Resign,White
TRUE,90,15+15,1321,1451,-130,D50,7,Resign,Black
TRUE,41,15+15,1300,1333,-33,B52,6,Mate,White
TRUE,43,15+2,1318,1449,-131,D06,4,Resign,White
TRUE,38,15+2,1450,1303,147,A73,17,Resign,Black
TRUE,41,15+2,1290,1367,-77,D20,5,Mate,White
TRUE,84,15+2,1300,1330,-30,D35,9,Resign,Black
TRUE,56,15+2,1209,1291,-82,A01,5,Resign,Black
TRUE,30,15+2,1299,1418,-119,D31,6,Resign,Black
FALSE,6,40+20,1814,1299,515,C50,5,Resign,White
TRUE,67,15+2,1348,1308,40,C20,3,Resign,White
TRUE,56,15+2,1318,1366,-48,D20,5,Resign,Black
TRUE,103,15+2,1324,1329,-5,C44,6,Resign,White
TRUE,40,15+2,1345,1187,158,D20,5,Mate,Black
TRUE,52,15+2,1352,1149,203,D31,5,Resign,Black
TRUE,57,15+2,1350,1429,-79,D35,10,Draw,Draw
TRUE,23,15+2,1403,1340,63,A40,3,Resign,White
TRUE,39,15+2,1322,1072,250,D20,5,Mate,White
TRUE,52,15+2,1331,1382,-51,D08,4,Resign,Black
TRUE,41,15+2,1373,1341,32,D21,6,Resign,White
TRUE,33,15+15,1350,1265,85,C44,5,Resign,White
TRUE,58,15+15,1270,1299,-29,D00,3,Resign,Black
TRUE,31,15+15,1223,1282,-59,B01,4,Mate,White
TRUE,15,15+15,1289,1306,-17,C50,8,Resign,White
TRUE,32,15+15,1007,1268,-261,C50,6,Resign,Black
TRUE,45,10+0,1170,1179,-9,C21,5,Resign,White
TRUE,25,10+0,1442,1183,259,C70,8,Resign,White
TRUE,15,15+15,1172,1170,2,C42,5,Resign,White
TRUE,62,15+15,1178,1346,-168,B18,8,Resign,Black
TRUE,59,15+15,1171,1190,-19,C53,9,Resign,White
TRUE,51,15+15,1175,1329,-154,C78,10,Resign,White
TRUE,22,15+15,1273,1160,113,D00,2,Resign,Black
TRUE,27,10+0,1154,974,180,C41,5,Resign,White
TRUE,34,15+15,1167,1122,45,C65,6,Resign,Black
TRUE,79,10+0,1439,1171,268,C70,10,Out of Time,White
TRUE,73,15+15,1245,1170,75,C53,9,Resign,White
TRUE,74,10+0,1250,1156,94,A00,1,Mate,Black
TRUE,92,10+0,1164,1263,-99,C70,8,Resign,Black
TRUE,26,15+15,1173,1251,-78,B30,5,Resign,Black
TRUE,40,15+15,1089,1165,-76,C50,6,Mate,Black
TRUE,77,10+0,1278,1173,105,C20,3,Resign,White
TRUE,58,15+15,1178,1391,-213,C64,6,Resign,Black
TRUE,51,15+15,1164,1293,-129,C70,10,Mate,White
TRUE,73,10+0,1353,1170,183,C53,7,Out of Time,White
TRUE,50,15+15,1030,1162,-132,D02,3,Mate,Black
TRUE,52,15+15,1176,1118,58,C42,4,Resign,Black
TRUE,11,15+15,1353,1181,172,C20,4,Mate,White
TRUE,61,15+15,1184,1184,0,C44,5,Resign,White
TRUE,19,15+15,1171,1252,-81,C42,5,Resign,White
TRUE,51,15+15,1157,1234,-77,C55,7,Resign,White
TRUE,12,15+15,1034,1149,-115,D01,4,Resign,Black
TRUE,86,15+15,1156,886,270,C50,5,Draw,Draw
TRUE,27,15+15,1142,1226,-84,C00,3,Mate,White
TRUE,86,15+15,1042,1133,-91,C20,3,Mate,Black
TRUE,61,15+15,1123,1084,39,C40,6,Mate,White
TRUE,53,15+15,1247,1122,125,C20,3,Mate,White
TRUE,50,15+15,1070,1112,-42,A00,1,Mate,Black
TRUE,16,15+15,1099,1173,-74,C15,7,Resign,White
TRUE,110,10+0,1114,1027,87,C00,5,Out of Time,Black
TRUE,45,15+15,914,1133,-219,C46,5,Mate,White
TRUE,93,15+15,1125,996,129,C42,5,Mate,White
TRUE,105,15+15,1242,1125,117,C26,4,Resign,White
TRUE,60,15+15,1133,1234,-101,C50,6,Resign,Black
TRUE,58,15+15,981,1127,-146,C70,6,Mate,Black
TRUE,65,15+15,1111,1219,-108,C48,7,Mate,White
TRUE,56,15+15,1126,1054,72,C41,5,Mate,Black
TRUE,64,15+15,1147,908,239,B00,4,Resign,Black
TRUE,4,15+15,914,1141,-227,A00,1,Resign,Black
TRUE,58,10+0,1984,1948,36,B06,6,Resign,Black
TRUE,34,10+0,1954,2158,-204,B23,3,Resign,Black
FALSE,101,10+0,2008,1954,54,A10,4,Resign,White
FALSE,35,10+0,1954,2008,-54,B23,5,Resign,Black
FALSE,54,10+0,2008,1954,54,A15,2,Resign,Black
FALSE,116,10+0,1954,2008,-54,A01,2,Resign,Black
TRUE,115,10+0,2100,1960,140,A45,2,Mate,White
TRUE,48,10+0,1945,1961,-16,B01,6,Draw,Draw
TRUE,56,10+0,1982,1960,22,B01,2,Draw,Draw
TRUE,54,10+0,1974,1899,75,A01,2,Resign,Black
TRUE,37,10+0,2068,1982,86,B09,11,Resign,White
TRUE,81,10+0,1959,2028,-69,A01,1,Resign,White
TRUE,45,10+0,2005,1969,36,A02,1,Resign,White
TRUE,161,10+0,1960,1868,92,A01,2,Mate,White
TRUE,88,10+0,1964,2287,-323,B00,5,Resign,Black
TRUE,148,10+0,1914,1965,-51,B01,4,Draw,Draw
TRUE,119,10+0,1951,2049,-98,A01,2,Mate,White
TRUE,60,10+0,2149,1933,216,A52,7,Resign,Black
TRUE,34,10+0,1599,1929,-330,B01,6,Mate,Black
TRUE,94,10+0,1882,1919,-37,B01,6,Resign,Black
TRUE,122,10+0,1699,1914,-215,B01,5,Mate,Black
TRUE,44,10+0,1916,2285,-369,A01,2,Resign,Black
TRUE,26,10+0,1936,1638,298,A01,5,Resign,Black
TRUE,116,10+0,1758,1929,-171,B01,4,Resign,Black
TRUE,31,10+0,1265,1957,-692,B00,5,Resign,White
TRUE,133,10+0,1954,1578,376,E90,9,Mate,White
FALSE,65,5+5,1984,2050,-66,B23,4,Resign,White
FALSE,62,5+5,2050,1627,423,A06,2,Mate,Black
FALSE,62,5+5,1627,2050,-423,C00,3,Resign,Black
FALSE,42,5+5,2050,1627,423,A04,2,Mate,Black
FALSE,42,5+5,1627,2050,-423,B02,2,Resign,Black
FALSE,158,5+5,1617,2050,-433,A48,5,Draw,Draw
FALSE,31,5+5,2050,1852,198,B01,6,Resign,White
FALSE,46,5+5,1981,2050,-69,A15,4,Resign,Black
FALSE,20,5+5,2050,1981,69,B15,9,Resign,Black
FALSE,73,10+5,1901,1164,737,C70,8,Mate,White
FALSE,35,11+5,1164,1435,-271,B01,4,Mate,White
FALSE,71,10+0,1435,1164,271,C50,7,Out of Time,White
FALSE,46,11+5,1164,1435,-271,C48,7,Resign,White
FALSE,52,10+5,1164,1901,-737,C48,8,Resign,Black
TRUE,52,10+0,1245,1228,17,C60,5,Out of Time,Black
TRUE,70,10+0,1287,1099,188,B20,2,Out of Time,Black
FALSE,49,10+15,1866,1099,767,D17,10,Resign,White
TRUE,75,10+0,1211,1230,-19,B20,2,Resign,White
TRUE,61,10+0,1344,1500,-156,B50,4,Mate,White
FALSE,41,10+10,1834,1500,334,C41,8,Resign,White
FALSE,46,10+10,1500,1834,-334,D01,5,Resign,Black
FALSE,53,10+5,1635,1500,135,D00,10,Mate,White
TRUE,52,10+0,1456,1604,-148,D20,4,Mate,Black
TRUE,36,10+0,1378,1318,60,C00,3,Resign,Black
TRUE,64,10+0,1500,1487,13,D10,5,Resign,Black
TRUE,65,15+15,1714,1709,5,A43,5,Resign,White
TRUE,71,15+15,1613,1729,-116,C02,9,Resign,White
TRUE,50,15+15,1731,2127,-396,B06,4,Resign,Black
TRUE,54,15+15,1739,1840,-101,A65,11,Mate,Black
TRUE,76,15+15,1760,1718,42,C02,7,Mate,Black
TRUE,61,15+15,1708,1729,-21,C02,8,Resign,White
TRUE,53,15+15,1721,1643,78,D30,4,Resign,White
TRUE,24,15+15,1707,1712,-5,C07,7,Resign,Black
TRUE,64,10+2,1170,1662,-492,B01,2,Mate,Black
TRUE,51,5+5,1261,1237,24,A00,1,Resign,White
TRUE,71,10+5,1100,1306,-206,A04,3,Mate,White
FALSE,49,10+5,1590,1100,490,C41,7,Mate,White
FALSE,34,10+5,1100,1590,-490,A06,3,Mate,Black
TRUE,88,5+5,1302,875,427,C20,3,Out of Time,Black
TRUE,11,7+5,1234,1335,-101,D02,4,Draw,Draw
TRUE,11,7+5,1522,1500,22,C42,6,Mate,White
TRUE,86,10+0,2306,2405,-99,C46,7,Resign,Black
TRUE,58,10+0,2422,2386,36,B22,8,Resign,Black
TRUE,50,10+0,2373,2356,17,B33,17,Resign,Black
TRUE,62,10+0,2325,2338,-13,D02,5,Resign,Black
TRUE,39,10+0,2336,1830,506,C45,9,Resign,White
TRUE,49,10+0,2334,1836,498,C61,6,Resign,White
TRUE,43,10+0,2329,2017,312,A67,15,Resign,White
TRUE,84,10+0,1879,2326,-447,B52,6,Mate,Black
TRUE,41,10+0,2323,1881,442,C42,16,Resign,White
TRUE,48,10+0,1622,2322,-700,C47,9,Resign,Black
TRUE,48,10+0,1933,2318,-385,B43,10,Mate,Black
TRUE,38,10+0,1983,2313,-330,A40,2,Resign,Black
TRUE,41,10+0,2312,1663,649,C62,6,Mate,White
TRUE,28,10+0,1866,2309,-443,A04,2,Resign,Black
TRUE,74,10+0,1835,2307,-472,D94,9,Resign,Black
TRUE,29,10+0,2300,2041,259,E20,8,Resign,White
TRUE,45,10+0,2288,2148,140,C42,4,Resign,White
TRUE,61,10+0,2283,1947,336,D37,7,Mate,White
TRUE,19,10+0,2275,2016,259,B17,12,Resign,White
TRUE,48,10+0,1909,2271,-362,B22,8,Resign,Black
TRUE,41,10+0,2263,2006,257,E21,7,Resign,White
TRUE,30,10+0,1293,2263,-970,B02,2,Resign,Black
TRUE,55,10+0,2257,1922,335,B34,9,Mate,White
TRUE,72,10+0,2191,2239,-48,B43,10,Resign,Black
TRUE,78,10+0,1380,2239,-859,D30,4,Resign,Black
TRUE,34,10+0,1796,2235,-439,E00,4,Resign,Black
TRUE,56,10+0,1879,2230,-351,B33,11,Mate,Black
TRUE,49,10+0,2217,2059,158,A99,15,Resign,White
TRUE,72,10+0,2336,2185,151,B43,10,Mate,Black
TRUE,70,10+5,2175,1936,239,B09,11,Resign,White
TRUE,83,10+5,2161,1984,177,C45,8,Resign,White
TRUE,57,10+5,2150,1915,235,E61,6,Resign,White
TRUE,39,10+5,1976,2135,-159,B22,6,Resign,Black
TRUE,56,10+5,1830,2126,-296,A16,4,Resign,Black
TRUE,46,10+5,2001,2105,-104,A22,6,Resign,Black
TRUE,31,10+5,2104,1344,760,C41,5,Mate,White
TRUE,66,10+5,1918,2086,-168,B30,4,Resign,Black
TRUE,52,10+5,2082,1500,582,E21,7,Resign,White
TRUE,100,10+5,1774,2071,-297,B41,8,Resign,Black
TRUE,10,10+5,1778,2059,-281,B33,8,Resign,Black
TRUE,49,10+5,1783,2045,-262,B90,10,Resign,Black
TRUE,100,10+5,1788,2029,-241,B33,11,Mate,Black
TRUE,107,10+5,1609,2109,-500,D43,8,Resign,White
TRUE,44,10+5,1701,2100,-399,B21,3,Mate,Black
TRUE,27,10+5,2091,1704,387,B01,4,Resign,White
TRUE,72,10+5,1931,2061,-130,C48,8,Resign,Black
FALSE,21,180+0,1408,1396,12,D30,4,Out of Time,White
TRUE,91,10+0,1398,1383,15,D30,4,Mate,White
TRUE,35,10+0,1387,1399,-12,D10,5,Resign,White
TRUE,50,10+0,1394,1512,-118,D06,4,Mate,Black
TRUE,56,10+0,1479,1381,98,B30,4,Resign,Black
TRUE,37,10+0,1371,1374,-3,D30,4,Resign,White
TRUE,66,10+0,1372,1360,12,B30,4,Resign,Black
TRUE,40,10+0,1351,1287,64,C01,4,Resign,White
TRUE,32,20+0,1209,1265,-56,A00,1,Mate,Black
TRUE,26,17+5,1221,1820,-599,C20,3,Mate,Black
TRUE,89,8+0,1332,1500,-168,A40,2,Mate,White
TRUE,65,30+0,1528,1369,159,D02,3,Resign,Black
TRUE,37,30+0,1231,1545,-314,C66,8,Resign,White
TRUE,48,15+15,1142,1138,4,C42,6,Resign,White
TRUE,54,10+0,1263,1264,-1,C41,7,Out of Time,Black
TRUE,43,15+15,1392,1500,-108,B20,2,Mate,White
TRUE,60,15+0,1906,1834,72,E17,11,Resign,Black
TRUE,122,15+0,1841,2015,-174,A43,2,Out of Time,Black
TRUE,49,15+0,1905,1852,53,B00,2,Resign,White
TRUE,56,10+0,1467,1478,-11,A01,4,Mate,Black
FALSE,77,10+0,1478,1500,-22,B27,3,Mate,White
FALSE,60,10+0,1500,1478,22,A00,1,Resign,Black
FALSE,33,10+0,1478,1362,116,B07,2,Mate,White
FALSE,83,15+0,1478,1490,-12,C44,5,Resign,White
TRUE,102,8+5,1453,1466,-13,C62,6,Mate,Black
FALSE,29,5+5,1466,1592,-126,C45,7,Resign,White
FALSE,91,5+8,1466,1582,-116,C41,4,Resign,White
FALSE,34,2+10,1466,1744,-278,B34,9,Resign,Black
TRUE,59,10+0,1479,1454,25,C45,7,Resign,Black
TRUE,41,6+5,1566,1493,73,C62,6,Resign,White
TRUE,54,10+0,1454,1421,33,D30,6,Resign,Black
TRUE,43,10+0,1444,1465,-21,A00,1,Resign,White
TRUE,34,10+0,1387,1457,-70,E90,9,Resign,Black
TRUE,122,10+0,1417,1447,-30,D00,3,Resign,Black
TRUE,51,10+0,1436,1439,-3,D46,12,Mate,White
TRUE,62,10+0,1455,1081,374,C57,10,Resign,Black
TRUE,30,10+0,1318,1448,-130,C57,10,Resign,Black
TRUE,79,10+0,1437,1446,-9,B15,9,Out of Time,White
TRUE,32,10+0,1448,1436,12,D02,4,Resign,Black
TRUE,78,10+0,1308,1441,-133,C26,5,Resign,Black
TRUE,82,10+0,1708,1851,-143,D02,4,Resign,Black
TRUE,64,15+5,1960,2260,-300,D11,5,Resign,Black
TRUE,59,15+5,1969,2247,-278,A08,5,Resign,Black
TRUE,62,10+3,1325,1174,151,D02,3,Resign,Black
FALSE,104,15+1,1325,1500,-175,C67,8,Mate,Black
TRUE,65,5+8,1322,913,409,D02,3,Mate,White
TRUE,23,15+0,1224,1332,-108,B21,3,Resign,White
TRUE,50,30+0,1353,1068,285,D02,5,Mate,Black
TRUE,58,10+9,1131,1347,-216,D01,4,Mate,Black
TRUE,64,10+0,1197,1340,-143,B00,2,Resign,Black
FALSE,56,3+8,1163,1340,-177,D00,5,Resign,Black
TRUE,18,60+120,1362,976,386,C42,6,Resign,Black
TRUE,43,10+0,1348,1381,-33,D02,3,Resign,White
TRUE,24,10+0,1375,1334,41,C22,6,Resign,Black
TRUE,125,90+120,911,1356,-445,A10,2,Mate,White
TRUE,104,15+8,1030,1352,-322,C68,10,Resign,Black
FALSE,29,5+5,1352,1408,-56,D02,4,Resign,White
FALSE,48,10+3,2035,1352,683,B30,4,Resign,Black
TRUE,65,5+8,1787,1417,370,C41,7,Mate,White
TRUE,20,5+8,1810,1495,315,C40,6,Resign,Black
TRUE,38,5+8,1783,1797,-14,A02,2,Mate,Black
TRUE,26,5+8,1723,1814,-91,B33,11,Resign,White
TRUE,70,5+8,1645,1806,-161,A52,7,Resign,Black
TRUE,35,5+8,1800,1590,210,B21,5,Resign,White
TRUE,23,5+8,1798,1250,548,C79,10,Resign,White
TRUE,76,5+8,1602,1791,-189,B21,3,Resign,Black
TRUE,68,5+8,1415,1788,-373,B21,3,Out of Time,Black
TRUE,4,8+0,1758,1804,-46,A51,4,Resign,White
TRUE,30,8+0,1815,1889,-74,B00,2,Resign,Black
TRUE,59,8+0,1800,1831,-31,B01,4,Mate,White
TRUE,77,8+0,1820,1814,6,A01,3,Resign,White
TRUE,76,8+0,1830,1809,21,B01,4,Out of Time,Black
TRUE,34,9+1,1914,1842,72,B33,8,Resign,White
TRUE,53,9+1,1856,1903,-47,C66,8,Resign,Black
TRUE,178,5+5,2153,2474,-321,D02,5,Draw,Draw
TRUE,91,5+5,2474,2477,-3,E30,7,Draw,Draw
TRUE,57,5+5,2469,2216,253,B33,11,Resign,White
TRUE,42,5+5,2220,2464,-244,C47,8,Resign,Black
TRUE,48,8+0,1973,2462,-489,E20,8,Mate,Black
TRUE,33,5+5,2465,2384,81,D00,3,Draw,Draw
TRUE,71,5+5,2460,2240,220,A45,3,Resign,White
TRUE,26,5+5,2104,2456,-352,C27,6,Resign,Black
TRUE,32,5+5,2301,2449,-148,C29,6,Resign,Black
TRUE,63,5+5,2447,2005,442,B07,5,Mate,White
TRUE,86,5+8,2306,2438,-132,C48,8,Resign,Black
TRUE,99,9+3,2432,2213,219,A42,8,Resign,White
TRUE,36,8+0,2255,2425,-170,D00,3,Resign,Black
TRUE,153,5+5,2428,2360,68,A71,15,Draw,Draw
TRUE,112,8+0,2208,2421,-213,A02,4,Resign,Black
TRUE,39,5+5,2418,2067,351,D30,7,Resign,White
TRUE,28,5+5,2083,2415,-332,D00,2,Resign,Black
TRUE,65,5+5,2409,2182,227,E61,6,Resign,White
TRUE,21,5+5,2281,2400,-119,D00,3,Resign,Black
TRUE,98,6+10,2015,2397,-382,C77,9,Resign,Black
TRUE,31,10+0,1426,1371,55,B06,5,Resign,Black
TRUE,68,10+0,1437,1476,-39,C62,6,Resign,Black
TRUE,42,10+0,1719,1679,40,D35,6,Resign,White
TRUE,42,10+0,1689,1670,19,B32,8,Mate,Black
TRUE,59,10+0,1672,1701,-29,B21,3,Resign,White
TRUE,80,10+0,1695,1923,-228,B94,11,Resign,Black
TRUE,31,10+0,1706,1698,8,B30,4,Resign,Black
TRUE,107,10+0,1687,1717,-30,D30,7,Out of Time,White
TRUE,18,2+15,1728,1723,5,B40,8,Resign,Black
TRUE,72,10+1,1648,1719,-71,B30,4,Mate,Black
FALSE,45,5+8,1719,1765,-46,C41,7,Resign,White
TRUE,66,15+15,1648,1710,-62,D02,4,Resign,Black
TRUE,93,10+0,1696,1722,-26,D00,3,Resign,White
TRUE,90,10+0,1732,1768,-36,C45,13,Resign,Black
TRUE,23,10+0,1833,1740,93,C55,6,Resign,White
TRUE,118,10+0,1433,1737,-304,D00,3,Out of Time,Black
TRUE,103,10+0,1729,2008,-279,B32,7,Draw,Draw
TRUE,23,10+0,1722,1605,117,B32,8,Resign,White
TRUE,91,15+15,1713,1659,54,C55,6,Mate,White
TRUE,56,10+0,1605,1698,-93,A00,1,Mate,Black
TRUE,71,10+0,1690,1613,77,C00,3,Mate,White
TRUE,48,10+0,1622,1681,-59,A00,1,Mate,Black
TRUE,80,10+0,1702,1681,21,C46,6,Resign,Black
TRUE,33,10+0,1568,1696,-128,B32,8,Resign,White
TRUE,84,10+0,1707,1699,8,C00,3,Out of Time,Black
TRUE,51,10+0,1453,1724,-271,C55,6,Resign,White
TRUE,47,10+0,1735,1733,2,C60,5,Resign,Black
TRUE,74,5+12,1744,1801,-57,B43,9,Resign,Black
TRUE,77,5+8,1854,1730,124,C45,7,Resign,Black
TRUE,54,10+0,1705,1719,-14,C62,6,Resign,Black
TRUE,75,10+0,1709,1716,-7,B00,5,Out of Time,White
TRUE,89,10+0,1694,1825,-131,C41,5,Out of Time,White
TRUE,62,10+0,1651,1684,-33,C20,3,Resign,Black
TRUE,49,10+0,1706,1695,11,B20,2,Resign,White
TRUE,67,10+0,1683,1717,-34,C41,5,Resign,White
TRUE,73,10+0,1707,1693,14,D00,2,Resign,White
TRUE,43,10+0,1758,1702,56,D02,4,Resign,White
TRUE,70,10+0,1713,1709,4,B38,11,Resign,Black
TRUE,28,10+0,1724,1734,-10,B32,7,Resign,Black
TRUE,16,10+0,1730,1882,-152,B30,4,Resign,Black
FALSE,47,60+10,2334,1800,534,A40,2,Resign,White
TRUE,52,10+0,1680,1789,-109,B00,2,Mate,Black
TRUE,43,10+0,1774,1768,6,A04,2,Resign,White
TRUE,78,10+0,1711,1760,-49,B00,2,Resign,Black
FALSE,75,5+60,1760,1542,218,A08,4,Resign,White
TRUE,105,10+0,1713,1609,104,A01,2,Mate,White
TRUE,103,10+0,1710,1618,92,A00,1,Out of Time,White
TRUE,35,10+0,1374,1613,-239,C64,6,Resign,Black
TRUE,45,10+0,1603,1539,64,B07,6,Mate,White
FALSE,92,8+0,1564,1603,-39,C64,7,Draw,Draw
FALSE,108,5+8,1821,1842,-21,B90,11,Resign,Black
FALSE,154,15+3,1512,1821,-309,D04,6,Resign,Black
FALSE,21,25+0,1821,1832,-11,B13,5,Resign,White
FALSE,48,25+0,1832,1821,11,B12,7,Mate,Black
FALSE,89,25+0,1821,1832,-11,B12,5,Draw,Draw
FALSE,31,25+0,1832,1821,11,B12,7,Mate,White
FALSE,66,10+0,1500,1821,-321,D00,5,Mate,Black
FALSE,80,8+15,1821,1820,1,B01,5,Resign,White
FALSE,62,15+5,1500,1821,-321,B13,11,Resign,White
FALSE,120,11+0,1877,1821,56,B13,11,Mate,Black
TRUE,38,30+25,1902,1830,72,B11,8,Resign,White
FALSE,61,12+1,1830,1311,519,C45,8,Out of Time,White
FALSE,28,10+5,1824,1830,-6,B10,3,Resign,Black
FALSE,99,15+0,1548,1842,-294,B12,5,Resign,White
TRUE,49,15+3,1858,1730,128,C00,3,Resign,Black
TRUE,44,8+0,1891,1845,46,B01,6,Resign,Black
TRUE,55,25+0,1876,1856,20,B01,4,Resign,White
TRUE,92,15+5,1867,1883,-16,C45,8,Resign,Black
TRUE,27,10+0,1864,1449,415,B01,4,Resign,White
TRUE,98,15+10,1922,1851,71,D10,5,Resign,Black
TRUE,24,15+10,1861,1899,-38,B10,4,Mate,Black
TRUE,4,10+0,1527,1861,-334,A02,1,Mate,Black
TRUE,16,20+5,1878,1698,180,B01,6,Resign,Black
FALSE,85,10+5,1878,1906,-28,B87,14,Resign,White
TRUE,70,15+5,1660,1873,-213,B01,4,Mate,Black
FALSE,36,5+8,1707,1873,-166,B01,4,Resign,Black
TRUE,124,10+0,1806,1875,-69,D12,11,Draw,Draw
TRUE,61,8+0,1864,1842,22,B30,5,Resign,White
TRUE,66,8+0,1853,1853,0,B01,6,Out of Time,Black
TRUE,20,14+0,1882,1840,42,B01,6,Resign,Black
TRUE,49,10+5,1832,1696,136,B07,4,Resign,White
TRUE,42,10+5,1704,1824,-120,A20,2,Mate,Black
TRUE,32,10+5,1841,1688,153,B07,4,Resign,Black
TRUE,70,10+5,1695,1834,-139,A03,2,Resign,Black
TRUE,52,10+5,1851,1679,172,B07,4,Resign,Black
TRUE,18,10+0,1527,1882,-355,C20,3,Resign,Black
TRUE,4,10+0,1527,1882,-355,A02,1,Mate,Black
TRUE,54,7+2,1500,1901,-401,D10,5,Mate,Black
TRUE,4,10+0,1533,1897,-364,A02,1,Mate,Black
TRUE,5,10+0,1894,1539,355,A00,1,Mate,White
TRUE,26,10+0,1545,1890,-345,C20,3,Mate,Black
TRUE,4,10+0,1552,1887,-335,A02,1,Mate,Black
FALSE,115,5+60,1923,1887,36,D00,3,Draw,Draw
FALSE,100,9+0,1961,2215,-254,E59,19,Mate,Black
TRUE,113,9+0,2215,1961,254,C91,18,Resign,White
TRUE,125,9+0,2215,2191,24,D12,8,Resign,White
TRUE,51,15+0,2215,2147,68,B30,4,Resign,White
TRUE,65,10+0,1803,2215,-412,E14,7,Resign,Black
TRUE,29,10+0,2210,1805,405,C41,7,Resign,White
TRUE,26,10+0,1807,2205,-398,E00,4,Resign,Black
TRUE,43,10+0,2200,1810,390,C66,8,Resign,White
TRUE,33,10+0,1805,2195,-390,C00,2,Resign,Black
TRUE,54,15+2,2189,2167,22,E20,6,Resign,Black
TRUE,42,25+25,2051,2147,-96,C42,9,Resign,Black
TRUE,61,25+25,2121,2118,3,C42,7,Resign,White
FALSE,38,10+0,1500,2098,-598,D00,2,Mate,Black
TRUE,47,10+0,2078,1920,158,B34,9,Resign,White
TRUE,82,10+0,2151,2029,122,C50,8,Resign,Black
TRUE,47,10+0,1986,2009,-23,C11,13,Resign,White
TRUE,34,60+20,2143,1916,227,A45,3,Resign,Black
TRUE,27,10+0,1904,1544,360,C41,5,Mate,White
TRUE,32,10+0,1547,1891,-344,C42,5,Mate,Black
TRUE,90,20+0,1950,1926,24,A06,3,Mate,Black
TRUE,38,20+0,1902,1811,91,A00,1,Resign,White
TRUE,51,20+0,1879,1569,310,A06,3,Resign,White
TRUE,41,20+0,1805,1749,56,A04,3,Resign,White
TRUE,5,20+0,1787,1343,444,A04,2,Resign,White
TRUE,44,10+10,1560,1713,-153,A28,6,Mate,Black
TRUE,33,10+10,1500,1569,-69,C44,5,Resign,White
TRUE,41,10+0,1541,1690,-149,C41,7,Mate,White
TRUE,28,10+0,1567,1551,16,B22,3,Resign,White
TRUE,62,10+0,1540,1540,0,B20,3,Mate,Black
TRUE,28,10+0,1550,1531,19,C57,10,Resign,Black
TRUE,61,15+15,1435,1543,-108,B52,6,Resign,Black
TRUE,123,10+0,1534,1467,67,B01,4,Mate,White
TRUE,89,10+0,1524,1499,25,D06,4,Mate,White
TRUE,43,10+0,1548,1535,13,B20,3,Resign,White
TRUE,44,10+0,1545,1554,-9,B15,5,Resign,Black
FALSE,20,10+15,2621,1545,1076,B54,6,Resign,White
TRUE,55,15+15,1544,1523,21,A43,5,Resign,Black
TRUE,20,15+15,1432,1559,-127,B20,3,Resign,White
TRUE,88,10+0,1369,1553,-184,B21,3,Mate,Black
TRUE,96,10+0,1553,1542,11,B20,2,Resign,Black
TRUE,120,10+0,1543,1553,-10,B20,3,Resign,White
TRUE,111,10+0,1544,1496,48,B30,5,Resign,White
TRUE,39,10+0,1519,1556,-37,D00,10,Mate,White
TRUE,93,10+0,1545,1559,-14,A21,3,Mate,White
TRUE,100,10+0,1529,1534,-5,D04,5,Mate,Black
TRUE,54,10+0,1546,1517,29,A25,4,Resign,Black
TRUE,75,5+8,1500,1973,-473,A80,3,Mate,White
TRUE,160,15+5,2105,1929,176,B13,5,Resign,Black
TRUE,32,10+0,813,841,-28,C20,3,Resign,White
TRUE,86,10+0,857,1057,-200,B40,5,Mate,Black
FALSE,50,8+10,857,958,-101,B23,3,Resign,Black
TRUE,39,10+2,1478,859,619,B01,2,Mate,White
FALSE,31,15+0,859,1500,-641,C40,4,Resign,White
TRUE,29,10+8,1574,861,713,B01,8,Resign,White
TRUE,27,5+10,1186,871,315,B01,2,Mate,White
TRUE,57,15+0,1391,875,516,B00,5,Mate,White
TRUE,68,45+0,1271,883,388,B01,2,Resign,White
TRUE,95,10+0,1203,894,309,D00,4,Mate,White
TRUE,40,20+3,901,1339,-438,B20,2,Mate,Black
FALSE,27,45+0,1500,901,599,B01,2,Resign,White
TRUE,78,30+10,922,1120,-198,C20,3,Resign,Black
TRUE,74,14+12,989,791,198,D00,3,Resign,Black
TRUE,4,30+0,1026,1121,-95,D00,2,Resign,Black
TRUE,44,8+0,1057,1240,-183,A40,2,Resign,Black
FALSE,45,30+0,1057,1341,-284,C00,3,Resign,Black
TRUE,15,30+0,1331,1083,248,B21,3,Mate,White
TRUE,37,20+5,1266,1130,136,B00,2,Resign,White
TRUE,22,12+0,1155,1484,-329,B01,4,Resign,Black
TRUE,58,20+0,1222,1351,-129,D00,2,Resign,Black
FALSE,33,15+15,1214,1222,-8,B01,2,Resign,White
FALSE,41,10+1,1034,1222,-188,A40,4,Resign,White
TRUE,46,7+7,1535,1273,262,C00,3,Resign,White
TRUE,36,10+10,1500,1409,91,D00,2,Mate,Black
FALSE,55,10+0,1950,2212,-262,E00,1,Out of Time,White
FALSE,49,10+10,1950,1226,724,A04,2,Resign,White
FALSE,78,10+10,1950,1885,65,A08,4,Mate,Black
FALSE,29,10+10,1950,2204,-254,A04,2,Draw,Draw
FALSE,65,10+10,1950,1500,450,A06,2,Draw,Draw
FALSE,66,10+10,1950,1819,131,A07,4,Draw,Draw
FALSE,112,10+10,1950,1477,473,A04,2,Draw,Draw
FALSE,70,10+10,1950,1500,450,A07,3,Draw,Draw
TRUE,50,10+0,2036,1706,330,A08,6,Resign,Black
FALSE,40,10+0,1795,2036,-241,B54,6,Resign,Black
TRUE,33,15+0,2023,1671,352,A04,2,Mate,White
TRUE,30,15+0,1675,2008,-333,B57,8,Mate,Black
TRUE,53,15+0,1990,1678,312,A04,2,Mate,White
FALSE,30,20+60,1990,1465,525,A08,5,Draw,Draw
FALSE,11,60+0,1990,1756,234,A04,2,Draw,Draw
FALSE,3,60+0,1990,1779,211,A04,2,Draw,Draw
FALSE,67,10+10,1990,1447,543,A04,2,Draw,Draw
TRUE,41,45+45,1458,1980,-522,A00,4,Resign,Black
TRUE,28,45+45,1967,1500,467,A04,2,Resign,White
FALSE,52,10+10,1967,1295,672,A07,3,Resign,White
FALSE,30,10+0,2102,1967,135,B54,6,Resign,Black
TRUE,62,20+0,1647,1566,81,D30,4,Resign,Black
FALSE,35,6+6,1500,1647,-147,C46,5,Resign,White
TRUE,89,4+15,1668,1642,26,C40,4,Resign,Black
TRUE,119,10+0,1613,1694,-81,B50,5,Resign,White
FALSE,21,5+8,1500,1500,0,C21,3,Resign,White
FALSE,65,5+8,1528,1500,28,B22,3,Resign,White
FALSE,50,5+8,1500,1412,88,D01,7,Out of Time,Black
TRUE,60,30+0,1887,1760,127,D02,3,Resign,Black
TRUE,73,15+10,1826,1900,-74,C59,16,Resign,White
FALSE,42,10+1,1297,1500,-203,A00,1,Mate,Black
FALSE,58,15+0,1297,1230,67,C20,3,Mate,Black
FALSE,38,10+0,1625,1754,-129,D00,3,Resign,Black
FALSE,28,10+0,1719,1625,94,D35,9,Resign,Black
FALSE,26,10+0,1625,1657,-32,B43,9,Resign,Black
FALSE,35,10+0,1619,1625,-6,C02,5,Resign,White
FALSE,35,10+0,1551,1625,-74,C68,9,Resign,White
TRUE,34,5+6,1862,1358,504,D20,5,Resign,Black
FALSE,38,10+0,1807,1862,-55,C53,9,Resign,Black
FALSE,27,10+0,1862,1387,475,A00,1,Resign,Black
FALSE,80,10+0,1474,1862,-388,C41,5,Out of Time,Black
FALSE,54,10+0,1862,1807,55,C41,5,Resign,Black
FALSE,65,10+0,1720,1862,-142,C47,8,Mate,White
FALSE,55,10+0,1862,1690,172,A06,2,Resign,Black
FALSE,67,10+0,1884,1862,22,C42,5,Resign,Black
FALSE,78,10+0,1396,1862,-466,C50,8,Resign,Black
FALSE,51,10+0,1674,1862,-188,D06,4,Resign,White
FALSE,75,10+0,2203,1862,341,C60,6,Resign,White
FALSE,36,10+0,1862,2203,-341,B70,10,Resign,Black
FALSE,58,10+0,1862,1722,140,D20,6,Mate,Black
FALSE,12,10+0,1598,1862,-264,C41,5,Resign,White
FALSE,21,10+10,1708,1862,-154,C42,5,Resign,White
FALSE,56,10+0,1862,1500,362,A40,1,Resign,Black
FALSE,24,10+0,1862,1513,349,D30,4,Resign,Black
FALSE,32,10+0,1500,1862,-362,D05,6,Resign,Black
FALSE,66,10+0,1862,1449,413,D48,16,Mate,Black
FALSE,45,10+0,1862,1500,362,B01,4,Resign,Black
FALSE,50,10+0,1704,1862,-158,C60,6,Resign,White
FALSE,18,10+0,1862,1769,93,C45,7,Resign,Black
FALSE,90,10+0,1701,1862,-161,C50,6,Mate,Black
FALSE,75,10+0,1799,1862,-63,C26,4,Mate,White
FALSE,34,10+0,1862,1701,161,C41,4,Resign,Black
FALSE,70,10+0,1699,1862,-163,C46,6,Resign,Black
FALSE,24,5+8,1862,1579,283,B21,6,Resign,Black
FALSE,18,5+8,1862,1416,446,B07,5,Out of Time,Black
FALSE,36,5+8,1862,2073,-211,B21,5,Resign,Black
FALSE,99,5+8,1567,1862,-295,A06,3,Resign,White
FALSE,60,5+8,1564,1862,-298,A43,2,Resign,White
FALSE,77,5+8,1862,1140,722,C49,8,Mate,White
TRUE,74,10+0,1972,1952,20,A52,7,Mate,Black
TRUE,61,10+0,1960,1950,10,C42,5,Resign,White
TRUE,15,10+0,2199,1955,244,C42,7,Resign,White
FALSE,102,10+0,1955,1837,118,B90,11,Draw,Draw
TRUE,129,10+0,1937,2090,-153,C01,5,Out of Time,White
TRUE,25,10+0,1951,1664,287,C01,5,Resign,White
TRUE,39,10+0,1944,1776,168,B36,8,Resign,White
TRUE,62,10+0,1553,1942,-389,B13,5,Out of Time,Black
TRUE,19,10+0,1236,1941,-705,B10,2,Resign,Black
FALSE,83,180+0,1500,1500,0,C00,3,Resign,White
FALSE,66,180+0,1500,1500,0,C44,5,Resign,White
FALSE,89,180+0,1500,1500,0,C00,3,Resign,White
FALSE,129,180+180,1500,1500,0,A00,1,Draw,Draw
FALSE,27,180+180,1500,1500,0,B00,2,Resign,White
FALSE,76,180+180,1500,1500,0,B00,2,Resign,White
FALSE,55,8+3,1452,1343,109,C34,6,Resign,White
FALSE,65,20+0,1343,1376,-33,A01,4,Mate,White
TRUE,63,10+0,1803,1737,66,C01,5,Resign,White
TRUE,64,4+6,1670,1692,-22,C46,5,Resign,Black
TRUE,69,5+8,1500,1534,-34,C40,3,Resign,White
FALSE,31,5+8,1500,1421,79,C40,3,Resign,White
FALSE,15,5+8,1500,1329,171,C50,5,Mate,White
FALSE,35,10+0,1851,1712,139,B54,6,Resign,White
FALSE,107,20+0,1712,1714,-2,C45,7,Out of Time,White
FALSE,43,10+0,1500,1712,-212,D00,2,Resign,White
FALSE,72,6+10,1705,1712,-7,B20,3,Resign,Black
FALSE,63,10+0,1712,2015,-303,C11,7,Resign,Black
FALSE,34,10+25,1712,1832,-120,B10,2,Resign,Black
FALSE,51,3+10,1712,1615,97,B01,4,Resign,Black
FALSE,60,10+10,1712,1708,4,C40,4,Resign,Black
FALSE,26,10+0,1860,1712,148,B21,3,Resign,Black
FALSE,70,30+30,2108,1712,396,D05,7,Resign,Black
FALSE,24,10+0,1712,1959,-247,A22,4,Resign,Black
FALSE,124,5+10,1712,1500,212,A35,4,Resign,Black
FALSE,39,15+15,1780,1712,68,E20,8,Resign,White
FALSE,58,8+0,2180,1712,468,B21,3,Resign,Black
FALSE,16,10+1,1328,1712,-384,A00,1,Resign,Black
FALSE,52,5+5,1896,1712,184,D30,7,Mate,Black
TRUE,22,10+0,1500,1591,-91,C00,5,Resign,Black
TRUE,43,10+0,1582,1494,88,D15,7,Resign,White
TRUE,27,10+0,1726,1589,137,C01,5,Resign,White
TRUE,41,10+0,1577,1618,-41,A10,2,Mate,White
TRUE,30,10+0,1577,1534,43,A20,2,Mate,Black
TRUE,125,10+0,1693,1585,108,D37,7,Mate,White
TRUE,16,10+0,1573,1590,-17,A13,2,Resign,White
TRUE,53,10+0,1597,1583,14,C00,3,Resign,White
TRUE,49,10+0,1603,1594,9,C00,3,Mate,White
TRUE,59,10+0,1586,1623,-37,A15,2,Resign,White
TRUE,86,10+0,1592,1783,-191,A20,2,Mate,Black
TRUE,52,10+0,1602,1629,-27,A10,1,Mate,Black
TRUE,96,10+0,1516,1593,-77,C00,2,Mate,Black
TRUE,114,10+0,1475,1585,-110,C00,3,Resign,Black
TRUE,69,10+0,1575,1571,4,A27,5,Resign,White
TRUE,40,10+0,1585,1632,-47,A20,2,Mate,Black
FALSE,72,15+0,2065,1976,89,B21,6,Resign,White
TRUE,63,7+4,1976,1988,-12,B40,10,Resign,White
TRUE,141,7+4,1976,1987,-11,C44,4,Resign,White
TRUE,92,8+0,2035,1961,74,A56,6,Mate,Black
TRUE,64,10+0,1975,1908,67,C48,8,Resign,Black
TRUE,90,10+0,1463,1974,-511,A06,3,Resign,Black
TRUE,70,10+0,1997,1480,517,C22,7,Mate,Black
FALSE,68,10+0,1950,1997,-47,B01,2,Resign,Black
TRUE,63,8+0,2229,2002,227,C02,10,Mate,White
TRUE,63,10+0,1819,2020,-201,B27,3,Mate,White
TRUE,75,10+0,2014,1827,187,C48,8,Out of Time,White
TRUE,94,10+0,1807,2008,-201,B40,4,Out of Time,Black
TRUE,102,10+0,2013,2274,-261,A16,3,Resign,Black
TRUE,87,10+0,2008,1744,264,A11,2,Resign,White
TRUE,90,10+0,2179,1991,188,B40,10,Resign,Black
TRUE,96,10+0,1777,1998,-221,B40,5,Draw,Draw
TRUE,33,10+0,1982,1917,65,A34,3,Resign,White
TRUE,52,10+0,1749,1977,-228,B40,4,Resign,Black
TRUE,62,10+0,1781,1971,-190,B40,8,Resign,Black
TRUE,63,8+5,2040,1981,59,B40,10,Resign,White
TRUE,132,10+0,1890,2139,-249,C30,4,Mate,Black
TRUE,55,10+0,2131,2018,113,B45,10,Resign,White
TRUE,95,10+0,2116,2252,-136,E34,8,Mate,White
TRUE,59,10+0,1687,1691,-4,D46,12,Resign,White
TRUE,86,10+0,1689,1668,21,B21,3,Resign,Black
TRUE,150,10+0,1651,1657,-6,C20,3,Mate,Black
FALSE,54,5+8,1500,1990,-490,B43,10,Mate,Black
FALSE,74,5+5,1786,1736,50,C44,7,Resign,Black
TRUE,33,20+0,1663,1758,-95,B01,4,Out of Time,White
TRUE,161,5+5,1779,1794,-15,A20,2,Resign,White
TRUE,85,7+3,1500,1688,-188,C40,4,Resign,White
TRUE,76,10+0,1654,1918,-264,D53,8,Resign,Black
TRUE,52,10+0,1690,1913,-223,C01,5,Mate,Black
TRUE,204,7+2,1818,1896,-78,D70,6,Out of Time,Black
TRUE,26,10+5,1813,1887,-74,C12,11,Resign,Black
TRUE,64,10+0,1775,1879,-104,A01,3,Resign,Black
TRUE,47,10+0,1873,1651,222,B01,4,Resign,White
TRUE,103,10+0,1868,1656,212,A43,5,Out of Time,White
TRUE,39,10+0,1860,1770,90,B15,5,Resign,White
TRUE,50,10+0,1748,1852,-104,C00,3,Resign,Black
TRUE,19,10+0,1365,1850,-485,C00,3,Resign,Black
TRUE,30,10+0,1861,1873,-12,B38,11,Resign,Black
TRUE,35,20+10,1833,1873,-40,A45,3,Resign,White
FALSE,46,10+5,1821,1873,-52,C03,5,Resign,Black
TRUE,35,10+0,2004,1881,123,B40,5,Mate,White
TRUE,32,10+0,1895,1797,98,C42,5,Mate,Black
TRUE,52,10+0,1560,1892,-332,B20,3,Resign,Black
TRUE,132,10+0,1901,1993,-92,C41,5,Resign,Black
TRUE,38,10+0,1729,1894,-165,A03,2,Resign,Black
TRUE,86,10+0,1613,1891,-278,B20,3,Mate,Black
TRUE,43,10+15,1864,1892,-28,B41,8,Resign,White
TRUE,34,10+15,1905,1851,54,C02,9,Resign,Black
TRUE,72,10+0,1784,1897,-113,B40,4,Mate,Black
TRUE,23,10+0,1893,1624,269,C61,6,Resign,White
TRUE,78,10+0,1750,1885,-135,D01,4,Resign,Black
TRUE,45,10+0,1882,1602,280,C62,6,Mate,White
TRUE,66,20+5,1712,1875,-163,C41,5,Resign,Black
TRUE,29,6+3,1878,1887,-9,D00,10,Mate,White
TRUE,154,10+0,1895,1977,-82,B32,10,Out of Time,Black
TRUE,80,15+10,1672,1890,-218,A56,4,Resign,Black
TRUE,121,10+0,1881,1828,53,C00,3,Resign,White
TRUE,140,10+0,1972,1878,94,B41,9,Draw,Draw
TRUE,75,10+0,1868,1824,44,C00,3,Mate,White
TRUE,36,10+15,1819,1881,-62,B56,10,Resign,White
TRUE,77,5+15,1871,1841,30,C40,4,Resign,White
TRUE,33,5+15,1828,1884,-56,B21,3,Resign,White
TRUE,56,5+8,1727,1877,-150,D00,4,Resign,Black
TRUE,129,45+15,1891,1814,77,C88,13,Resign,Black
TRUE,53,10+0,1650,1910,-260,B40,4,Resign,White
TRUE,22,10+0,1968,1921,47,B22,6,Resign,White
TRUE,51,10+0,1907,1946,-39,E77,8,Resign,White
TRUE,37,10+0,1903,1648,255,C60,6,Resign,White
TRUE,30,10+0,1725,1896,-171,B22,3,Resign,Black
TRUE,89,10+0,1894,1506,388,C41,5,Resign,White
TRUE,73,10+0,1890,1617,273,C66,8,Resign,White
TRUE,114,10+10,1522,1727,-205,C54,13,Mate,Black
TRUE,107,10+10,1708,1528,180,C00,4,Mate,White
TRUE,92,10+5,1744,1770,-26,C50,7,Mate,Black
TRUE,63,10+5,1759,1790,-31,C25,4,Mate,White
TRUE,36,15+20,1750,1741,9,C50,6,Mate,Black
TRUE,55,5+7,1686,1681,5,C55,6,Resign,White
TRUE,85,30+10,1840,1732,108,C20,4,Mate,White
TRUE,118,6+8,1713,1637,76,D00,3,Resign,Black
TRUE,55,10+15,1791,1716,75,D00,3,Mate,White
FALSE,135,15+5,1716,1763,-47,C00,4,Draw,Draw
TRUE,78,20+0,1804,1931,-127,B20,3,Mate,Black
FALSE,40,10+3,1850,1804,46,C60,5,Resign,Black
FALSE,114,8+0,1804,1779,25,C02,7,Out of Time,Draw
TRUE,68,15+5,1701,1500,201,C46,5,Mate,Black
TRUE,48,30+0,1005,1140,-135,C46,6,Resign,Black
TRUE,29,15+5,1148,1057,91,D00,3,Resign,White
TRUE,14,15+5,1142,1150,-8,C60,6,Resign,Black
TRUE,61,10+0,1066,1326,-260,C48,7,Mate,White
TRUE,59,10+0,1625,1384,241,C50,6,Mate,White
FALSE,9,10+15,1805,1384,421,C41,5,Resign,White
TRUE,80,3+8,1500,1644,-144,A00,1,Mate,Black
TRUE,81,30+5,1687,1771,-84,D00,3,Resign,Black
TRUE,103,30+5,1678,1595,83,A41,2,Resign,White
TRUE,10,20+0,2313,2168,145,B00,2,Resign,Black
FALSE,32,20+0,1855,2313,-458,C50,6,Resign,Black
TRUE,50,15+10,2353,2313,40,A85,5,Draw,Draw
TRUE,41,10+10,2291,2144,147,C67,10,Resign,White
TRUE,39,8+0,2272,2061,211,C02,9,Resign,White
TRUE,50,10+0,2344,2215,129,C50,6,Resign,Black
TRUE,66,25+25,2063,2183,-120,C65,6,Resign,Black
TRUE,66,10+0,2109,2247,-138,B13,5,Resign,White
TRUE,55,8+0,2062,1978,84,C45,8,Resign,White
TRUE,65,10+0,1996,1957,39,B43,9,Mate,White
TRUE,72,10+0,1968,1882,86,C54,16,Mate,Black
TRUE,57,20+0,1756,1771,-15,C44,8,Resign,White
TRUE,50,20+0,1785,1432,353,C24,5,Resign,Black
FALSE,57,10+0,1432,1916,-484,C41,5,Resign,White
TRUE,21,20+8,1870,1479,391,C62,6,Resign,White
FALSE,48,10+10,1859,1479,380,C62,6,Mate,Black
TRUE,49,5+5,2108,1500,608,A80,3,Mate,White
TRUE,68,6+9,1299,1513,-214,A00,1,Mate,Black
FALSE,40,8+5,1501,1513,-12,C55,6,Resign,Black
FALSE,9,8+5,1513,1501,12,D06,4,Resign,Black
FALSE,36,180+0,1126,1513,-387,C20,3,Resign,Black
TRUE,98,20+0,1286,1502,-216,C77,9,Resign,Black
TRUE,56,5+5,1433,1481,-48,A01,4,Mate,Black
FALSE,128,10+0,1406,1481,-75,D15,7,Draw,Draw
TRUE,132,8+5,1510,1461,49,B01,4,Mate,Black
TRUE,48,20+0,1534,1581,-47,D30,4,Resign,Black
TRUE,57,20+0,1547,1564,-17,C57,8,Mate,White
TRUE,75,20+0,1602,1502,100,A00,1,Resign,Black
TRUE,99,20+0,1444,1651,-207,C55,7,Resign,White
TRUE,59,15+0,1627,1496,131,C41,4,Resign,White
FALSE,56,5+8,1267,1627,-360,C20,3,Out of Time,Black
TRUE,69,15+0,1604,1446,158,E71,9,Resign,White
TRUE,70,15+0,1453,1576,-123,D10,4,Resign,Black
TRUE,77,5+5,1740,1500,240,B10,2,Mate,White
TRUE,64,15+0,1552,1625,-73,C22,7,Mate,Black
TRUE,70,20+0,1810,1473,337,C20,2,Mate,Black
TRUE,75,7+5,1436,1484,-48,B56,10,Resign,White
TRUE,104,14+8,1638,1417,221,D00,2,Draw,Draw
TRUE,63,10+0,2053,1914,139,C40,4,Resign,White
TRUE,67,10+0,2021,1921,100,C40,4,Resign,White
TRUE,40,10+0,1930,1979,-49,C20,3,Resign,Black
TRUE,80,10+0,2000,1908,92,A08,4,Resign,Black
TRUE,99,10+0,1885,1607,278,B00,2,Mate,White
TRUE,120,10+0,1776,1821,-45,A43,2,Mate,Black
TRUE,9,10+5,1845,1750,95,B56,9,Draw,Draw
TRUE,62,6+4,1707,1734,-27,A00,1,Resign,Black
TRUE,59,10+0,1500,1603,-103,C65,6,Mate,White
TRUE,57,10+0,1185,1222,-37,A00,1,Resign,White
TRUE,72,10+0,1230,1334,-104,C41,6,Mate,Black
TRUE,115,10+0,1262,1240,22,C40,4,Mate,White
TRUE,70,10+0,1250,1286,-36,C60,6,Mate,Black
TRUE,29,10+0,1133,1264,-131,C40,4,Resign,White
TRUE,33,10+0,1257,1141,116,C65,6,Mate,White
TRUE,17,10+0,1279,1267,12,C57,11,Mate,White
TRUE,19,10+0,1315,1264,51,A25,4,Resign,White
TRUE,100,10+0,1277,1173,104,C00,3,Out of Time,Black
TRUE,27,10+0,1332,1287,45,C50,8,Mate,White
TRUE,95,10+0,1291,1166,125,B00,4,Out of Time,Draw
TRUE,75,10+0,1194,1308,-114,C48,7,Mate,White
TRUE,44,10+0,1136,1301,-165,D00,3,Resign,Black
TRUE,87,10+0,1291,1262,29,C41,4,Mate,White
TRUE,29,10+0,1286,1083,203,C42,5,Out of Time,White
TRUE,75,10+0,1278,1173,105,C00,3,Out of Time,White
TRUE,52,10+0,1175,1270,-95,D01,4,Mate,Black
TRUE,40,10+0,1173,1262,-89,C20,3,Resign,Black
TRUE,73,10+0,1329,1271,58,C44,5,Mate,White
TRUE,64,10+0,1282,1285,-3,C00,4,Resign,Black
TRUE,52,10+0,1235,1272,-37,A00,1,Resign,Black
TRUE,26,10+0,1284,1261,23,C47,8,Resign,Black
TRUE,13,10+0,1279,1036,243,C40,4,Resign,White
TRUE,104,10+0,1239,1269,-30,C20,3,Resign,Black
TRUE,55,10+0,1152,1284,-132,D30,4,Mate,White
TRUE,57,10+0,1277,1122,155,C30,3,Mate,White
TRUE,97,10+0,1264,1327,-63,C78,11,Out of Time,White
TRUE,17,10+0,1442,1270,172,C57,8,Mate,White
TRUE,23,10+0,1260,1233,27,C72,9,Mate,White
FALSE,54,10+2,1767,1260,507,B50,5,Resign,White
TRUE,72,10+0,1268,1392,-124,C62,6,Mate,Black
TRUE,34,10+0,1259,1417,-158,C70,8,Resign,Black
TRUE,56,15+0,1263,1587,-324,B34,8,Mate,Black
TRUE,84,5+5,1342,1248,94,D01,4,Resign,Black
TRUE,29,10+0,1783,1249,534,C68,8,Mate,White
TRUE,19,10+0,1257,1380,-123,C41,4,Resign,Black
TRUE,144,10+0,1265,1366,-101,B52,6,Mate,Black
FALSE,110,10+0,1016,1262,-246,A01,2,Resign,Black
TRUE,47,10+0,1247,1380,-133,C45,8,Mate,White
FALSE,37,10+0,1662,1501,161,C61,6,Resign,White
FALSE,60,10+0,1542,1501,41,A28,7,Draw,Draw
FALSE,54,10+0,1199,1501,-302,D02,4,Mate,Black
FALSE,137,10+0,1501,1199,302,C55,6,Mate,White
FALSE,81,10+0,1199,1501,-302,D02,4,Mate,White
FALSE,83,10+0,1501,1500,1,C40,4,Out of Time,White
FALSE,53,10+0,1597,1501,96,D20,5,Resign,White
FALSE,65,10+0,1501,1619,-118,C62,6,Resign,White
FALSE,8,10+0,1567,1501,66,C50,6,Resign,Black
FALSE,55,10+0,1585,1501,84,C62,6,Mate,White
FALSE,67,10+0,1501,1590,-89,C40,4,Mate,White
FALSE,26,10+0,1501,1640,-139,C50,8,Resign,Black
FALSE,33,10+0,1702,1501,201,C44,9,Resign,White
FALSE,73,10+0,1514,1501,13,D00,3,Mate,White
FALSE,27,10+0,1501,1500,1,C41,5,Resign,Black
FALSE,50,10+0,1501,1511,-10,C41,5,Resign,Black
FALSE,74,10+0,1500,1501,-1,C46,8,Mate,Black
FALSE,130,10+0,1501,1760,-259,C00,3,Draw,Draw
FALSE,14,10+0,1501,1787,-286,C02,7,Resign,Black
FALSE,51,10+0,1694,1501,193,D00,3,Out of Time,White
FALSE,24,10+0,1501,1503,-2,B07,2,Resign,Black
FALSE,94,10+0,1694,1501,193,D00,3,Resign,Black
FALSE,24,10+0,1501,1606,-105,C68,7,Resign,Black
FALSE,57,10+0,1500,1501,-1,A00,1,Resign,White
FALSE,19,10+0,1500,1501,-1,D02,4,Resign,White
FALSE,47,10+0,1787,1501,286,C45,7,Resign,White
FALSE,30,10+0,1501,1646,-145,C02,5,Resign,Black
FALSE,17,10+0,1707,1501,206,A06,3,Resign,White
FALSE,18,10+0,1501,1500,1,C48,7,Resign,Black
FALSE,24,10+0,1645,1501,144,C50,9,Resign,White
FALSE,7,10+0,1501,1797,-296,C46,6,Out of Time,White
FALSE,27,10+0,1501,1501,0,C23,3,Resign,White
FALSE,50,10+0,1501,1626,-125,B30,4,Resign,Black
FALSE,20,10+0,1501,1759,-258,C00,3,Resign,Black
FALSE,85,10+0,1500,1501,-1,C46,7,Resign,White
FALSE,87,10+0,1501,1500,1,C41,4,Resign,White
FALSE,45,10+0,1501,1513,-12,C46,5,Mate,White
FALSE,63,10+0,1501,1509,-8,B00,5,Resign,White
FALSE,38,10+0,1500,1501,-1,C50,6,Resign,Black
FALSE,39,10+0,1585,1501,84,D20,5,Resign,White
FALSE,8,10+0,1501,1609,-108,C40,5,Resign,Black
FALSE,90,10+0,1501,1500,1,C41,5,Resign,Black
FALSE,94,10+0,1501,1500,1,C42,8,Resign,White
FALSE,29,10+0,1598,1501,97,C24,4,Resign,White
FALSE,98,15+15,1104,910,194,E61,6,Resign,Black
FALSE,74,15+15,1104,1207,-103,A10,2,Mate,Black
FALSE,37,15+15,1104,1343,-239,A20,2,Resign,White
FALSE,74,15+15,1104,1500,-396,A22,4,Mate,Black
FALSE,6,15+15,1104,1228,-124,A20,2,Resign,White
FALSE,94,15+15,1104,1419,-315,A41,6,Mate,Black
FALSE,29,15+15,1104,1069,35,A20,2,Resign,White
FALSE,68,15+15,1104,1300,-196,C44,5,Mate,Black
FALSE,50,15+15,1104,1500,-396,A10,2,Resign,White
FALSE,38,15+15,1104,1248,-144,A10,1,Mate,Black
FALSE,28,15+15,1104,1226,-122,A10,2,Mate,Black
FALSE,82,15+15,1104,1139,-35,A40,4,Resign,White
FALSE,18,15+15,1104,1337,-233,A10,2,Resign,White
FALSE,63,15+15,1104,1017,87,E00,5,Mate,White
FALSE,58,15+15,1104,1290,-186,D00,2,Mate,Black
FALSE,44,15+15,1273,1104,169,C50,5,Resign,Black
FALSE,35,15+5,1500,1104,396,C41,5,Mate,White
FALSE,87,15+5,1481,1104,377,C41,5,Mate,White
FALSE,64,15+5,1104,1500,-396,D02,3,Out of Time,Black
FALSE,36,15+5,1500,1104,396,C20,3,Mate,Black
FALSE,29,15+5,1356,1104,252,C55,7,Mate,White
FALSE,93,15+5,1024,1104,-80,C24,4,Resign,White
FALSE,57,15+5,1336,1104,232,D00,2,Mate,White
FALSE,53,15+5,1500,1104,396,A00,1,Mate,White
FALSE,42,15+5,1104,1430,-326,A45,2,Mate,Black
FALSE,51,15+5,1430,1104,326,C77,9,Mate,White
FALSE,77,15+5,1408,1104,304,C41,5,Mate,White
FALSE,21,15+5,1408,1104,304,C57,7,Mate,White
FALSE,43,15+5,1499,1104,395,C23,3,Out of Time,White
FALSE,81,15+5,1412,1104,308,C50,5,Out of Time,White
FALSE,94,180+0,1072,1231,-159,B01,4,Mate,Black
TRUE,92,15+15,1245,1264,-19,B21,3,Mate,Black
TRUE,29,15+15,1233,1174,59,C27,3,Mate,White
TRUE,78,15+15,1251,1177,74,B21,3,Mate,Black
TRUE,124,15+15,1174,1254,-80,A45,3,Draw,Draw
TRUE,59,15+15,1225,1252,-27,C48,8,Mate,White
TRUE,11,15+15,1216,1041,175,C42,6,Mate,White
TRUE,66,15+15,1007,1208,-201,B01,4,Mate,Black
TRUE,58,15+15,1226,1198,28,B00,5,Mate,Black
TRUE,41,15+15,1277,1241,36,B01,2,Mate,White
TRUE,49,15+15,1233,1013,220,C00,3,Resign,White
TRUE,45,15+15,1225,1014,211,A06,3,Resign,White
TRUE,110,15+15,1026,1215,-189,B01,6,Mate,Black
TRUE,52,15+0,1339,1339,0,C00,3,Draw,Draw
FALSE,17,15+0,1390,1339,51,D00,3,Resign,White
FALSE,98,10+0,1339,1243,96,C40,4,Resign,Black
TRUE,68,10+1,1327,1327,0,A00,1,Mate,Black
FALSE,52,10+0,1327,1490,-163,C46,7,Resign,Black
FALSE,29,10+0,1444,1327,117,D00,3,Resign,White
FALSE,39,10+0,1327,1391,-64,B25,4,Resign,White
FALSE,7,10+0,1500,1327,173,B29,5,Resign,White
FALSE,32,10+0,1500,1327,173,A43,3,Resign,Black
TRUE,97,10+0,1313,1360,-47,C46,7,Mate,White
FALSE,14,10+0,1500,1313,187,A43,2,Resign,White
FALSE,26,10+0,958,1313,-355,B32,6,Resign,White
FALSE,38,10+0,1313,1500,-187,C23,3,Resign,Black
FALSE,11,10+0,1223,1313,-90,A00,1,Resign,White
FALSE,84,10+0,1291,1313,-22,B30,4,Resign,White
FALSE,9,10+0,1313,1500,-187,C42,6,Mate,White
FALSE,9,10+0,1500,1313,187,B25,4,Mate,White
FALSE,33,10+0,1313,1239,74,B01,4,Resign,White
FALSE,56,10+0,1313,1500,-187,C00,3,Resign,Black
FALSE,17,10+0,1428,1313,115,B30,4,Mate,White
FALSE,73,10+0,1313,1078,235,C41,4,Out of Time,White
FALSE,35,10+0,1307,1313,-6,B30,4,Mate,White
FALSE,30,10+0,1313,1500,-187,B50,4,Resign,Black
FALSE,27,10+0,1313,1399,-86,C46,6,Mate,White
FALSE,77,10+0,1412,1313,99,B30,4,Mate,White
TRUE,31,30+0,1563,1318,245,B32,6,Resign,White
TRUE,30,9+0,1327,1420,-93,B20,3,Mate,Black
TRUE,87,9+0,1412,1337,75,A10,2,Mate,White
FALSE,43,10+10,1337,1382,-45,B27,4,Resign,White
FALSE,60,10+10,1382,1337,45,B40,4,Resign,Black
FALSE,36,10+10,1337,1382,-45,B27,3,Mate,Black
TRUE,77,15+15,1516,1345,171,C50,6,Mate,White
FALSE,56,8+8,1418,2003,-585,B01,4,Resign,Black
FALSE,44,8+8,2003,1418,585,C25,4,Resign,Black
FALSE,31,8+8,1418,2003,-585,B14,10,Resign,White
TRUE,54,10+0,1787,1749,38,C41,6,Resign,Black
TRUE,40,10+0,1802,1691,111,C00,3,Resign,Black
TRUE,18,10+0,1799,1408,391,B10,5,Resign,White
TRUE,137,10+0,2019,1805,214,C05,6,Mate,White
TRUE,38,10+0,1812,1949,-137,C56,15,Mate,Black
TRUE,73,10+0,1757,1825,-68,D06,6,Mate,White
TRUE,141,10+0,2150,1829,321,C00,3,Mate,White
TRUE,124,10+0,1766,1819,-53,C05,6,Resign,Black
TRUE,76,10+0,1827,1933,-106,B20,3,Mate,Black
TRUE,50,10+0,1834,1994,-160,B12,6,Resign,Black
TRUE,48,10+0,1590,1829,-239,C02,8,Mate,Black
TRUE,76,10+0,1844,1731,113,C55,10,Mate,Black
TRUE,55,10+0,1723,1859,-136,C00,2,Resign,White
TRUE,67,10+0,1853,1675,178,C55,6,Resign,White
TRUE,110,10+0,1859,1674,185,C55,11,Draw,Draw
TRUE,98,10+0,1834,1848,-14,D00,3,Mate,Black
TRUE,48,10+0,1804,1837,-33,C00,3,Resign,Black
TRUE,86,10+0,1850,1811,39,C55,9,Resign,Black
TRUE,47,10+0,1834,1856,-22,C00,3,Resign,White
TRUE,104,10+0,1526,1830,-304,C02,8,Mate,Black
TRUE,168,10+0,1843,1818,25,D00,3,Mate,Black
TRUE,154,10+0,1844,1713,131,B32,7,Out of Time,Black
TRUE,90,10+0,1845,1844,1,A13,2,Draw,Draw
TRUE,73,10+0,1728,1859,-131,A01,1,Mate,White
TRUE,26,10+0,1865,2076,-211,B35,13,Resign,Black
TRUE,79,10+0,2096,1870,226,C00,3,Mate,White
TRUE,71,10+0,1860,1800,60,B32,10,Mate,White
TRUE,102,10+0,1610,1856,-246,C00,7,Mate,Black
TRUE,75,10+0,1846,1778,68,B90,11,Out of Time,White
TRUE,77,10+0,1936,1843,93,C02,11,Draw,Draw
TRUE,23,10+0,1842,1300,542,C55,9,Resign,White
TRUE,34,10+0,1862,1556,306,C50,6,Mate,Black
TRUE,78,10+0,1865,1850,15,C05,12,Mate,Black
TRUE,69,10+0,1785,1840,-55,A40,2,Resign,Black
TRUE,74,10+0,1771,1831,-60,A40,2,Resign,Black
TRUE,56,10+0,1844,1793,51,C55,6,Mate,Black
TRUE,78,10+0,1848,2098,-250,B33,10,Resign,Black
TRUE,74,10+0,1789,1838,-49,C00,5,Out of Time,Black
TRUE,27,10+0,1820,2095,-275,B07,6,Resign,White
TRUE,60,10+0,1891,1805,86,C02,8,Mate,Black
TRUE,79,10+0,1785,2116,-331,B07,6,Resign,White
TRUE,49,10+0,1769,1926,-157,C55,9,Resign,White
TRUE,40,10+0,1967,1775,192,C00,5,Resign,White
TRUE,56,10+0,1711,1766,-55,A02,1,Out of Time,Black
TRUE,41,10+0,1754,1768,-14,B32,10,Mate,White
TRUE,51,10+0,1756,1765,-9,D30,6,Resign,White
TRUE,60,10+0,1778,1757,21,C00,3,Resign,Black
FALSE,113,5+10,1225,1086,139,C41,4,Mate,White
TRUE,30,20+0,1211,1226,-15,C55,6,Draw,Draw
TRUE,50,20+0,1243,1200,43,C40,4,Resign,Black
TRUE,114,10+1,1256,1298,-42,C46,7,Mate,Black
TRUE,42,10+1,1312,1237,75,C50,6,Resign,Black
FALSE,54,25+0,1245,1237,8,C42,4,Mate,Black
FALSE,108,15+0,1335,1237,98,C77,9,Resign,White
FALSE,55,15+0,1237,1335,-98,A40,2,Resign,White
FALSE,79,15+0,1335,1237,98,C42,5,Mate,White
FALSE,44,5+8,1237,1326,-89,D00,6,Resign,Black
TRUE,66,15+0,1253,1262,-9,C46,6,Mate,Black
TRUE,51,15+0,1227,1303,-76,D00,9,Resign,White
TRUE,53,15+0,1214,1115,99,D00,6,Resign,White
TRUE,53,7+3,1197,1190,7,B10,2,Out of Time,White
TRUE,60,5+5,1176,1658,-482,D01,4,Mate,Black
TRUE,17,5+5,1678,1017,661,C41,5,Resign,Black
FALSE,124,5+5,2186,1017,1169,C41,5,Resign,White
FALSE,125,10+0,1108,1017,91,C41,5,Mate,White
FALSE,39,10+0,2008,1017,991,C41,7,Resign,White
FALSE,42,15+4,1362,2089,-727,A45,3,Mate,Black
FALSE,38,5+5,1362,1657,-295,A45,5,Resign,Black
FALSE,30,5+5,1657,1362,295,B22,3,Resign,White
TRUE,4,6+4,1804,1372,432,C44,4,Resign,White
TRUE,50,10+0,1453,1466,-13,C02,10,Mate,Black
TRUE,53,10+0,1414,1182,232,C60,6,Resign,White
TRUE,59,10+0,1171,1432,-261,A29,7,Mate,White
FALSE,23,10+0,1697,1171,526,C50,5,Draw,Draw
TRUE,117,10+0,1705,1628,77,C41,5,Draw,Draw
TRUE,88,10+0,1567,1698,-131,C15,7,Resign,Black
FALSE,39,10+5,1401,1467,-66,A20,2,Mate,White
FALSE,29,10+5,1401,1588,-187,A04,2,Draw,Draw
FALSE,29,10+5,1588,1401,187,C44,11,Resign,Black
FALSE,68,10+10,1401,2252,-851,A07,8,Mate,Black
TRUE,62,15+15,1413,1401,12,A04,2,Mate,Black
TRUE,58,15+15,1539,1397,142,A45,3,Mate,Black
TRUE,115,15+15,1445,1407,38,E61,5,Mate,White
TRUE,52,15+15,1394,1659,-265,A08,4,Resign,White
TRUE,57,15+15,1383,1384,-1,A04,2,Resign,White
TRUE,105,10+0,1397,1394,3,E61,6,Out of Time,White
TRUE,56,10+0,1405,1402,3,A04,2,Resign,Black
TRUE,53,10+0,1430,1416,14,C23,4,Resign,White
TRUE,91,10+0,1467,1426,41,B54,6,Mate,White
FALSE,39,45+0,1426,1500,-74,B54,6,Mate,White
FALSE,64,45+0,1500,1426,74,B20,3,Resign,Black
FALSE,50,20+0,1426,1207,219,A08,5,Resign,White
FALSE,27,20+0,1549,1426,123,B20,2,Resign,Black
TRUE,56,30+0,1464,1413,51,A00,1,Resign,Black
FALSE,39,20+0,1413,1500,-87,C20,3,Mate,White
FALSE,62,20+0,1500,1413,87,B07,4,Mate,Black
FALSE,58,10+5,1413,1500,-87,E61,9,Mate,Black
FALSE,45,9+20,1688,1413,275,A21,4,Resign,White
TRUE,48,20+10,1220,1407,-187,C60,6,Mate,Black
FALSE,48,30+0,1500,1407,93,A43,5,Resign,White
FALSE,26,15+10,1407,1459,-52,D35,10,Resign,Black
FALSE,32,15+10,1500,1407,93,A00,1,Mate,Black
FALSE,41,20+15,1430,1407,23,C21,3,Resign,White
FALSE,23,20+60,2139,1407,732,C26,5,Resign,White
TRUE,48,15+15,1259,1184,75,D30,4,Resign,Black
TRUE,67,15+15,1162,1273,-111,D32,6,Resign,White
TRUE,32,15+15,1288,1138,150,D30,4,Resign,Black
TRUE,7,10+0,1154,1191,-37,A40,2,Resign,Black
TRUE,24,10+0,1159,1474,-315,D15,7,Resign,Black
TRUE,23,10+0,1217,1176,41,B20,2,Mate,White
TRUE,20,10+0,1205,1257,-52,A41,3,Resign,Black
TRUE,122,10+0,1210,1183,27,C20,3,Out of Time,Black
TRUE,57,5+10,1396,1131,265,D02,4,Mate,White
TRUE,19,10+10,1237,1565,-328,C57,9,Resign,White
TRUE,98,15+0,1753,1451,302,D02,4,Mate,Black
TRUE,35,15+0,1699,1457,242,D02,4,Mate,White
FALSE,41,10+0,1699,1500,199,C68,8,Mate,White
TRUE,75,25+0,1500,1545,-45,D02,3,Mate,White
TRUE,122,10+0,1364,1356,8,B07,3,Mate,Black
TRUE,8,10+0,1374,1385,-11,C40,4,Out of Time,Black
TRUE,90,10+0,1324,1365,-41,C45,7,Out of Time,Black
TRUE,46,10+0,1376,1370,6,C10,6,Mate,Black
TRUE,29,10+0,1340,1366,-26,A00,1,Resign,Black
TRUE,51,10+0,1278,1380,-102,C46,6,Mate,White
TRUE,39,10+0,1250,1382,-132,D00,2,Draw,Draw
TRUE,94,10+0,1388,1238,150,C55,6,Out of Time,Black
TRUE,129,10+0,1301,1401,-100,A04,2,Out of Time,White
TRUE,129,10+0,1390,1423,-33,C41,5,Out of Time,White
TRUE,38,10+0,1403,1321,82,C40,4,Mate,Black
TRUE,68,10+0,1384,1393,-9,D00,3,Resign,Black
TRUE,56,10+0,1403,1387,16,C00,3,Resign,Black
TRUE,88,10+0,1381,1393,-12,A04,2,Mate,Black
TRUE,86,10+0,1405,1362,43,B01,4,Mate,Black
TRUE,107,10+0,1397,1405,-8,B21,3,Draw,Draw
TRUE,57,10+0,1397,1327,70,C41,7,Resign,White
TRUE,13,10+0,1374,1408,-34,A00,1,Resign,White
TRUE,82,10+0,1414,1594,-180,B02,4,Resign,Black
TRUE,63,10+0,1306,1429,-123,D00,2,Mate,White
TRUE,40,10+0,1423,1610,-187,C55,6,Resign,Black
TRUE,42,10+0,1463,1432,31,A00,1,Resign,White
TRUE,50,10+0,1440,1443,-3,E20,8,Resign,White
TRUE,25,10+0,1432,1456,-24,C57,11,Mate,White
TRUE,88,10+0,1437,1635,-198,C00,3,Mate,Black
TRUE,62,10+0,1412,1427,-15,B20,2,Resign,Black
TRUE,48,10+0,1443,1415,28,B34,8,Mate,Black
TRUE,30,10+0,1418,1404,14,C44,4,Resign,Black
TRUE,110,10+0,1261,1397,-136,D00,2,Mate,Black
TRUE,60,10+0,1406,1458,-52,B40,6,Mate,Black
TRUE,39,10+0,1349,1419,-70,C46,7,Mate,White
TRUE,63,10+0,1412,1305,107,D20,6,Resign,White
TRUE,40,10+0,1424,1356,68,D20,6,Mate,Black
TRUE,15,10+0,1413,1434,-21,A40,2,Resign,White
TRUE,47,10+0,1408,1184,224,B07,7,Mate,White
TRUE,44,10+0,1500,1414,86,C20,2,Resign,White
TRUE,86,10+0,1343,1406,-63,C00,2,Resign,Black
TRUE,73,10+0,1697,1592,105,B00,2,Resign,White
TRUE,80,10+0,1693,2287,-594,B02,3,Mate,Black
TRUE,117,10+0,1588,1696,-108,A00,1,Draw,Draw
TRUE,41,10+0,1596,1711,-115,C23,3,Mate,White
TRUE,94,10+0,1721,1754,-33,B50,4,Mate,Black
TRUE,63,10+0,1721,1857,-136,C40,5,Resign,White
TRUE,80,10+0,1735,1649,86,C40,4,Out of Time,Black
TRUE,67,10+0,1731,1879,-148,C67,8,Draw,Draw
TRUE,116,10+0,1643,1722,-79,C42,5,Out of Time,Black
TRUE,130,10+0,1228,1732,-504,C20,3,Mate,Black
TRUE,73,10+0,1716,1856,-140,C66,8,Resign,White
TRUE,93,10+0,1710,1712,-2,B95,12,Resign,White
TRUE,94,10+0,1828,1694,134,D10,4,Out of Time,Black
TRUE,33,10+0,1685,1609,76,B10,2,Resign,White
FALSE,47,10+8,1472,1445,27,D02,5,Mate,White
FALSE,23,20+5,1472,1500,-28,D02,5,Mate,White
FALSE,84,15+15,1472,1218,254,D00,3,Resign,White
FALSE,6,180+0,1161,1472,-311,A41,3,Resign,White
TRUE,88,20+2,1493,1315,178,A80,2,Mate,Black
FALSE,35,20+0,1493,1500,-7,D00,3,Mate,White
FALSE,78,12+0,1463,1493,-30,B00,4,Mate,Black
FALSE,61,12+0,1493,1463,30,D00,3,Resign,White
FALSE,113,10+0,1744,1482,262,C20,4,Draw,Draw
FALSE,78,10+0,1482,1744,-262,D00,3,Mate,Black
FALSE,31,15+8,1500,1482,18,A21,4,Resign,White
TRUE,49,10+0,1477,1189,288,D00,3,Mate,White
TRUE,82,10+0,1476,1474,2,D02,5,Mate,Black
FALSE,115,10+0,1476,1524,-48,D06,4,Out of Time,White
FALSE,59,10+0,1500,1170,330,C21,3,Mate,White
FALSE,82,10+0,1170,1500,-330,C20,3,Mate,Black
TRUE,22,15+15,1229,1160,69,C23,3,Resign,Black
FALSE,49,10+0,1219,1229,-10,C10,5,Mate,White
FALSE,45,30+0,1659,1500,159,B21,6,Resign,White
TRUE,10,15+10,1032,1140,-108,B20,5,Resign,Black
TRUE,88,30+0,1037,1669,-632,B20,2,Mate,Black
TRUE,33,10+0,1147,1121,26,B00,5,Mate,White
TRUE,69,10+0,1209,1261,-52,C42,4,Mate,White
FALSE,84,10+0,1500,1311,189,A20,2,Mate,Black
TRUE,70,10+0,1500,1473,27,C25,5,Mate,Black
TRUE,74,8+0,2352,2366,-14,C40,7,Resign,White
TRUE,161,8+0,2351,2363,-12,B50,5,Mate,White
TRUE,62,10+5,1500,1758,-258,B03,9,Mate,Black
TRUE,39,15+5,1724,1605,119,B22,3,Resign,White
TRUE,91,15+15,1364,1327,37,C57,8,Resign,White
FALSE,53,30+0,1327,1355,-28,C44,6,Mate,White
TRUE,35,10+0,1367,1343,24,B07,5,Resign,White
TRUE,52,10+0,1361,1370,-9,C41,5,Resign,Black
TRUE,66,10+0,1327,1343,-16,C50,6,Resign,Black
TRUE,111,10+0,1347,1186,161,C46,7,Mate,White
TRUE,27,10+0,1334,1400,-66,C00,3,Mate,White
TRUE,19,10+0,1348,1322,26,C34,6,Resign,Black
TRUE,27,10+0,1329,1466,-137,B20,3,Resign,Black
TRUE,25,10+0,1295,1821,-526,C44,4,Mate,White
TRUE,102,10+0,1329,1282,47,D07,7,Resign,Black
TRUE,60,10+0,1285,1598,-313,C27,3,Mate,Black
TRUE,62,10+0,1099,1279,-180,D00,3,Mate,Black
TRUE,130,10+0,1275,1398,-123,B10,3,Draw,Draw
TRUE,61,10+0,1350,1285,65,D07,7,Mate,White
TRUE,63,10+0,1383,1286,97,C46,7,Mate,White
TRUE,50,10+0,1297,1313,-16,C50,5,Mate,Black
TRUE,26,10+0,1273,1286,-13,C50,8,Mate,Black
TRUE,33,10+0,1282,1018,264,C42,5,Mate,White
TRUE,17,10+0,1231,1295,-64,C57,11,Mate,White
TRUE,32,10+0,1306,1298,8,C50,8,Resign,Black
TRUE,92,10+0,1195,1298,-103,A00,1,Out of Time,Black
TRUE,47,10+0,1383,1307,76,C40,4,Mate,White
TRUE,25,10+0,1296,1284,12,B23,3,Resign,White
TRUE,71,10+0,1600,1300,300,C22,6,Mate,White
TRUE,57,10+0,1282,1492,-210,C41,4,Mate,White
TRUE,43,10+0,1386,1279,107,A00,1,Draw,Draw
TRUE,17,10+0,1264,1367,-103,C50,6,Mate,White
TRUE,51,10+0,1393,1272,121,D01,4,Mate,White
TRUE,24,10+0,1278,1474,-196,C41,4,Mate,Black
TRUE,39,10+0,1267,1370,-103,B01,4,Resign,White
TRUE,49,10+0,1349,1276,73,C20,3,Mate,White
TRUE,40,10+0,1285,1383,-98,C00,3,Mate,Black
TRUE,95,10+0,1526,1290,236,A00,1,Mate,White
TRUE,45,10+0,1460,1296,164,D00,10,Mate,White
TRUE,64,10+0,1299,1647,-348,B20,3,Mate,Black
TRUE,51,10+0,1279,1625,-346,C46,7,Resign,White
TRUE,43,5+5,1455,1272,183,B32,8,Mate,White
TRUE,29,5+5,1253,1472,-219,B01,6,Resign,White
TRUE,23,15+5,1258,1481,-223,D02,4,Resign,Black
TRUE,53,8+0,1500,1509,-9,C26,5,Mate,White
TRUE,25,10+0,2165,1973,192,B32,6,Mate,White
TRUE,78,10+0,2179,2115,64,A00,1,Resign,Black
TRUE,52,10+0,1857,2176,-319,A56,4,Out of Time,Black
TRUE,83,10+0,2173,1831,342,C23,3,Resign,White
TRUE,41,10+0,2177,2051,126,C02,9,Draw,Draw
TRUE,101,10+0,2156,2181,-25,B28,5,Resign,White
TRUE,37,10+0,2175,1983,192,B84,14,Mate,White
TRUE,106,10+0,1856,2171,-315,C00,3,Resign,Black
TRUE,56,10+0,2030,2164,-134,B20,3,Mate,Black
TRUE,124,10+0,2179,2090,89,A40,2,Resign,Black
TRUE,32,10+0,1450,1390,60,C46,5,Resign,Black
TRUE,67,10+0,1507,1497,10,C55,7,Resign,White
TRUE,42,10+0,1511,1490,21,C68,8,Mate,Black
TRUE,78,10+0,1402,1465,-63,C55,7,Mate,Black
TRUE,100,10+0,1492,1560,-68,B07,2,Resign,Black
TRUE,64,10+0,1558,1526,32,C23,3,Resign,White
TRUE,53,10+0,1491,1438,53,C46,5,Mate,White
TRUE,71,10+0,1447,1439,8,B07,2,Resign,White
TRUE,41,10+0,1455,1506,-51,C20,4,Resign,White
TRUE,77,10+0,1570,1565,5,C68,8,Resign,White
FALSE,7,7+2,1238,1500,-262,C23,3,Mate,White
FALSE,7,7+2,1500,1238,262,C23,3,Mate,White
FALSE,4,7+2,1500,1238,262,A02,1,Mate,Black
FALSE,18,7+2,1500,1238,262,B20,3,Mate,Black
FALSE,23,15+5,1443,1500,-57,C44,5,Mate,White
FALSE,12,10+5,1500,1626,-126,C23,3,Resign,Black
TRUE,60,10+0,1319,1214,105,C40,4,Resign,Black
TRUE,54,10+0,1278,1308,-30,A10,2,Resign,Black
TRUE,28,10+0,1317,1401,-84,C45,7,Mate,Black
TRUE,32,10+0,1258,1331,-73,B20,2,Resign,White
TRUE,65,10+0,1320,1291,29,C40,4,Mate,White
TRUE,33,10+0,1331,1347,-16,B32,8,Resign,Black
TRUE,104,10+0,1340,1433,-93,D00,2,Resign,Black
TRUE,127,10+0,1134,1346,-212,B20,2,Draw,Draw
TRUE,73,10+0,1336,1292,44,A40,2,Resign,White
TRUE,106,10+0,1515,1319,196,B23,3,Resign,Black
TRUE,40,10+0,1295,1308,-13,B02,5,Mate,Black
TRUE,45,10+0,1295,1321,-26,A40,2,Resign,White
TRUE,117,10+0,1278,1463,-185,D02,3,Mate,White
TRUE,123,10+0,1363,1287,76,A45,2,Mate,White
TRUE,45,10+0,1275,1287,-12,C44,4,Resign,White
TRUE,89,10+0,1201,1290,-89,B70,10,Mate,White
TRUE,73,9+10,1214,925,289,C02,5,Resign,White
TRUE,105,15+15,966,937,29,B01,2,Mate,White
TRUE,8,15+15,951,955,-4,C00,3,Resign,Black
TRUE,61,10+0,784,970,-186,C40,3,Mate,White
TRUE,101,15+15,1161,958,203,B01,4,Mate,White
TRUE,96,10+5,972,985,-13,C50,6,Mate,Black
FALSE,79,15+0,1148,972,176,B01,4,Mate,White
FALSE,16,15+15,972,1301,-329,C20,3,Resign,Black
TRUE,13,10+0,1181,978,203,A10,2,Resign,White
TRUE,21,15+15,958,1008,-50,C20,3,Resign,White
TRUE,28,15+15,1015,956,59,B20,3,Draw,Draw
TRUE,46,15+15,972,954,18,C20,3,Mate,Black
TRUE,110,10+0,983,1090,-107,A40,2,Mate,Black
TRUE,105,10+0,964,1029,-65,D00,3,Resign,White
TRUE,66,10+0,1058,943,115,D00,3,Mate,Black
TRUE,47,10+0,808,973,-165,A00,1,Mate,White
TRUE,11,10+0,1095,986,109,B01,4,Resign,White
TRUE,62,10+0,999,1092,-93,A00,1,Resign,Black
TRUE,13,10+0,912,1024,-112,B01,4,Resign,White
TRUE,132,15+0,1032,1274,-242,B13,5,Mate,Black
TRUE,112,10+0,1199,1002,197,D20,5,Mate,Black
TRUE,20,10+0,1029,914,115,A00,1,Mate,Black
TRUE,128,10+0,1048,1077,-29,A40,1,Mate,Black
TRUE,33,10+0,1082,1070,12,B01,2,Resign,White
TRUE,141,10+0,1044,1080,-36,A04,2,Out of Time,White
TRUE,30,10+0,1070,1069,1,B01,2,Resign,White
FALSE,107,180+180,1206,1069,137,C40,3,Mate,White
TRUE,48,15+15,1099,1052,47,B01,6,Resign,Black
TRUE,6,15+15,1062,1071,-9,D00,4,Resign,Black
TRUE,19,15+15,1038,1074,-36,B01,6,Resign,White
TRUE,53,15+15,1266,1053,213,A04,2,Resign,White
TRUE,63,30+0,1099,1326,-227,D00,3,Resign,Black
TRUE,42,10+15,1141,1168,-27,B00,3,Resign,Black
TRUE,44,8+7,954,1166,-212,A04,2,Draw,Draw
TRUE,21,8+7,1196,946,250,B00,2,Draw,Draw
TRUE,37,8+7,937,1233,-296,A06,2,Draw,Draw
FALSE,39,5+5,1638,940,698,C02,7,Resign,White
TRUE,105,10+0,1649,1672,-23,D02,3,Resign,White
TRUE,80,10+0,1676,1637,39,C23,3,Resign,Black
TRUE,39,10+0,1711,1645,66,B00,5,Resign,White
TRUE,90,10+0,1655,1668,-13,B30,4,Resign,Black
TRUE,41,10+0,1666,1647,19,C40,4,Resign,Black
TRUE,69,10+0,1645,1655,-10,C50,5,Resign,Black
TRUE,21,10+0,1591,1647,-56,A04,2,Resign,Black
TRUE,103,10+0,1648,1672,-24,C46,5,Mate,White
TRUE,79,10+0,1595,1660,-65,D31,6,Resign,White
TRUE,31,10+0,1671,1671,0,C30,3,Resign,White
TRUE,25,10+0,1660,1665,-5,C46,5,Resign,White
TRUE,31,10+0,1682,1670,12,D06,3,Mate,White
TRUE,140,10+0,1683,1621,62,B46,10,Resign,Black
TRUE,148,10+0,1693,1693,0,B30,4,Mate,Black
TRUE,87,10+0,1730,1703,27,C55,6,Mate,White
TRUE,41,10+0,1799,1711,88,D06,3,Resign,White
FALSE,80,10+0,1143,1711,-568,C44,5,Mate,Black
TRUE,90,10+0,1686,1701,-15,C62,6,Resign,Black
TRUE,47,10+0,1711,1724,-13,C46,6,Resign,Black
TRUE,97,10+0,1701,1680,21,C00,3,Mate,White
TRUE,101,10+0,1964,1705,259,C23,3,Resign,White
TRUE,108,10+0,1720,1566,154,C40,4,Mate,Black
TRUE,132,10+0,1728,1798,-70,C42,5,Resign,Black
TRUE,94,10+0,1755,1717,38,C50,5,Mate,Black
TRUE,43,10+0,1704,1775,-71,C48,7,Resign,White
TRUE,61,10+0,1772,1713,59,C55,6,Resign,White
TRUE,41,10+0,1699,1800,-101,C48,7,Resign,White
TRUE,64,10+0,1610,1691,-81,C60,5,Resign,Black
TRUE,61,10+0,1679,1730,-51,B40,4,Mate,White
TRUE,58,10+0,1576,1671,-95,C20,3,Resign,Black
TRUE,33,10+0,1661,1675,-14,C00,3,Mate,White
TRUE,54,10+0,1661,1618,43,B44,8,Mate,Black
TRUE,60,10+0,1748,1647,101,C50,5,Resign,Black
TRUE,141,10+0,1637,1661,-24,B30,4,Mate,White
TRUE,57,10+0,1540,1629,-89,C34,6,Resign,Black
TRUE,127,10+0,1620,1549,71,C48,8,Resign,White
TRUE,103,10+0,1535,1634,-99,C25,5,Mate,White
TRUE,71,10+0,1347,1268,79,A00,1,Mate,White
TRUE,61,15+3,1400,1500,-100,B00,5,Mate,White
FALSE,60,5+8,1500,1072,428,C46,5,Mate,Black
TRUE,73,15+15,1258,1362,-104,B23,3,Mate,White
TRUE,80,15+15,1088,1350,-262,D01,5,Resign,Black
TRUE,108,15+20,1297,1330,-33,A21,4,Mate,Black
TRUE,72,10+10,1605,1367,238,B20,3,Resign,White
TRUE,100,25+0,1420,1620,-200,C30,3,Resign,Black
TRUE,105,8+5,1621,1325,296,C02,7,Draw,Draw
TRUE,98,20+5,1500,1501,-1,D02,4,Resign,Black
TRUE,35,10+0,1576,1539,37,C44,5,Resign,White
TRUE,29,10+0,1191,1598,-407,C20,3,Mate,White
TRUE,41,10+0,1595,1223,372,C41,6,Out of Time,White
TRUE,95,10+0,1301,1616,-315,C41,4,Out of Time,White
TRUE,79,10+0,1611,1371,240,C44,4,Out of Time,White
TRUE,46,10+0,1383,1606,-223,C22,6,Mate,Black
TRUE,81,10+0,1498,1597,-99,C45,7,Resign,Black
TRUE,69,10+0,1355,1592,-237,C27,3,Resign,Black
TRUE,76,10+0,1593,2216,-623,B06,7,Out of Time,Black
TRUE,108,10+0,1532,1583,-51,C41,6,Mate,Black
TRUE,75,10+0,1569,1349,220,C60,5,Mate,White
TRUE,87,10+0,1728,1576,152,A53,6,Out of Time,White
TRUE,111,10+0,1560,1686,-126,B00,3,Out of Time,White
TRUE,40,10+0,1550,1482,68,C02,7,Resign,White
TRUE,60,10+0,1553,1953,-400,C60,5,Resign,Black
TRUE,109,10+0,1775,1558,217,C77,9,Mate,White
TRUE,31,10+0,1549,1570,-21,C44,5,Mate,White
TRUE,60,10+0,1577,1874,-297,C41,4,Mate,Black
TRUE,52,10+0,1276,1573,-297,D00,4,Mate,Black
TRUE,87,10+0,1585,1569,16,B00,5,Resign,Black
TRUE,26,5+8,1408,1579,-171,C21,4,Resign,Black
TRUE,63,10+0,1575,1281,294,C40,4,Out of Time,White
TRUE,101,10+0,1814,1568,246,C30,4,Draw,Draw
TRUE,80,10+0,1585,1697,-112,B23,3,Out of Time,Black
TRUE,71,10+0,1574,1561,13,C41,6,Out of Time,White
TRUE,174,10+0,1528,1564,-36,C68,7,Mate,Black
TRUE,123,10+0,1651,1573,78,C46,5,Out of Time,White
TRUE,99,10+0,1569,1298,271,C41,5,Mate,White
TRUE,114,10+0,1390,1201,189,C00,3,Mate,Black
TRUE,57,10+0,1349,1403,-54,E20,6,Mate,White
TRUE,29,10+0,1418,1415,3,C20,3,Mate,White
TRUE,45,10+0,1403,1403,0,C50,8,Mate,White
TRUE,9,10+0,1395,1273,122,B00,2,Mate,White
TRUE,102,10+0,1408,1393,15,C40,4,Mate,Black
TRUE,114,7+2,1345,1398,-53,D01,7,Resign,Black
TRUE,67,7+2,1545,1405,140,C42,5,Mate,White
TRUE,128,7+2,1410,1629,-219,C57,8,Mate,Black
TRUE,12,7+2,1500,1378,122,C20,3,Resign,Black
TRUE,52,10+0,1232,1371,-139,A00,1,Resign,Black
TRUE,109,10+0,1372,1347,25,C41,5,Draw,Draw
TRUE,22,10+0,1384,1353,31,C50,5,Mate,Black
TRUE,41,10+0,1285,1400,-115,C20,4,Mate,White
TRUE,50,10+0,1412,1433,-21,C50,8,Mate,Black
TRUE,60,10+0,1416,1699,-283,B28,4,Resign,Black
TRUE,93,10+0,1406,1338,68,C41,5,Out of Time,White
TRUE,92,7+2,1564,1389,175,C24,5,Mate,Black
TRUE,56,7+2,1102,1385,-283,C20,3,Mate,Black
TRUE,122,7+2,1243,1378,-135,A41,2,Mate,Black
TRUE,111,7+2,1586,1383,203,C26,5,Mate,White
FALSE,68,4+6,1045,1383,-338,C20,4,Mate,Black
TRUE,42,4+6,1383,1045,338,C00,3,Mate,Black
TRUE,26,4+6,1383,1045,338,C00,3,Resign,Black
TRUE,77,4+6,1383,1045,338,C00,3,Mate,White
TRUE,45,4+6,1383,1045,338,C00,3,Mate,White
TRUE,112,8+0,1383,1045,338,C00,3,Draw,Draw
TRUE,52,8+0,1383,1045,338,C00,3,Mate,Black
TRUE,98,10+0,1500,1503,-3,C20,3,Resign,Black
TRUE,89,10+0,1980,1860,120,C11,11,Mate,White
TRUE,59,10+0,1171,1432,-261,A29,7,Mate,White
TRUE,113,10+0,1403,1364,39,C00,3,Mate,White
TRUE,62,10+0,1446,1359,87,C20,3,Resign,Black
TRUE,58,10+0,1369,1413,-44,C23,3,Mate,Black
TRUE,12,10+0,1468,1354,114,C20,3,Mate,Black
TRUE,84,8+0,1331,1434,-103,C23,3,Mate,Black
TRUE,33,10+0,1985,1009,976,C62,6,Resign,White
FALSE,63,10+0,1227,1009,218,C20,4,Mate,White
FALSE,41,10+0,1009,1227,-218,C00,3,Mate,White
TRUE,69,8+0,1344,1018,326,A00,1,Mate,White
FALSE,92,10+0,1018,1707,-689,B01,2,Resign,Black
FALSE,20,10+0,1018,1489,-471,B02,4,Resign,Black
FALSE,16,20+0,1018,1387,-369,C42,5,Resign,Black
FALSE,81,10+0,1500,1018,482,C62,6,Resign,White
TRUE,31,30+0,998,835,163,C42,5,Mate,White
TRUE,45,15+0,1055,1034,21,C26,5,Resign,White
FALSE,19,10+0,1166,1034,132,C50,5,Mate,White
FALSE,19,10+0,1100,1034,66,C46,7,Mate,White
TRUE,88,8+0,1009,1038,-29,A40,2,Out of Time,Draw
FALSE,124,180+0,1500,1038,462,C20,3,Mate,Black
FALSE,2,15+0,1038,1331,-293,B01,2,Out of Time,Black
FALSE,13,5+5,1653,1038,615,C44,4,Resign,White
FALSE,12,60+0,1038,1265,-227,C40,4,Resign,White
FALSE,25,10+0,955,1038,-83,A40,2,Resign,White
FALSE,46,8+0,1063,1779,-716,C00,3,Resign,Black
FALSE,26,10+0,1067,972,95,A00,1,Resign,White
FALSE,24,5+5,1072,1815,-743,D00,4,Resign,Black
TRUE,49,13+1,1324,1096,228,C26,6,Mate,White
TRUE,40,20+0,1150,1202,-52,A00,1,Resign,Black
FALSE,29,15+0,1918,1150,768,C60,6,Mate,White
TRUE,137,10+0,1352,1629,-277,C44,5,Mate,White
TRUE,14,8+0,1352,1364,-12,C20,3,Draw,Draw
TRUE,60,8+0,1353,1364,-11,C41,5,Resign,White
TRUE,44,8+0,1377,1340,37,B10,2,Mate,Black
TRUE,34,8+0,1351,1366,-15,C30,3,Mate,Black
TRUE,40,8+0,1363,1353,10,C40,3,Mate,Black
TRUE,113,10+0,1403,1364,39,C00,3,Mate,White
TRUE,38,10+0,1323,1365,-42,C20,3,Draw,Draw
TRUE,90,10+0,1287,1355,-68,A40,2,Resign,Black
TRUE,37,10+0,1345,1296,49,C20,3,Resign,White
TRUE,44,8+0,1331,1341,-10,B01,2,Mate,Black
TRUE,34,8+0,1343,1328,15,B01,4,Mate,Black
FALSE,34,8+0,1343,1328,15,B01,4,Resign,Black
TRUE,157,8+0,1293,1342,-49,C40,4,Mate,White
TRUE,45,10+0,1210,1334,-124,A00,1,Resign,Black
TRUE,31,10+0,1325,1218,107,A40,2,Mate,White
TRUE,102,15+15,1690,1712,-22,A00,1,Mate,Black
TRUE,32,15+15,1763,1628,135,A00,1,Resign,Black
TRUE,79,10+0,1776,1880,-104,B31,6,Mate,White
TRUE,29,10+0,1840,1785,55,D06,4,Resign,White
TRUE,75,10+0,1786,1795,-9,D93,11,Mate,White
TRUE,66,10+0,1711,1751,-40,B20,3,Resign,Black
TRUE,39,15+10,1848,1857,-9,D60,12,Resign,White
TRUE,44,15+10,1865,1990,-125,B30,4,Resign,Black
TRUE,38,15+10,1880,1828,52,C77,9,Resign,Black
TRUE,48,15+10,1835,1868,-33,B54,6,Resign,Black
TRUE,83,15+10,1854,1871,-17,B07,3,Resign,White
TRUE,45,15+10,1805,1870,-65,B21,3,Resign,White
TRUE,132,15+10,1873,1803,70,C60,6,Draw,Draw
TRUE,55,15+10,1989,1868,121,D43,8,Draw,Draw
TRUE,82,15+10,1884,1830,54,C40,6,Resign,Black
TRUE,100,15+10,1839,1871,-32,B23,3,Mate,Black
TRUE,142,15+15,1844,1857,-13,B20,3,Resign,Black
TRUE,85,15+10,1844,1809,35,C64,7,Resign,White
TRUE,54,15+10,1832,1829,3,B88,12,Resign,Black
TRUE,80,15+10,1844,1839,5,B30,4,Resign,Black
TRUE,99,15+10,1845,1841,4,B50,4,Draw,Draw
TRUE,100,15+10,1837,1828,9,D03,5,Resign,Black
TRUE,51,15+10,1810,1835,-25,B30,4,Resign,White
TRUE,69,20+5,1981,1818,163,A00,1,Resign,White
TRUE,106,15+10,1805,1800,5,B54,6,Resign,Black
TRUE,58,30+5,1815,1893,-78,B50,4,Resign,Black
TRUE,63,15+10,1946,1828,118,B50,4,Resign,White
TRUE,48,15+10,1843,1938,-95,B00,2,Resign,Black
TRUE,64,15+10,1859,1945,-86,B01,6,Mate,Black
TRUE,57,15+10,1825,1885,-60,B20,3,Resign,White
TRUE,24,15+10,1864,1833,31,C77,9,Resign,White
TRUE,123,15+10,1879,1863,16,D46,12,Draw,Draw
TRUE,54,15+10,1895,1813,82,C74,9,Resign,Black
TRUE,66,15+10,1812,1872,-60,B50,4,Resign,Black
TRUE,77,15+10,1906,1902,4,B54,6,Resign,White
TRUE,143,15+10,1873,1833,40,C62,6,Out of Time,White
TRUE,32,15+10,1916,1842,74,C77,9,Resign,Black
TRUE,39,15+10,1854,1880,-26,B54,6,Resign,Black
TRUE,79,15+10,1839,1819,20,C62,6,Resign,White
TRUE,84,15+10,1795,1789,6,B50,5,Resign,Black
TRUE,71,15+10,1717,1833,-116,B50,4,Resign,White
TRUE,97,15+10,1761,1712,49,B54,6,Draw,Draw
TRUE,38,15+10,1770,1789,-19,B50,4,Resign,White
TRUE,66,15+10,1890,1853,37,C62,6,Resign,Black
TRUE,59,15+10,1800,1750,50,B20,3,Resign,Black
TRUE,43,15+10,1500,1627,-127,B04,8,Resign,White
FALSE,91,10+10,1822,1431,391,C34,6,Mate,White
TRUE,63,60+0,1416,1216,200,C42,5,Mate,White
TRUE,77,60+0,1393,1337,56,C65,7,Mate,White
TRUE,13,10+0,1867,1399,468,C57,7,Resign,White
TRUE,62,10+0,1438,1407,31,C41,4,Out of Time,Black
TRUE,23,10+0,2009,1441,568,C44,5,Mate,White
TRUE,17,10+0,1460,1483,-23,C68,7,Resign,White
TRUE,44,10+0,1500,1762,-262,B41,8,Resign,Black
TRUE,33,10+0,1937,1507,430,C34,6,Resign,White
TRUE,30,10+0,1508,2364,-856,B90,11,Resign,Black
TRUE,46,10+0,1319,1480,-161,A00,1,Mate,Black
TRUE,42,10+0,1486,2125,-639,C78,9,Mate,Black
TRUE,90,10+0,1734,1402,332,A40,6,Resign,Black
TRUE,65,10+0,1915,1835,80,B27,4,Resign,White
TRUE,76,10+0,1853,1595,258,D35,6,Resign,Black
TRUE,69,10+0,2340,1857,483,D02,4,Mate,White
TRUE,48,10+0,1798,1848,-50,C50,6,Resign,Black
TRUE,66,10+0,1850,2192,-342,E30,7,Resign,Black
TRUE,72,10+0,1862,1846,16,D35,10,Resign,Black
TRUE,62,10+0,1788,1853,-65,C50,6,Mate,Black
TRUE,69,10+0,1846,1719,127,E30,7,Resign,White
TRUE,70,10+0,1551,1842,-291,D20,5,Resign,Black
TRUE,56,10+0,1852,1879,-27,B00,2,Mate,Black
TRUE,170,10+0,1819,1889,-70,D20,8,Resign,Black
TRUE,111,10+0,1880,1803,77,E77,8,Resign,White
TRUE,160,10+0,1935,1867,68,D25,7,Out of Time,Black
TRUE,108,10+0,1879,1841,38,A85,5,Resign,Black
TRUE,73,10+0,2231,1882,349,D02,3,Resign,White
TRUE,66,10+0,1850,1871,-21,D00,2,Resign,Black
TRUE,77,10+0,1870,1412,458,A40,2,Mate,White
TRUE,59,10+0,1949,1879,70,C21,5,Mate,White
TRUE,97,10+0,1324,1878,-554,D20,4,Resign,Black
TRUE,62,10+0,1889,1907,-18,C20,3,Resign,Black
TRUE,76,10+0,1708,1887,-179,C33,6,Out of Time,Black
TRUE,67,10+0,1841,1900,-59,C52,12,Mate,White
TRUE,3,10+0,1375,1332,43,D02,3,Out of Time,White
TRUE,77,10+0,1318,1395,-77,B06,4,Mate,White
TRUE,70,10+0,1331,1289,42,B23,5,Resign,Black
TRUE,39,10+0,1254,1322,-68,A40,4,Resign,Black
TRUE,63,15+15,1309,1336,-27,C02,6,Mate,White
TRUE,47,10+0,1326,1321,5,C20,3,Out of Time,White
TRUE,29,10+0,1308,1339,-31,C00,3,Mate,White
TRUE,41,10+0,1285,1321,-36,A40,2,Resign,White
TRUE,48,10+0,1270,1322,-52,D02,3,Mate,Black
TRUE,38,10+0,1327,1542,-215,C02,6,Mate,Black
TRUE,46,10+0,1328,1978,-650,C50,7,Mate,Black
TRUE,67,10+0,1550,1321,229,B01,2,Mate,White
TRUE,48,10+0,1322,1836,-514,B00,2,Resign,Black
TRUE,12,10+0,1328,1498,-170,C22,7,Resign,Black
TRUE,10,10+0,1358,1315,43,C41,5,Out of Time,Black
TRUE,30,10+0,1319,1633,-314,C41,5,Out of Time,Black
TRUE,48,10+0,1330,1345,-15,C02,5,Resign,Black
TRUE,18,10+0,1343,1369,-26,C55,6,Resign,Black
TRUE,13,10+0,1335,1355,-20,C41,5,Mate,White
TRUE,62,10+0,1140,1349,-209,C30,3,Resign,Black
TRUE,38,10+0,1350,1938,-588,C50,7,Resign,Black
TRUE,27,10+0,1360,1362,-2,A13,4,Out of Time,White
TRUE,49,10+0,1783,1364,419,C57,8,Resign,White
TRUE,36,10+0,1368,1635,-267,B30,5,Resign,Black
TRUE,36,10+0,1370,1838,-468,B01,4,Resign,Black
TRUE,1,10+0,1464,1355,109,A00,1,Resign,Black
TRUE,49,10+0,1341,1424,-83,B30,5,Resign,White
TRUE,37,10+0,1819,1345,474,C34,6,Resign,White
TRUE,95,10+0,1324,1795,-471,C44,4,Mate,White
TRUE,17,10+0,1318,1169,149,C40,4,Resign,White
TRUE,23,10+0,1743,1320,423,C41,5,Mate,White
TRUE,118,10+0,1329,1308,21,C33,5,Mate,Black
TRUE,12,10+0,1317,1392,-75,B01,4,Resign,Black
TRUE,41,10+0,1309,1213,96,C41,5,Resign,White
TRUE,16,10+0,1321,1259,62,B07,2,Resign,Black
TRUE,2,10+0,1336,1516,-180,B01,2,Out of Time,Black
TRUE,35,10+0,1375,1346,29,C40,4,Resign,White
TRUE,9,10+0,1398,1355,43,C40,4,Resign,White
TRUE,81,10+0,1346,1295,51,C24,4,Mate,White
TRUE,55,10+0,1351,1357,-6,C41,4,Out of Time,White
TRUE,2,150+180,1039,1161,-122,C20,2,Out of Time,Black
TRUE,2,150+180,1055,1280,-225,A00,1,Resign,Black
TRUE,8,10+0,1086,1148,-62,A00,1,Resign,Black
TRUE,62,10+0,1091,1958,-867,A00,1,Mate,Black
FALSE,4,180+180,1091,1171,-80,A00,1,Resign,Black
FALSE,2,180+180,1091,1529,-438,A00,1,Resign,Black
FALSE,2,180+180,1091,1701,-610,A00,1,Resign,White
FALSE,2,30+0,1091,1500,-409,A00,1,Resign,Black
TRUE,5,8+8,1674,1095,579,A00,1,Resign,White
TRUE,15,10+0,1907,1095,812,C00,4,Resign,White
TRUE,26,10+0,1185,1171,14,A00,1,Mate,Black
TRUE,38,10+0,1193,1636,-443,A00,1,Mate,Black
TRUE,69,3+12,1733,1199,534,A41,3,Mate,White
TRUE,44,20+5,1236,1373,-137,A00,1,Mate,Black
FALSE,37,7+3,2047,1236,811,B07,3,Mate,White
TRUE,64,7+10,1264,1506,-242,A00,1,Mate,Black
FALSE,1,10+60,2032,1223,809,B00,1,Out of Time,White
TRUE,2,9+1,1765,1234,531,A01,1,Resign,White
TRUE,26,9+1,1246,1753,-507,A40,2,Mate,Black
TRUE,12,9+1,1739,1260,479,A00,1,Resign,White
TRUE,14,9+1,1279,1720,-441,A01,1,Resign,Black
TRUE,73,9+1,1694,1305,389,A04,2,Mate,White
TRUE,3,9+1,1654,1345,309,A01,1,Resign,White
TRUE,6,9+1,1423,1576,-153,C00,3,Resign,Black
TRUE,26,9+1,1662,1337,325,A43,3,Draw,Draw
TRUE,3,10+0,1500,1500,0,A40,2,Resign,Black
FALSE,52,15+2,1500,1377,123,C44,8,Resign,Black
FALSE,68,15+2,1377,1500,-123,C02,6,Resign,Black
FALSE,61,15+2,1500,1377,123,C41,8,Mate,White
FALSE,19,15+2,2126,1500,626,C14,13,Resign,White
FALSE,36,15+2,1500,2126,-626,A45,2,Resign,Black
FALSE,34,15+2,2126,1500,626,C70,8,Resign,White
FALSE,46,15+2,1500,2126,-626,B98,14,Resign,Black
FALSE,110,15+2,1500,2126,-626,B98,14,Mate,Black
FALSE,138,15+0,1537,1500,37,B20,3,Out of Time,Black
FALSE,68,15+0,1500,1537,-37,C55,6,Mate,Black
FALSE,125,15+0,1500,1619,-119,C50,5,Resign,White
TRUE,84,8+0,1026,1864,-838,D00,4,Mate,Black
FALSE,31,10+0,1513,1026,487,A40,2,Resign,White
FALSE,119,10+0,1519,1026,493,C27,3,Resign,White
FALSE,32,10+0,1026,1369,-343,C20,3,Mate,Black
FALSE,90,10+0,1026,1916,-890,A00,2,Mate,Black
TRUE,54,15+15,1145,1040,105,B01,2,Resign,White
TRUE,64,5+8,1043,1539,-496,D00,3,Mate,Black
TRUE,73,5+8,1878,1043,835,A21,3,Mate,White
TRUE,171,11+0,1666,1044,622,C41,5,Mate,White
TRUE,13,5+8,1856,1045,811,C23,4,Mate,White
TRUE,14,5+40,1382,1009,373,A00,1,Out of Time,Black
TRUE,72,5+30,1547,971,576,C00,3,Resign,Black
FALSE,52,5+8,971,1500,-529,B01,2,Mate,Black
FALSE,114,5+8,971,1629,-658,B06,2,Mate,Black
TRUE,21,12+0,981,1181,-200,C00,4,Resign,Black
TRUE,49,10+7,982,1700,-718,C20,3,Resign,Black
TRUE,81,10+7,1700,982,718,C41,5,Mate,White
FALSE,9,6+5,1735,982,753,C20,3,Mate,White
FALSE,61,10+0,982,1136,-154,C20,3,Resign,Black
TRUE,31,10+0,1371,1457,-86,C40,4,Resign,Black
TRUE,39,10+0,1883,1373,510,C70,10,Resign,White
TRUE,60,10+0,1344,1696,-352,C40,4,Resign,White
TRUE,52,10+0,1348,1725,-377,B54,6,Resign,Black
TRUE,35,10+0,1863,1349,514,C70,8,Resign,White
TRUE,24,10+0,1460,1327,133,C64,6,Mate,Black
TRUE,19,10+0,1338,1344,-6,A00,1,Resign,White
TRUE,34,10+0,1359,1411,-52,B01,2,Resign,Black
TRUE,13,10+0,1829,1361,468,C34,6,Resign,White
TRUE,30,10+0,1365,1708,-343,B01,4,Resign,Black
TRUE,94,10+0,1366,2301,-935,B43,9,Resign,Black
TRUE,6,10+0,1254,1353,-99,C44,5,Resign,Black
TRUE,64,10+0,1369,1408,-39,B40,4,Mate,Black
TRUE,15,10+0,1344,1390,-46,C50,8,Mate,White
TRUE,15,10+0,1512,1403,109,C44,5,Mate,White
TRUE,58,10+0,1405,2016,-611,C58,11,Mate,Black
TRUE,66,10+0,1412,1679,-267,C41,5,Resign,Black
TRUE,19,10+0,1479,1387,92,C00,3,Resign,Black
TRUE,39,10+0,1889,1389,500,A40,2,Mate,White
TRUE,37,10+0,1392,1816,-424,C50,6,Resign,Black
TRUE,29,10+0,1817,1396,421,C34,5,Mate,White
TRUE,22,10+0,1760,1358,402,C50,5,Mate,Black
TRUE,50,10+0,1360,1873,-513,C50,7,Resign,Black
TRUE,56,10+0,1383,1352,31,B30,4,Resign,Black
TRUE,30,10+0,1536,1350,186,A00,5,Mate,Black
TRUE,34,10+0,1356,1708,-352,B12,5,Resign,Black
TRUE,58,10+0,1376,1418,-42,C50,8,Resign,Black
TRUE,76,10+0,1333,1876,-543,B45,9,Mate,Black
TRUE,28,10+0,1313,1335,-22,C70,8,Draw,Draw
TRUE,36,10+0,1349,1534,-185,C57,8,Resign,Black
TRUE,33,10+0,2086,1350,736,C67,11,Resign,White
TRUE,44,10+0,1370,1469,-99,C57,10,Resign,Black
TRUE,50,10+0,1406,1321,85,B30,4,Resign,Black
TRUE,14,10+0,1410,1882,-472,B27,4,Resign,Black
TRUE,59,10+0,1241,1460,-219,D00,3,Resign,White
TRUE,68,10+0,1370,1425,-55,C20,3,Out of Time,Black
TRUE,35,10+0,1384,1380,4,C41,5,Resign,White
TRUE,65,10+0,1435,1429,6,C44,5,Resign,White
TRUE,59,10+0,1469,1485,-16,C44,8,Mate,White
TRUE,61,10+0,1494,1433,61,C23,3,Draw,Draw
TRUE,45,10+0,1555,1607,-52,B00,3,Resign,Black
TRUE,56,10+0,1437,1475,-38,C20,3,Mate,Black
TRUE,25,10+0,1346,1361,-15,B00,5,Resign,Black
TRUE,86,5+8,1393,1357,36,D01,5,Mate,Black
TRUE,68,5+8,1368,1381,-13,C22,6,Resign,Black
TRUE,100,5+8,1375,1529,-154,B12,3,Resign,Black
TRUE,57,5+8,1590,1380,210,B01,4,Mate,White
TRUE,21,5+8,1371,1291,80,C44,5,Out of Time,White
TRUE,54,5+8,1135,1366,-231,D02,4,Resign,Black
TRUE,145,5+8,1741,1371,370,B01,4,Mate,White
TRUE,113,5+8,1363,1250,113,A30,2,Resign,White
TRUE,46,5+8,1347,1800,-453,C21,5,Mate,Black
TRUE,66,5+8,1349,1832,-483,C22,6,Mate,Black
TRUE,75,5+8,1343,1165,178,B00,7,Mate,White
TRUE,51,5+8,1326,1355,-29,B02,4,Resign,White
TRUE,84,5+8,1354,1423,-69,C21,3,Resign,Black
TRUE,47,5+8,1635,1358,277,A00,2,Mate,White
TRUE,60,5+8,1540,1341,199,C22,7,Mate,Black
TRUE,89,10+8,1329,1358,-29,B00,6,Resign,White
TRUE,104,10+8,1331,1746,-415,C49,8,Mate,Black
TRUE,51,10+8,1321,1267,54,B01,4,Mate,White
TRUE,44,10+8,1334,1277,57,B01,4,Resign,Black
TRUE,107,10+8,1324,1280,44,B01,4,Mate,White
TRUE,49,10+8,1368,1334,34,A00,1,Resign,White
TRUE,100,10+8,1340,1548,-208,C00,4,Mate,Black
TRUE,110,10+8,1348,1460,-112,C00,3,Resign,Black
TRUE,151,10+8,1335,1371,-36,B00,3,Mate,White
TRUE,30,10+8,1345,1400,-55,C22,6,Mate,Black
TRUE,59,10+8,1341,1056,285,C48,9,Mate,White
TRUE,43,10+8,1376,1351,25,C65,6,Mate,White
TRUE,85,10+8,1337,1523,-186,C22,6,Out of Time,White
TRUE,60,10+8,1313,1349,-36,C40,4,Resign,White
TRUE,44,10+8,1359,1391,-32,B00,7,Mate,Black
TRUE,80,10+8,1216,1352,-136,C25,4,Resign,Black
TRUE,40,10+8,1160,1369,-209,A00,1,Resign,White
TRUE,102,10+8,1374,1357,17,B01,4,Mate,Black
TRUE,34,10+8,1369,1364,5,A00,4,Mate,Black
TRUE,72,10+8,1373,1639,-266,C21,3,Resign,Black
TRUE,41,10+8,1468,1381,87,C57,7,Resign,White
TRUE,84,10+8,1385,1670,-285,B06,8,Mate,Black
TRUE,36,10+8,1392,1549,-157,B01,6,Mate,Black
TRUE,179,10+8,1303,1406,-103,B01,4,Mate,White
TRUE,27,10+8,1398,1312,86,C27,3,Mate,White
TRUE,39,10+8,1297,1413,-116,C40,4,Mate,White
TRUE,57,10+8,1400,1529,-129,B21,3,Resign,White
TRUE,127,10+8,1398,1465,-67,B21,3,Draw,Draw
TRUE,68,10+8,1403,1613,-210,C22,6,Mate,Black
TRUE,68,5+8,1408,1628,-220,C21,5,Mate,Black
TRUE,56,5+8,1419,1449,-30,C22,6,Mate,Black
TRUE,96,5+8,1432,1382,50,A04,2,Mate,Black
TRUE,97,20+0,1444,1476,-32,C62,6,Resign,White
FALSE,36,15+15,1476,1652,-176,D02,4,Mate,Black
FALSE,75,15+15,1492,1476,16,D00,3,Resign,Black
TRUE,56,10+1,1479,1806,-327,D05,6,Mate,Black
TRUE,39,30+2,1740,1485,255,D26,8,Resign,White
TRUE,39,20+30,1581,1495,86,D00,3,Resign,White
TRUE,19,15+0,1597,1504,93,D30,4,Resign,White
TRUE,143,30+3,1684,1511,173,C62,6,Resign,White
TRUE,23,14+10,1579,1522,57,D06,4,Resign,White
TRUE,118,25+10,1502,1695,-193,C41,5,Resign,White
TRUE,34,10+10,1507,1757,-250,D02,4,Resign,Black
TRUE,55,15+15,1605,1517,88,C50,8,Resign,White
FALSE,35,10+2,1748,1537,211,C53,7,Resign,White
TRUE,54,15+0,1547,1626,-79,A15,4,Resign,Black
TRUE,11,15+5,1353,1568,-215,C20,3,Resign,White
TRUE,18,10+5,1589,1386,203,D02,4,Resign,Black
TRUE,11,10+5,1369,1611,-242,C45,8,Resign,White
TRUE,117,5+8,1721,1621,100,C62,6,Resign,White
TRUE,40,7+3,1635,1631,4,A04,2,Mate,Black
TRUE,38,10+2,1533,1624,-91,C50,9,Mate,Black
TRUE,88,10+5,1633,1777,-144,D02,3,Resign,Black
TRUE,62,5+5,1649,1606,43,A06,3,Resign,Black
FALSE,37,15+5,1646,1649,-3,C62,6,Resign,Black
FALSE,62,5+30,1500,1649,-149,C20,3,Mate,Black
FALSE,23,10+0,1307,1649,-342,A03,2,Resign,White
FALSE,59,10+0,1649,1230,419,D02,4,Mate,White
TRUE,88,5+8,1673,1633,40,A00,1,Mate,Black
TRUE,5,10+0,1821,1641,180,C30,3,Resign,White
TRUE,45,5+8,1649,1838,-189,D02,3,Resign,Black
TRUE,41,30+0,1466,1673,-207,C22,6,Mate,White
TRUE,41,10+0,1742,1785,-43,C44,7,Out of Time,White
TRUE,89,10+0,1650,1756,-106,A45,2,Mate,White
TRUE,84,7+2,1629,1749,-120,B22,3,Mate,Black
FALSE,100,10+0,1519,1749,-230,B50,4,Draw,Draw
TRUE,70,10+0,1851,1887,-36,C01,5,Resign,Black
TRUE,52,10+0,1874,1774,100,C01,5,Resign,Black
TRUE,50,10+0,1891,1793,98,B01,4,Resign,Black
TRUE,87,10+0,1876,1810,66,B13,5,Resign,White
TRUE,52,10+0,1745,1862,-117,D02,4,Resign,Black
TRUE,127,10+0,1833,1738,95,C02,11,Out of Time,White
TRUE,54,10+0,1637,1821,-184,A01,2,Mate,Black
TRUE,64,10+0,1587,1811,-224,B12,7,Out of Time,Black
TRUE,43,10+0,1861,1960,-99,C12,11,Resign,Black
TRUE,51,10+0,1882,1873,9,B13,12,Out of Time,White
TRUE,57,10+0,1946,1884,62,B13,12,Mate,White
TRUE,133,10+0,1885,1837,48,B46,10,Draw,Draw
TRUE,92,10+0,1796,1875,-79,B50,5,Out of Time,Black
TRUE,36,10+0,1884,2004,-120,B06,4,Resign,Black
TRUE,39,10+0,1863,1899,-36,D02,5,Resign,White
FALSE,63,8+0,1581,1232,349,C22,6,Out of Time,White
FALSE,55,8+0,1581,1232,349,C21,3,Out of Time,White
FALSE,40,8+0,1232,1581,-349,B70,10,Out of Time,Black
FALSE,87,8+1,1232,1581,-349,D02,4,Mate,White
TRUE,71,10+2,1500,1238,262,B21,3,Out of Time,White
TRUE,64,5+8,1188,1259,-71,B23,3,Resign,White
FALSE,60,30+0,1515,1615,-100,B23,3,Resign,Black
FALSE,34,30+0,1615,1515,100,A48,5,Resign,Black
TRUE,73,10+5,1277,1464,-187,A45,2,Resign,Black
TRUE,23,10+5,1371,1284,87,C41,5,Resign,White
FALSE,20,20+0,1500,1371,129,B21,3,Mate,Black
TRUE,64,10+0,1372,1440,-68,B23,3,Resign,Black
FALSE,63,45+45,2131,1431,700,D00,4,Resign,White
TRUE,54,15+15,1426,1447,-21,C44,12,Resign,White
TRUE,50,15+15,1485,1403,82,B52,6,Mate,Black
TRUE,44,20+0,1401,1382,19,B20,3,Mate,Black
TRUE,37,20+0,1392,1608,-216,A22,5,Resign,Black
TRUE,21,20+0,1603,1402,201,C50,9,Resign,White
FALSE,149,10+5,1402,1341,61,C70,8,Mate,White
FALSE,94,15+10,1116,1402,-286,A30,2,Resign,Black
FALSE,61,15+10,1116,1402,-286,A03,2,Resign,White
FALSE,21,15+10,1116,1402,-286,B75,13,Resign,White
FALSE,50,15+10,1116,1402,-286,B57,8,Mate,Black
FALSE,30,15+10,1402,1116,286,A41,4,Resign,Black
FALSE,55,14+0,1402,1569,-167,A10,2,Mate,White
TRUE,57,10+0,1737,1408,329,A38,13,Resign,White
TRUE,48,10+0,1431,1426,5,A10,2,Resign,Black
TRUE,21,10+0,1455,1448,7,A10,2,Resign,Black
TRUE,35,10+0,1859,1460,399,B21,5,Resign,White
TRUE,43,10+0,1501,1484,17,A45,2,Resign,White
TRUE,111,10+0,1457,1449,8,A15,2,Mate,White
TRUE,49,10+0,1419,1544,-125,A20,2,Out of Time,White
FALSE,40,15+10,1419,1865,-446,A20,2,Out of Time,Black
TRUE,57,15+10,1433,1653,-220,A30,2,Resign,Black
TRUE,14,25+0,1781,1441,340,A09,4,Resign,White
TRUE,19,7+7,1639,1807,-168,C55,7,Resign,White
TRUE,45,10+1,1807,1798,9,A10,2,Resign,White
TRUE,109,20+8,1889,1807,82,B93,11,Out of Time,White
TRUE,18,15+0,1807,1687,120,D05,6,Resign,Black
TRUE,45,10+10,1639,1807,-168,A20,2,Mate,White
TRUE,86,20+0,1630,1723,-93,B90,11,Mate,Black
TRUE,61,15+1,1555,1575,-20,D02,3,Mate,White
FALSE,35,10+0,1555,1755,-200,D02,3,Resign,White
FALSE,42,15+10,1881,1555,326,D15,8,Resign,Black
FALSE,79,25+0,1555,1412,143,B06,4,Mate,White
FALSE,54,25+0,1412,1555,-143,A00,2,Mate,Black
TRUE,89,30+30,1293,2123,-830,C50,6,Mate,White
TRUE,25,30+30,2118,1294,824,D02,4,Resign,White
TRUE,28,30+30,1295,2112,-817,C41,8,Resign,Black
TRUE,35,8+0,1500,2154,-654,A46,5,Mate,White
FALSE,30,7+7,2075,2140,-65,B45,10,Resign,White
TRUE,125,10+15,1848,2264,-416,B01,4,Resign,White
TRUE,137,10+0,2056,2264,-208,B01,4,Resign,White
TRUE,140,8+2,2264,1639,625,B57,12,Draw,Draw
TRUE,52,10+0,2366,2264,102,B01,6,Resign,Black
FALSE,19,45+0,2030,2264,-234,B01,6,Resign,Black
TRUE,92,10+0,1778,2264,-486,C77,9,Mate,Black
FALSE,36,10+0,1778,2264,-486,C70,8,Resign,Black
FALSE,35,10+0,2264,1778,486,B43,9,Mate,White
FALSE,14,10+0,1778,2264,-486,B01,4,Mate,Black
TRUE,41,10+0,2264,1778,486,B43,9,Resign,White
TRUE,46,10+0,2016,2264,-248,C18,13,Mate,Black
TRUE,63,10+0,2264,2016,248,C11,13,Resign,White
TRUE,173,10+0,2225,2264,-39,C42,15,Out of Time,Draw
TRUE,37,15+0,1305,2264,-959,C55,7,Resign,Black
FALSE,57,20+0,2264,1841,423,D02,5,Mate,White
FALSE,52,20+0,1841,2264,-423,D02,5,Resign,Black
FALSE,51,20+0,2264,1841,423,B01,6,Mate,White
TRUE,50,20+0,1841,2264,-423,A00,1,Resign,Black
TRUE,54,20+0,1855,2264,-409,C42,5,Out of Time,Black
TRUE,45,10+0,2264,1529,735,C01,5,Resign,White
FALSE,17,10+0,2264,1753,511,C27,3,Mate,White
FALSE,29,10+0,2264,1753,511,C40,4,Resign,White
FALSE,68,10+0,1753,2264,-511,C23,4,Resign,Black
FALSE,13,10+0,2264,1753,511,C27,3,Mate,White
FALSE,48,10+0,1753,2264,-511,C01,5,Resign,Black
FALSE,33,10+0,2264,1753,511,C40,4,Resign,White
FALSE,25,10+0,2264,1713,551,A43,5,Mate,White
FALSE,58,15+0,1455,2264,-809,B23,5,Resign,Black
FALSE,97,15+0,2264,1455,809,E44,9,Out of Time,White
FALSE,70,15+0,1455,2264,-809,E32,7,Resign,Black
FALSE,59,15+0,2264,1455,809,C62,6,Resign,White
TRUE,46,15+0,1455,2264,-809,B12,7,Resign,Black
FALSE,67,5+5,2264,1871,393,B22,3,Resign,White
TRUE,38,5+5,1871,2264,-393,A00,1,Resign,Black
TRUE,64,15+0,1615,2264,-649,D00,5,Resign,Black
FALSE,57,15+0,2264,1871,393,C41,8,Resign,White
FALSE,71,15+0,1871,2264,-393,C53,9,Resign,Black
TRUE,55,15+0,2264,1871,393,C41,8,Resign,White
TRUE,74,15+0,1885,2261,-376,B20,3,Resign,Black
TRUE,75,30+5,2249,2153,96,A00,2,Resign,White
TRUE,133,30+0,2188,2234,-46,C65,6,Resign,Black
TRUE,55,30+0,2218,2198,20,A07,3,Resign,White
TRUE,19,10+0,1466,1046,420,C55,6,Resign,White
TRUE,33,10+0,1457,1395,62,B31,6,Resign,White
TRUE,122,10+0,1349,1449,-100,D00,3,Mate,Black
TRUE,208,10+0,1465,1449,16,D50,9,Out of Time,Draw
TRUE,48,10+0,1316,1442,-126,D32,10,Resign,Black
TRUE,61,10+0,1434,1321,113,B52,6,Mate,White
TRUE,46,10+0,2026,1864,162,A04,2,Resign,White
TRUE,55,10+0,2021,1806,215,A04,2,Resign,White
TRUE,103,10+0,2016,2032,-16,A45,3,Resign,White
TRUE,99,10+0,2024,1933,91,A04,2,Out of Time,White
TRUE,48,10+0,1892,2018,-126,B95,12,Mate,Black
TRUE,145,10+0,2008,1986,22,A04,2,Resign,White
TRUE,84,10+0,1830,2003,-173,E90,11,Resign,Black
TRUE,42,10+0,1985,1993,-8,B50,4,Resign,Black
TRUE,35,10+0,1980,2071,-91,A08,4,Resign,White
TRUE,64,10+0,2064,1968,96,A48,5,Resign,Black
TRUE,113,10+0,1958,1952,6,A04,2,Out of Time,White
TRUE,50,10+0,1720,1943,-223,B90,11,Resign,Black
TRUE,57,10+0,1937,1792,145,A07,3,Resign,White
TRUE,21,10+0,1930,1810,120,A04,2,Resign,White
TRUE,66,10+0,1950,1920,30,B22,3,Mate,Black
TRUE,34,10+0,1802,1913,-111,B50,4,Mate,Black
TRUE,73,10+0,1903,1887,16,A04,2,Resign,White
TRUE,148,10+0,1901,1893,8,B90,10,Out of Time,Black
TRUE,119,10+0,1829,1905,-76,B57,8,Out of Time,White
TRUE,130,10+0,1903,1969,-66,A05,10,Draw,Draw
TRUE,37,10+0,1954,1912,42,E73,12,Mate,White
TRUE,108,10+0,1927,1916,11,A04,2,Mate,Black
TRUE,149,10+0,1874,1939,-65,B22,8,Mate,White
TRUE,103,10+0,1899,1950,-51,E70,9,Out of Time,White
TRUE,158,10+0,1952,1907,45,A04,2,Out of Time,Draw
TRUE,70,10+0,1957,2136,-179,A04,2,Resign,Black
TRUE,111,10+0,2007,1966,41,B21,3,Resign,White
TRUE,80,10+0,1970,1835,135,A04,2,Draw,Draw
TRUE,113,10+0,1989,1980,9,B90,10,Out of Time,White
TRUE,78,10+0,1810,1974,-164,B90,11,Resign,Black
TRUE,81,10+0,1973,2003,-30,A08,4,Draw,Draw
TRUE,77,10+0,2069,1969,100,B86,11,Resign,White
TRUE,17,10+0,1958,1996,-38,A04,2,Resign,White
TRUE,39,10+0,1951,1862,89,A04,2,Resign,White
TRUE,104,10+0,2066,1937,129,A49,4,Resign,Black
TRUE,135,10+0,1869,1939,-70,B20,3,Out of Time,Draw
TRUE,110,10+0,1948,1948,0,A04,2,Resign,Black
TRUE,119,10+0,1937,1959,-22,B53,7,Mate,White
TRUE,29,10+0,1950,1901,49,A08,4,Resign,White
TRUE,122,10+0,1726,1946,-220,A45,2,Resign,Black
TRUE,109,10+0,1941,1916,25,A05,4,Draw,Draw
TRUE,151,10+0,1859,1954,-95,B20,3,Out of Time,White
TRUE,71,10+0,1975,1964,11,B92,11,Resign,White
TRUE,77,10+0,1956,1854,102,A04,2,Resign,White
TRUE,119,10+0,1785,1971,-186,B20,3,Resign,White
TRUE,53,10+0,1960,2000,-40,A04,2,Resign,White
FALSE,63,10+0,1949,1474,475,B50,5,Resign,White
FALSE,31,19+0,1474,1623,-149,B84,12,Resign,White
FALSE,58,10+5,1702,1474,228,B50,4,Mate,Black
FALSE,46,2+10,1474,2014,-540,A20,2,Mate,Black
FALSE,84,5+5,1500,1474,26,A45,2,Mate,Black
FALSE,56,10+7,1363,1474,-111,B21,3,Mate,Black
FALSE,24,15+0,1390,1474,-84,A45,2,Resign,White
FALSE,65,9+12,1474,1254,220,C69,10,Resign,White
FALSE,62,10+0,1495,1474,21,B20,3,Mate,Black
FALSE,6,40+20,1500,1474,26,B23,3,Draw,Draw
FALSE,29,8+15,1820,1474,346,B52,6,Resign,White
FALSE,90,15+30,1474,2010,-536,B00,5,Draw,Draw
FALSE,27,15+5,1474,1624,-150,B35,14,Resign,White
FALSE,78,5+5,1767,1474,293,D94,9,Resign,Black
FALSE,145,5+8,1474,1607,-133,C62,6,Mate,White
TRUE,46,10+0,1487,1562,-75,D00,2,Mate,Black
TRUE,120,10+0,1254,1461,-207,A00,1,Mate,Black
TRUE,46,10+0,1514,1560,-46,A03,2,Mate,Black
TRUE,93,10+0,1572,1590,-18,B01,6,Mate,White
TRUE,52,10+0,1503,1498,5,B01,2,Mate,Black
TRUE,70,10+0,1629,1603,26,C00,4,Resign,Black
TRUE,75,10+0,1500,1393,107,D00,8,Out of Time,White
TRUE,48,15+15,1873,2105,-232,D00,4,Resign,Black
TRUE,53,15+15,2065,1879,186,B07,3,Resign,White
TRUE,25,15+15,1886,2001,-115,D00,5,Resign,Black
TRUE,71,15+15,1797,2083,-286,A15,4,Out of Time,White
TRUE,27,15+15,1500,1500,0,D21,6,Resign,White
FALSE,77,5+8,1128,795,333,A00,2,Mate,White
FALSE,130,9+3,1128,2177,-1049,A00,2,Mate,Black
TRUE,85,20+1,1114,1189,-75,A00,1,Resign,White
TRUE,51,20+1,1191,1111,80,A00,1,Draw,Draw
FALSE,53,60+0,1111,921,190,A00,4,Mate,White
FALSE,36,10+0,897,1111,-214,B06,2,Resign,Black
FALSE,26,10+0,1111,897,214,A00,1,Resign,White
TRUE,52,10+10,1099,1124,-25,A04,2,Resign,White
TRUE,139,10+0,1115,1013,102,A00,1,Mate,White
FALSE,72,10+0,1099,1115,-16,B06,2,Mate,Black
FALSE,142,10+0,1099,1115,-16,B06,2,Mate,Black
TRUE,60,0+25,1136,843,293,A00,2,Mate,Black
TRUE,23,0+25,798,1157,-359,B06,2,Resign,White
FALSE,9,30+30,2419,1157,1262,B30,5,Resign,White
TRUE,43,15+5,1151,964,187,A00,1,Mate,White
TRUE,34,7+2,1113,1581,-468,C20,3,Mate,Black
TRUE,38,15+0,1098,1202,-104,C41,6,Resign,White
TRUE,23,15+15,1083,1218,-135,C44,5,Mate,White
TRUE,6,15+15,1091,1203,-112,B20,3,Resign,Black
TRUE,37,15+15,1236,1098,138,C45,7,Mate,White
TRUE,19,15+15,1112,1109,3,C20,3,Resign,White
TRUE,21,15+15,1188,1118,70,D00,3,Mate,White
TRUE,65,15+15,1116,1173,-57,B01,2,Draw,Draw
TRUE,28,15+15,1139,1104,35,C44,5,Mate,Black
TRUE,19,15+15,1100,1116,-16,C65,6,Resign,White
TRUE,47,20+5,1614,1711,-97,B07,2,Resign,White
TRUE,30,20+5,1623,1701,-78,B07,7,Resign,Black
TRUE,100,10+5,1716,1659,57,D10,5,Resign,Black
TRUE,71,10+5,1794,1714,80,E76,11,Draw,Draw
TRUE,29,10+3,1749,1726,23,B07,4,Resign,White
TRUE,43,10+2,1711,1760,-49,D35,7,Resign,White
TRUE,35,10+5,1700,1625,75,D15,7,Resign,White
TRUE,32,15+10,1689,1593,96,D32,10,Resign,White
TRUE,85,10+5,1663,1705,-42,A01,2,Resign,White
TRUE,112,10+5,1695,1691,4,B08,8,Resign,Black
TRUE,34,10+5,1676,1684,-8,A40,2,Resign,White
TRUE,38,10+5,1696,1659,37,B07,2,Mate,Black
TRUE,25,10+5,1651,1466,185,D21,5,Mate,White
TRUE,15,8+5,1635,1647,-12,A40,2,Out of Time,White
TRUE,41,0+15,1525,1657,-132,B07,2,Resign,White
TRUE,49,15+16,1640,1650,-10,D06,8,Mate,White
TRUE,68,10+5,1782,1651,131,B07,2,Resign,White
TRUE,51,20+0,1630,1697,-67,D35,7,Resign,White
TRUE,50,20+0,1674,1655,19,A50,4,Mate,Black
TRUE,45,20+0,1643,1696,-53,D10,4,Resign,White
TRUE,92,15+5,1708,1864,-156,A52,7,Resign,Black
TRUE,70,15+6,1760,1683,77,D00,3,Mate,Black
TRUE,86,8+6,1839,1651,188,D10,5,Resign,Black
TRUE,54,8+6,1664,1820,-156,E20,5,Mate,Black
TRUE,45,20+1,1641,1645,-4,D21,6,Resign,White
TRUE,42,20+1,1657,1614,43,B07,7,Resign,Black
TRUE,25,8+6,1700,1635,65,B07,2,Mate,White
TRUE,45,8+6,1602,1671,-69,D02,4,Resign,White
TRUE,70,8+8,1655,1566,89,E61,6,Resign,Black
TRUE,136,10+0,1582,1770,-188,E20,8,Mate,Black
TRUE,40,10+7,1648,1591,57,B07,4,Resign,Black
TRUE,44,10+6,1629,1586,43,B07,4,Draw,Draw
TRUE,58,25+8,1480,1551,-71,B07,7,Resign,Black
TRUE,52,15+5,1577,1763,-186,A53,6,Mate,Black
TRUE,74,15+5,1614,1732,-118,D10,5,Mate,Black
TRUE,63,15+0,1890,1639,251,B08,9,Resign,White
TRUE,88,10+5,1642,1638,4,B07,2,Draw,Draw
TRUE,85,10+5,1549,1551,-2,D32,6,Resign,White
TRUE,65,10+5,1652,1674,-22,A45,2,Resign,White
TRUE,81,10+5,1500,1497,3,D10,5,Resign,White
TRUE,68,15+14,1871,1774,97,E24,9,Resign,Black
TRUE,56,15+14,1201,1871,-670,D00,2,Resign,Black
TRUE,75,15+14,1870,1202,668,A40,2,Mate,White
TRUE,14,15+14,1573,1866,-293,B01,4,Mate,Black
TRUE,68,15+14,1771,1857,-86,A10,2,Resign,Black
TRUE,24,15+14,1630,1851,-221,D15,7,Resign,Black
TRUE,21,15+14,1799,1866,-67,B01,4,Resign,White
TRUE,18,15+14,1585,1861,-276,C00,3,Resign,Black
TRUE,43,15+14,1857,1590,267,C01,5,Resign,White
TRUE,41,15+14,1594,1852,-258,B01,4,Resign,Black
TRUE,16,15+14,1873,1574,299,A52,7,Mate,Black
TRUE,57,15+14,1875,1821,54,D43,8,Draw,Draw
TRUE,75,15+14,1875,1074,801,D20,5,Mate,White
TRUE,48,15+14,1887,1892,-5,D31,5,Resign,Black
TRUE,41,15+14,1880,1781,99,A43,3,Mate,White
TRUE,54,15+14,1825,1869,-44,C00,3,Resign,Black
TRUE,93,10+0,1940,1879,61,B01,4,Resign,White
TRUE,64,10+0,1815,1882,-67,A00,1,Draw,Draw
TRUE,57,15+14,1878,1534,344,A40,2,Mate,White
TRUE,22,15+14,1873,1630,243,D37,7,Resign,White
TRUE,73,15+14,1757,1891,-134,B01,4,Resign,White
TRUE,53,15+14,1887,1564,323,D07,5,Mate,White
TRUE,60,15+14,1426,1885,-459,B01,2,Mate,Black
TRUE,95,15+14,1879,1671,208,D02,8,Resign,White
TRUE,89,15+14,1872,1708,164,D43,8,Resign,White
TRUE,58,15+14,1900,1900,0,D31,16,Resign,Black
TRUE,74,15+14,1923,1211,712,D41,9,Resign,Black
TRUE,73,15+14,1907,1677,230,D31,6,Out of Time,White
TRUE,42,15+14,1683,1901,-218,D00,4,Resign,Black
TRUE,55,15+14,1730,1893,-163,C00,3,Resign,Black
TRUE,45,15+14,1886,1737,149,A40,2,Resign,White
TRUE,47,15+14,1720,1905,-185,A06,3,Resign,White
TRUE,27,15+14,1903,1454,449,D06,4,Mate,White
TRUE,67,15+14,1894,1775,119,A85,5,Resign,White
TRUE,55,15+14,1889,1641,248,D31,5,Mate,White
TRUE,29,15+14,1883,1646,237,D44,9,Resign,White
TRUE,50,15+14,1651,1878,-227,B01,4,Mate,Black
TRUE,50,10+15,1217,1259,-42,A04,2,Mate,Black
TRUE,52,10+15,1271,1517,-246,A04,2,Mate,Black
TRUE,28,10+15,1500,1406,94,A06,3,Mate,Black
TRUE,8,10+0,1132,1258,-126,A00,1,Resign,Black
TRUE,22,10+0,1303,1248,55,B01,2,Mate,Black
TRUE,84,10+0,1257,1296,-39,C20,3,Mate,Black
TRUE,25,10+0,1152,1271,-119,C50,5,Mate,White
TRUE,68,10+0,1283,1255,28,C20,3,Mate,Black
TRUE,82,10+0,1295,1226,69,C20,3,Mate,Black
TRUE,8,10+0,1448,1280,168,C20,3,Mate,Black
TRUE,151,10+0,1268,1312,-44,B20,2,Out of Time,White
TRUE,81,10+0,1378,1276,102,B01,4,Mate,White
TRUE,34,10+0,1284,1370,-86,C20,3,Mate,Black
TRUE,60,10+0,1311,1272,39,A40,3,Resign,Black
TRUE,47,10+0,1245,1284,-39,A40,6,Mate,White
TRUE,100,10+0,1331,1296,35,B00,2,Draw,Draw
TRUE,40,10+0,1305,1360,-55,C20,3,Resign,Black
TRUE,110,10+0,1193,1298,-105,D04,5,Resign,Black
TRUE,57,10+0,1288,1257,31,C20,4,Mate,White
TRUE,51,10+0,1245,1300,-55,C46,5,Mate,White
TRUE,70,10+0,1315,1189,126,B20,2,Mate,Black
TRUE,19,10+0,1302,1377,-75,B00,2,Mate,White
TRUE,65,10+0,1251,1314,-63,C40,4,Mate,White
TRUE,45,10+0,1307,1180,127,C20,3,Resign,White
TRUE,37,10+0,1290,1548,-258,C40,4,Mate,White
TRUE,37,10+0,1419,1309,110,B00,5,Mate,White
TRUE,59,10+0,1303,1321,-18,B00,5,Mate,White
TRUE,30,10+0,1227,1312,-85,B01,2,Mate,Black
TRUE,63,10+0,1304,1226,78,B06,2,Mate,White
TRUE,45,10+0,1371,1315,56,C20,3,Mate,White
TRUE,128,10+0,1325,1361,-36,C20,3,Mate,Black
TRUE,40,10+0,1340,1316,24,C20,3,Mate,Black
TRUE,31,10+0,1307,1246,61,C20,3,Resign,White
TRUE,97,10+0,1296,1298,-2,C20,3,Resign,White
TRUE,7,10+0,1285,1279,6,B00,2,Mate,White
TRUE,15,10+0,1328,1295,33,C50,5,Mate,White
TRUE,58,10+0,1283,1499,-216,B27,4,Mate,Black
TRUE,9,10+0,1310,1304,6,C42,6,Mate,White
TRUE,14,10+0,1316,1298,18,C50,7,Mate,Black
TRUE,43,10+0,1307,1272,35,C00,3,Mate,White
TRUE,53,10+0,1304,1318,-14,C23,3,Mate,White
TRUE,46,10+0,1236,1309,-73,C21,4,Resign,Black
TRUE,91,10+0,1297,1319,-22,C45,8,Mate,White
TRUE,49,10+0,1258,1299,-41,C40,4,Mate,White
TRUE,53,10+0,1288,1268,20,B21,3,Resign,White
FALSE,17,10+5,1242,1291,-49,C20,3,Mate,White
FALSE,17,10+5,1291,1242,49,C20,3,Mate,White
FALSE,22,60+0,1291,1500,-209,A40,2,Mate,Black
FALSE,46,30+0,1291,1318,-27,A45,2,Mate,Black
TRUE,59,10+0,1430,1434,-4,C40,4,Mate,White
TRUE,43,10+0,1824,1500,324,A40,2,Mate,White
FALSE,25,5+10,1500,1332,168,C40,4,Resign,Black
TRUE,55,10+0,1604,1344,260,D02,5,Mate,White
TRUE,61,10+0,1494,1364,130,A27,5,Mate,White
FALSE,8,30+0,1500,1364,136,C40,4,Resign,White
FALSE,38,15+0,1661,1364,297,C23,3,Mate,Black
FALSE,16,10+0,1500,1364,136,C40,6,Resign,White
FALSE,98,10+0,1364,1525,-161,C21,3,Mate,Black
FALSE,79,10+0,1525,1364,161,C40,4,Mate,White
FALSE,68,5+8,1390,1364,26,A00,1,Resign,White
FALSE,17,15+6,1168,1364,-196,A00,1,Resign,White
FALSE,55,15+6,1364,1500,-136,C42,6,Mate,White
FALSE,47,10+0,1832,1500,332,A10,1,Resign,White
FALSE,47,10+0,2005,1500,505,C50,5,Resign,White
FALSE,74,30+0,1500,1531,-31,A00,4,Resign,Black
FALSE,71,30+0,1531,1500,31,D00,2,Mate,White
FALSE,12,30+0,1500,1500,0,C57,8,Mate,Black
TRUE,52,10+0,1386,1468,-82,C27,3,Resign,Black
TRUE,26,10+0,1371,1398,-27,B01,6,Resign,White
TRUE,66,10+0,1413,1271,142,D00,3,Resign,Black
TRUE,42,10+0,1279,1406,-127,B01,2,Mate,Black
TRUE,135,10+0,1398,1286,112,D00,3,Mate,White
TRUE,27,10+0,1407,1461,-54,B30,4,Resign,Black
TRUE,53,10+0,1283,1422,-139,B01,2,Resign,White
FALSE,29,20+20,2244,1411,833,D20,5,Resign,White
TRUE,54,10+0,1411,1411,0,B01,6,Mate,Black
TRUE,69,10+0,1391,1411,-20,C24,4,Resign,White
TRUE,28,10+0,1337,1391,-54,B01,6,Out of Time,Black
TRUE,87,10+0,1300,1405,-105,C20,3,Resign,White
TRUE,26,10+0,1084,1402,-318,D00,8,Resign,Black
TRUE,43,10+0,1396,1231,165,C24,4,Resign,White
TRUE,50,10+0,1406,1416,-10,C23,4,Resign,Black
TRUE,49,10+0,1405,1417,-12,D01,4,Mate,White
TRUE,128,10+0,1426,1481,-55,C46,6,Resign,Black
TRUE,54,10+0,1472,1436,36,B01,6,Resign,White
TRUE,49,8+0,1430,1256,174,A40,2,Mate,White
TRUE,55,10+0,1335,1444,-109,B01,2,Resign,White
TRUE,59,10+0,1436,1345,91,A40,2,Mate,White
TRUE,76,10+0,1355,1428,-73,B01,2,Mate,Black
TRUE,41,10+0,1441,1338,103,C23,3,Resign,Black
TRUE,56,10+0,1451,1480,-29,D00,3,Resign,Black
TRUE,82,10+0,1386,1442,-56,B01,6,Mate,Black
TRUE,75,10+0,1429,1511,-82,C23,3,Resign,White
TRUE,131,10+0,1416,1491,-75,D00,3,Mate,White
TRUE,38,10+0,1387,1406,-19,B01,6,Mate,Black
TRUE,69,10+0,1375,1396,-21,B01,4,Resign,Black
TRUE,48,10+0,1406,1423,-17,B01,2,Resign,Black
TRUE,80,10+0,1364,1397,-33,B01,2,Resign,Black
TRUE,35,10+0,1330,1409,-79,A06,3,Resign,White
TRUE,81,10+0,1404,1197,207,C23,3,Mate,White
TRUE,49,10+0,1397,1415,-18,D00,3,Resign,White
TRUE,79,10+0,1405,1408,-3,D00,3,Mate,White
TRUE,13,10+0,1171,1422,-251,D00,3,Resign,White
TRUE,105,10+0,1412,1401,11,C00,2,Mate,White
TRUE,83,10+0,1518,1419,99,A00,1,Resign,White
TRUE,46,10+0,1280,1413,-133,B01,6,Resign,Black
FALSE,77,15+0,1393,1527,-134,D00,2,Mate,White
FALSE,51,15+0,1730,1393,337,A02,4,Mate,White
FALSE,55,20+0,1527,1393,134,D00,3,Mate,White
FALSE,78,15+0,1309,1393,-84,B01,4,Mate,Black
FALSE,51,15+0,1393,1309,84,D04,5,Mate,White
FALSE,78,15+0,1393,1527,-134,D00,3,Mate,Black
FALSE,56,15+0,1393,1309,84,D00,4,Mate,Black
FALSE,134,30+0,1428,1279,149,D00,4,Mate,Black
FALSE,63,15+0,1428,1730,-302,D00,3,Mate,White
FALSE,61,15+0,1730,1428,302,C00,4,Mate,White
FALSE,50,20+0,1428,1527,-99,D00,3,Mate,Black
FALSE,87,20+0,1279,1428,-149,B01,4,Mate,White
FALSE,65,15+0,1730,1428,302,D00,2,Mate,White
FALSE,73,15+0,1500,1428,72,A06,3,Mate,White
FALSE,25,20+0,1527,1309,218,A00,1,Mate,White
FALSE,137,15+0,1730,1309,421,B00,6,Draw,Draw
FALSE,56,15+0,1309,1730,-421,C27,3,Mate,Black
FALSE,107,20+0,1527,1309,218,D00,4,Mate,White
FALSE,78,15+0,1309,1393,-84,B01,4,Mate,Black
FALSE,169,15+0,1730,1309,421,D00,4,Draw,Draw
FALSE,51,15+0,1393,1309,84,D04,5,Mate,White
FALSE,108,20+0,1309,1527,-218,B01,4,Mate,Black
FALSE,56,15+0,1393,1309,84,D00,4,Mate,Black
TRUE,37,5+5,1845,1507,338,A40,1,Resign,White
TRUE,70,5+5,1509,1868,-359,A84,3,Resign,Black
TRUE,16,5+5,1513,1783,-270,A40,2,Resign,Black
TRUE,60,5+5,1599,1499,100,B01,2,Resign,Black
TRUE,61,5+5,1539,1510,29,B00,2,Out of Time,White
TRUE,72,5+5,1519,1557,-38,A45,3,Resign,Black
TRUE,120,5+5,1533,1507,26,A40,1,Mate,Black
TRUE,24,5+5,1513,1695,-182,A00,1,Resign,Black
TRUE,54,5+5,1518,1716,-198,C33,5,Mate,Black
TRUE,155,5+5,1609,1526,83,D50,7,Resign,White
TRUE,80,5+5,1535,1620,-85,A03,2,Resign,Black
TRUE,59,5+5,1729,1553,176,B00,3,Resign,White
TRUE,50,5+5,1526,1542,-16,B20,2,Mate,Black
TRUE,53,5+5,1508,1555,-47,B00,6,Resign,White
TRUE,27,5+8,1531,1579,-48,C70,8,Resign,White
TRUE,43,5+8,1581,1541,40,C50,6,Resign,White
TRUE,52,5+8,1550,1620,-70,D24,9,Resign,Black
TRUE,82,5+8,1562,1556,6,C50,6,Resign,Black
TRUE,53,5+8,2167,1562,605,B30,5,Resign,White
TRUE,60,10+0,1130,1383,-253,C34,6,Mate,Black
FALSE,50,17+5,1136,1383,-247,A00,1,Resign,Black
FALSE,37,17+5,1383,1136,247,C50,6,Resign,White
TRUE,76,10+10,984,1378,-394,D00,5,Resign,Black
FALSE,46,10+5,1378,1377,1,C40,4,Mate,Black
TRUE,11,13+10,1372,1003,369,B50,4,Resign,White
TRUE,77,10+0,1364,1065,299,C00,3,Mate,White
TRUE,20,15+0,1196,1348,-152,D20,5,Resign,Black
TRUE,37,10+0,1336,1088,248,C00,3,Resign,White
TRUE,89,15+0,1310,1273,37,C42,5,Resign,White
TRUE,17,5+5,1382,1304,78,C23,3,Draw,Draw
TRUE,30,15+0,1285,1116,169,B30,4,Resign,White
TRUE,77,5+10,1271,1328,-57,C50,8,Resign,White
TRUE,89,10+0,1574,1562,12,D04,5,Out of Time,White
TRUE,67,10+0,1590,1561,29,B20,3,Draw,Draw
TRUE,31,10+0,1558,1235,323,D21,6,Resign,White
TRUE,101,15+15,1547,1567,-20,D20,5,Resign,White
TRUE,37,10+5,1517,1559,-42,E90,9,Out of Time,White
TRUE,80,10+10,1429,1552,-123,C00,3,Mate,Black
TRUE,107,10+0,1741,1810,-69,A03,2,Resign,White
TRUE,64,10+0,1805,1727,78,C00,3,Resign,Black
TRUE,63,10+0,1866,1734,132,C02,10,Resign,White
TRUE,44,10+0,1722,1756,-34,A04,2,Resign,White
TRUE,81,25+0,1740,1496,244,C36,8,Resign,Black
TRUE,164,10+0,1750,1804,-54,A09,3,Mate,Black
TRUE,52,10+0,1757,1893,-136,C45,8,Mate,Black
TRUE,95,10+0,1746,1743,3,A04,2,Mate,White
TRUE,90,10+1,1534,1740,-206,C00,3,Mate,Black
TRUE,49,10+0,1498,1759,-261,A00,1,Mate,White
TRUE,35,10+0,1672,1774,-102,C18,12,Resign,White
TRUE,72,10+0,1932,1757,175,C03,5,Mate,Black
TRUE,89,10+0,1742,1856,-114,D85,13,Resign,White
FALSE,36,20+15,1500,1425,75,B50,4,Resign,Black
FALSE,35,20+15,1425,1500,-75,B32,8,Resign,White
TRUE,21,15+15,1417,1326,91,A53,4,Resign,White
TRUE,105,15+15,1403,1428,-25,B20,2,Resign,White
TRUE,15,15+15,1437,1458,-21,D50,7,Resign,Black
TRUE,21,15+15,1446,1448,-2,B52,6,Mate,White
TRUE,46,15+15,1441,1331,110,E20,8,Resign,White
TRUE,42,15+15,1470,1428,42,B20,3,Resign,Black
TRUE,63,15+15,1415,1484,-69,A40,2,Mate,White
TRUE,62,15+15,1402,1495,-93,A10,2,Resign,White
TRUE,96,15+15,1345,1392,-47,B25,4,Resign,Black
TRUE,33,15+15,1420,1403,17,E61,6,Mate,White
TRUE,37,15+15,1556,1410,146,B20,3,Resign,White
TRUE,43,15+15,1507,1418,89,A48,5,Mate,White
TRUE,47,15+15,1410,1300,110,B00,2,Mate,White
TRUE,63,15+15,1398,1416,-18,C66,8,Resign,White
TRUE,41,15+15,1383,1410,-27,A49,4,Resign,White
TRUE,36,15+15,1428,1222,206,B01,6,Resign,Black
TRUE,42,15+15,1436,1522,-86,C40,4,Resign,Black
TRUE,31,15+15,1428,1318,110,C65,6,Mate,White
TRUE,45,15+15,1500,1435,65,A45,3,Resign,White
TRUE,60,15+15,1593,1442,151,E61,6,Resign,White
TRUE,39,15+15,1469,1453,16,B21,3,Mate,White
TRUE,114,15+15,1450,1525,-75,C02,9,Draw,Draw
TRUE,74,15+15,1461,1490,-29,C61,6,Resign,Black
TRUE,58,15+15,1400,1451,-51,B22,3,Mate,Black
TRUE,76,15+15,1525,1418,107,B22,3,Mate,Black
TRUE,60,15+15,1427,1433,-6,C40,4,Resign,Black
TRUE,30,15+15,1464,1416,48,B22,3,Mate,Black
TRUE,20,15+15,1476,1387,89,A04,2,Resign,Black
TRUE,59,15+15,1378,1318,60,B02,4,Mate,White
TRUE,76,15+15,1299,1369,-70,E77,8,Mate,Black
TRUE,48,15+15,1384,1285,99,B42,9,Resign,Black
TRUE,64,15+15,1500,1374,126,B50,4,Mate,Black
TRUE,62,15+15,1333,1364,-31,B20,2,Mate,Black
TRUE,51,15+15,1350,1409,-59,C41,6,Resign,White
TRUE,69,15+15,1327,1383,-56,B10,5,Mate,White
TRUE,40,15+15,1337,1384,-47,C10,6,Resign,Black
TRUE,68,15+15,1033,1333,-300,E60,5,Mate,Black
FALSE,38,10+0,1500,1287,213,C68,8,Mate,Black
FALSE,5,10+0,1465,1287,178,C20,4,Resign,White
TRUE,105,10+0,1413,1305,108,A01,5,Resign,White
TRUE,43,10+0,1275,1308,-33,C50,5,Mate,White
TRUE,33,10+0,1245,1259,-14,C00,5,Mate,White
TRUE,32,10+0,1292,1275,17,D15,7,Resign,White
TRUE,131,10+0,1264,1315,-51,C20,3,Out of Time,White
TRUE,38,10+0,1282,1234,48,C42,5,Resign,White
TRUE,75,10+0,1250,1156,94,B01,2,Resign,White
FALSE,32,180+0,1250,1500,-250,C65,6,Out of Time,Black
FALSE,57,5+5,1138,1176,-38,C44,4,Resign,White
TRUE,33,15+15,1373,1084,289,B01,4,Mate,White
FALSE,121,10+60,2286,1373,913,D02,4,Resign,White
TRUE,52,3+9,1194,1311,-117,A00,1,Mate,Black
TRUE,92,180+0,1330,1268,62,C42,5,Draw,Draw
TRUE,43,5+8,1511,1500,11,C20,2,Resign,White
TRUE,48,60+0,886,1659,-773,C21,7,Mate,Black
FALSE,41,15+10,1358,886,472,B20,3,Resign,White
TRUE,23,9+0,1620,890,730,A04,2,Resign,White
TRUE,49,10+0,1484,898,586,B20,3,Mate,White
FALSE,61,10+5,1500,898,602,B50,4,Mate,White
TRUE,19,10+5,1325,921,404,C10,5,Resign,White
TRUE,27,17+11,1397,940,457,C46,7,Mate,White
TRUE,31,15+0,1500,963,537,C57,8,Resign,White
TRUE,56,15+0,1049,1234,-185,C10,5,Mate,Black
FALSE,91,20+0,1118,1049,69,A40,3,Resign,White
TRUE,36,5+8,1110,1500,-390,D00,3,Resign,White
FALSE,20,5+10,1500,1595,-95,B01,2,Resign,Black
FALSE,31,5+8,1359,1500,-141,C40,4,Resign,White
FALSE,12,5+10,1500,1595,-95,B01,2,Resign,Black
FALSE,22,15+0,1500,1500,0,B00,2,Resign,Black
FALSE,21,15+0,1649,1500,149,D00,3,Resign,White
FALSE,7,15+0,1500,1500,0,C23,3,Mate,White
FALSE,18,20+10,1500,1683,-183,C20,4,Resign,Black
TRUE,99,5+10,1804,2023,-219,B03,9,Resign,White
TRUE,60,10+0,1822,1588,234,C40,4,Mate,Black
TRUE,62,10+0,1853,1809,44,A17,4,Resign,Black
TRUE,47,10+0,1805,1536,269,C44,8,Resign,White
TRUE,52,10+0,1580,1800,-220,C44,5,Mate,Black
TRUE,51,10+0,1794,1597,197,C40,4,Resign,White
TRUE,69,10+0,2100,1798,302,C45,8,Mate,White
TRUE,47,10+0,1789,1695,94,B50,4,Resign,White
TRUE,63,10+0,1774,1894,-120,C55,7,Resign,White
TRUE,94,10+0,1719,1765,-46,C65,6,Mate,Black
FALSE,57,5+5,1874,1765,109,C65,10,Mate,White
TRUE,54,10+10,1781,1956,-175,A06,3,Mate,Black
TRUE,41,10+0,1773,1659,114,B12,6,Mate,White
TRUE,41,10+0,1899,1780,119,C21,7,Mate,White
TRUE,44,10+0,1714,1771,-57,C65,6,Mate,Black
FALSE,85,10+60,2032,1776,256,A42,7,Resign,White
TRUE,2,9+1,1765,1234,531,A01,1,Resign,White
TRUE,26,9+1,1246,1753,-507,A40,2,Mate,Black
TRUE,12,9+1,1739,1260,479,A00,1,Resign,White
TRUE,14,9+1,1279,1720,-441,A01,1,Resign,Black
TRUE,73,9+1,1694,1305,389,A04,2,Mate,White
TRUE,3,9+1,1654,1345,309,A01,1,Resign,White
TRUE,6,9+1,1423,1576,-153,C00,3,Resign,Black
TRUE,26,9+1,1662,1337,325,A43,3,Draw,Draw
TRUE,3,10+0,1500,1500,0,A40,2,Resign,Black
TRUE,34,10+0,1579,1022,557,D02,4,Resign,White
TRUE,70,10+0,1028,1284,-256,C30,3,Mate,Black
TRUE,35,10+0,1307,1033,274,C00,2,Mate,White
TRUE,43,10+0,983,1051,-68,C00,2,Resign,White
TRUE,42,10+0,1058,1249,-191,B01,2,Resign,Black
TRUE,11,10+0,1066,1256,-190,C34,5,Resign,Black
TRUE,20,10+0,1073,1313,-240,C30,4,Resign,Black
TRUE,65,10+0,1308,1079,229,C44,5,Mate,White
TRUE,39,10+0,1046,1096,-50,C00,3,Resign,White
TRUE,112,10+0,1118,1002,116,A40,2,Mate,Black
TRUE,61,10+0,1107,977,130,C00,4,Mate,White
TRUE,119,10+0,1125,1124,1,D00,3,Out of Time,White
TRUE,49,10+0,1328,1133,195,B02,6,Resign,White
TRUE,92,15+15,1150,1157,-7,C00,3,Resign,Black
TRUE,52,15+15,1131,1167,-36,B01,2,Resign,White
TRUE,16,15+15,1107,1225,-118,B01,2,Resign,White
TRUE,52,10+0,1129,1096,33,C42,4,Resign,Black
TRUE,16,10+0,1132,1107,25,C00,3,Resign,Black
TRUE,67,10+0,1208,1123,85,C00,3,Resign,White
TRUE,7,10+0,1099,1198,-99,C21,3,Out of Time,White
TRUE,34,15+15,1110,1320,-210,B01,2,Mate,Black
TRUE,37,15+15,1315,1122,193,A10,2,Mate,White
TRUE,81,15+15,1094,1144,-50,C25,4,Mate,White
TRUE,58,15+15,1317,1049,268,A04,2,Mate,Black
TRUE,27,15+15,1061,1297,-236,C20,4,Resign,Black
TRUE,42,15+15,1074,1292,-218,C21,3,Resign,Black
TRUE,49,15+15,1287,1089,198,C24,4,Mate,White
TRUE,119,15+15,1098,1123,-25,D00,3,Resign,White
TRUE,44,15+15,1138,1368,-230,B00,2,Mate,Black
TRUE,30,15+15,1114,998,116,B06,2,Resign,White
TRUE,47,15+15,1296,1051,245,D02,4,Resign,Black
TRUE,95,15+15,1045,1101,-56,D02,3,Resign,White
TRUE,16,15+15,1138,1217,-79,C44,4,Resign,Black
TRUE,49,15+15,1062,1216,-154,C11,6,Out of Time,White
TRUE,3,15+15,1045,1080,-35,C21,3,Out of Time,White
TRUE,67,10+0,1175,1121,54,C42,5,Mate,White
TRUE,64,10+0,1253,1232,21,C42,7,Resign,Black
TRUE,86,10+0,1253,1956,-703,A40,2,Resign,Black
TRUE,36,10+0,1257,1715,-458,A43,2,Resign,Black
TRUE,41,10+0,1923,1258,665,B13,5,Mate,White
TRUE,38,10+0,1262,1661,-399,D02,5,Resign,Black
TRUE,70,10+0,1265,1720,-455,A40,2,Resign,Black
TRUE,39,10+0,1782,1268,514,B00,3,Resign,White
TRUE,25,10+0,1551,1276,275,B15,5,Mate,White
TRUE,23,10+0,1810,1278,532,B10,5,Mate,White
TRUE,19,10+0,1283,1668,-385,B21,3,Resign,Black
TRUE,43,10+0,2003,1284,719,B12,5,Mate,White
TRUE,109,10+0,1239,1699,-460,C27,3,Out of Time,White
TRUE,45,10+0,1670,1243,427,B12,6,Resign,White
TRUE,46,10+0,1246,1759,-513,C50,8,Resign,Black
TRUE,40,10+0,1252,1611,-359,B20,3,Resign,Black
TRUE,31,10+0,1955,1253,702,B15,10,Resign,White
TRUE,32,10+0,1256,1703,-447,D35,6,Resign,Black
TRUE,45,10+0,1866,1258,608,C48,9,Resign,White
TRUE,96,10+0,1666,1212,454,D01,4,Resign,Black
TRUE,52,10+0,1212,2215,-1003,E20,6,Mate,Black
TRUE,69,10+0,1928,1213,715,D35,6,Resign,White
TRUE,58,10+0,1178,1616,-438,B07,7,Mate,Black
TRUE,48,10+0,1268,1142,126,B02,3,Resign,Black
TRUE,72,10+0,1017,1122,-105,C55,7,Mate,Black
TRUE,104,10+0,1152,1158,-6,B32,8,Resign,Black
TRUE,93,10+0,983,1167,-184,B50,5,Draw,Draw
TRUE,55,10+0,1168,1833,-665,B20,3,Resign,Black
TRUE,38,10+0,1182,1429,-247,C21,3,Resign,Black
TRUE,68,10+0,1347,1417,-70,C55,8,Mate,Black
TRUE,65,10+0,1406,1371,35,C40,4,Resign,White
TRUE,32,15+15,1467,1390,77,C50,8,Resign,Black
TRUE,99,10+0,1423,1402,21,C26,6,Out of Time,White
TRUE,83,10+0,1411,1431,-20,C48,7,Mate,White
TRUE,52,10+0,1358,1420,-62,C42,5,Mate,Black
FALSE,17,15+15,1422,1500,-78,D06,4,Resign,White
FALSE,72,15+15,1500,1422,78,A03,2,Mate,Black
TRUE,23,15+15,1416,1330,86,D07,6,Resign,White
TRUE,50,15+15,1173,1410,-237,B20,3,Out of Time,Black
TRUE,39,15+15,1725,1402,323,B01,2,Mate,White
TRUE,104,15+15,1550,1372,178,C57,8,Mate,Black
TRUE,35,15+15,1355,1352,3,A20,2,Mate,White
TRUE,125,10+10,1452,1351,101,C02,9,Draw,Draw
TRUE,80,12+5,1362,1458,-96,C65,6,Mate,Black
FALSE,56,10+0,1500,1362,138,A06,3,Mate,Black
TRUE,6,10+0,1375,1435,-60,A10,1,Resign,Black
FALSE,77,20+0,1500,1375,125,D00,2,Mate,White
TRUE,14,12+2,1355,1431,-76,A20,2,Resign,White
TRUE,49,10+5,1333,1471,-138,C40,3,Mate,White
FALSE,101,7+25,1831,1520,311,C42,5,Resign,White
FALSE,39,10+0,1864,1520,344,C34,6,Resign,White
FALSE,47,20+7,1288,1520,-232,D00,6,Mate,White
TRUE,24,30+0,1616,1504,112,C62,6,Resign,Black
FALSE,122,10+5,1584,1504,80,C44,4,Mate,Black
FALSE,58,25+0,1504,1612,-108,B01,4,Resign,Black
FALSE,68,15+0,1504,1737,-233,C42,5,Resign,Black
FALSE,66,5+15,1504,1500,4,A22,4,Mate,Black
FALSE,58,5+15,1500,1504,-4,D00,3,Resign,Black
FALSE,51,5+15,1504,1500,4,A21,3,Resign,White
FALSE,38,5+15,1500,1504,-4,D00,3,Resign,Black
FALSE,61,20+0,1606,1504,102,C42,5,Resign,White
FALSE,74,20+0,1504,1606,-102,B13,5,Resign,Black
FALSE,56,12+6,1500,1504,-4,C20,3,Mate,Black
FALSE,81,12+6,1504,1500,4,B01,2,Mate,White
FALSE,54,12+6,1500,1504,-4,D00,3,Mate,Black
FALSE,41,12+6,1504,1500,4,C23,4,Mate,White
FALSE,62,12+6,1500,1504,-4,A00,2,Mate,Black
FALSE,42,20+0,943,1504,-561,C20,2,Resign,Black
FALSE,89,10+10,1504,1184,320,B06,6,Mate,White
TRUE,33,8+8,1428,1507,-79,C41,4,Draw,Draw
TRUE,28,10+0,1233,1503,-270,C55,6,Resign,Black
TRUE,25,10+0,1500,1149,351,C23,3,Mate,White
FALSE,56,20+5,1587,1500,87,D02,4,Resign,Black
FALSE,16,20+5,1500,1587,-87,A52,7,Resign,Black
FALSE,66,20+5,1587,1500,87,A01,2,Resign,Black
FALSE,77,15+0,1500,1500,0,C65,6,Mate,White
FALSE,73,15+0,1500,1500,0,A21,3,Resign,White
FALSE,19,5+10,1527,1500,27,C55,6,Draw,Draw
FALSE,58,5+10,1500,1500,0,C20,3,Mate,Black
FALSE,34,15+0,1500,1700,-200,A34,5,Resign,Black
FALSE,21,10+5,1500,1457,43,A22,6,Draw,Draw
FALSE,95,5+5,1500,1648,-148,A21,3,Draw,Draw
FALSE,73,2+15,1712,1500,212,C21,10,Resign,White
FALSE,46,2+15,1500,1712,-212,A22,6,Mate,Black
FALSE,78,25+30,1500,1500,0,C20,3,Resign,Black
FALSE,43,5+8,1788,1500,288,C34,6,Draw,Draw
FALSE,39,30+0,1500,1500,0,A22,5,Resign,White
FALSE,59,30+0,1500,1500,0,D00,3,Resign,White
FALSE,22,15+45,1500,1500,0,C24,4,Out of Time,Black
FALSE,45,5+10,1500,1479,21,C46,6,Resign,White
FALSE,61,10+0,1381,1500,-119,C62,6,Resign,White
FALSE,10,15+0,1500,1500,0,C62,6,Resign,Black
FALSE,107,15+0,1702,1500,202,C20,3,Out of Time,White
TRUE,44,15+8,1665,1697,-32,C46,6,Resign,Black
TRUE,81,15+8,1668,1543,125,C00,3,Resign,White
TRUE,117,15+8,1659,1628,31,A06,2,Draw,Draw
TRUE,38,15+8,1680,1633,47,A04,2,Resign,Black
TRUE,79,15+8,1680,1700,-20,A04,2,Draw,Draw
TRUE,84,15+8,1696,1527,169,C00,3,Out of Time,Black
TRUE,47,15+8,1693,1386,307,A04,4,Mate,White
TRUE,57,15+8,1687,1624,63,A04,2,Resign,White
TRUE,100,15+8,1691,1386,305,C42,5,Draw,Draw
TRUE,89,15+8,1684,1560,124,A04,2,Mate,White
TRUE,38,15+2,1672,1702,-30,A04,2,Resign,White
TRUE,66,15+2,1579,1664,-85,D20,5,Out of Time,Black
TRUE,58,15+2,1678,1565,113,B06,2,Resign,Black
TRUE,97,15+2,1680,1600,80,A04,2,Mate,White
TRUE,88,15+2,1691,1696,-5,D02,4,Resign,Black
TRUE,23,15+2,1684,1703,-19,C55,6,Resign,White
TRUE,62,15+2,1717,1618,99,C55,6,Out of Time,Black
TRUE,95,15+2,1626,1708,-82,B00,2,Resign,Black
TRUE,96,15+2,1722,1612,110,C46,6,Mate,Black
TRUE,94,15+2,1730,1848,-118,C41,6,Mate,Black
TRUE,79,15+2,1724,1560,164,C50,6,Resign,White
TRUE,77,15+2,1519,1740,-221,C42,5,Resign,White
TRUE,31,15+2,1738,1370,368,C55,7,Resign,White
TRUE,80,15+2,1656,1729,-73,D06,4,Resign,Black
TRUE,57,15+2,1628,1721,-93,B00,3,Resign,Black
TRUE,42,15+2,1728,1853,-125,B08,8,Mate,Black
TRUE,135,15+2,1719,1677,42,C41,4,Mate,White
TRUE,114,15+2,1687,1709,-22,A10,1,Resign,Black
TRUE,36,15+2,1721,1679,42,A04,2,Mate,Black
TRUE,147,15+2,1696,1722,-26,C55,6,Draw,Draw
TRUE,37,15+2,1718,1436,282,C41,4,Resign,White
TRUE,87,15+2,1709,1629,80,D02,4,Mate,White
TRUE,123,15+2,1704,1510,194,A06,2,Mate,White
TRUE,89,15+2,1695,1643,52,A06,2,Out of Time,White
TRUE,10,15+2,1518,1689,-171,C55,6,Out of Time,Black
TRUE,71,15+2,1683,1495,188,D02,4,Resign,White
TRUE,54,15+2,1694,1707,-13,C46,5,Resign,Black
TRUE,62,15+2,1744,1681,63,B00,3,Resign,Black
TRUE,34,10+1,1482,1472,10,A40,2,Resign,Black
TRUE,43,12+0,1473,1401,72,D30,4,Mate,White
TRUE,90,10+0,1221,1368,-147,A10,2,Mate,Black
TRUE,51,15+15,1481,1293,188,A02,1,Mate,White
TRUE,10,15+15,1500,1432,68,A43,3,Mate,Black
TRUE,95,10+0,1403,1182,221,D20,6,Mate,White
TRUE,22,10+0,1365,1163,202,A21,3,Resign,Black
TRUE,22,10+0,1163,1985,-822,C23,3,Mate,Black
TRUE,91,20+0,1153,1103,50,C24,4,Mate,White
TRUE,78,10+3,1158,1383,-225,C23,3,Resign,Black
TRUE,13,25+3,1147,1108,39,C41,5,Mate,White
TRUE,102,15+10,1206,1132,74,A00,1,Mate,Black
TRUE,67,10+5,1103,1146,-43,C20,3,Mate,White
TRUE,29,15+10,1127,1296,-169,C20,3,Mate,White
TRUE,97,17+1,1111,1198,-87,C00,2,Resign,White
TRUE,69,17+1,1172,1122,50,C40,4,Mate,White
TRUE,40,17+1,1136,1128,8,C20,3,Mate,Black
TRUE,60,15+0,1160,796,364,B01,4,Mate,Black
TRUE,144,15+0,795,1157,-362,C00,3,Resign,Black
TRUE,82,30+1,1084,1146,-62,A40,2,Mate,Black
FALSE,73,10+0,1146,995,151,C24,5,Resign,White
TRUE,62,20+0,1158,1191,-33,C23,3,Mate,Black
TRUE,115,30+0,1143,1191,-48,C24,5,Mate,White
TRUE,67,17+8,1002,1163,-161,C40,4,Mate,White
TRUE,62,13+1,1148,1165,-17,C00,2,Resign,White
TRUE,60,13+1,1161,1200,-39,C23,3,Mate,Black
TRUE,57,7+5,1011,1184,-173,A40,3,Mate,White
FALSE,48,15+15,1184,1070,114,A00,1,Mate,Black
FALSE,22,15+15,1176,1070,106,B02,2,Mate,Black
FALSE,42,15+15,1160,1070,90,C00,2,Resign,Black
TRUE,99,17+3,1134,1023,111,C20,3,Mate,White
TRUE,100,10+0,1129,1248,-119,C20,3,Draw,Draw
TRUE,72,10+0,1026,1116,-90,C40,4,Resign,Black
TRUE,90,10+0,1140,1011,129,B01,2,Mate,Black
TRUE,33,10+0,995,1167,-172,C23,3,Mate,White
TRUE,101,10+0,1156,997,159,B01,2,Mate,White
TRUE,80,10+8,1178,1132,46,B02,2,Resign,Black
TRUE,54,10+8,1089,1162,-73,C20,3,Out of Time,Black
TRUE,72,20+0,1092,1144,-52,A20,2,Mate,Black
TRUE,38,20+0,1172,1077,95,B01,2,Mate,Black
TRUE,62,20+0,1112,1151,-39,C21,3,Resign,Black
TRUE,7,15+0,1131,1071,60,C23,4,Mate,White
FALSE,50,8+5,1211,1500,-289,C55,6,Mate,Black
TRUE,43,11+0,1834,1218,616,C40,4,Mate,White
FALSE,43,10+5,1742,1218,524,B00,3,Mate,White
FALSE,17,10+5,1742,1218,524,B00,2,Mate,White
TRUE,113,15+5,1500,1261,239,B00,2,Mate,White
TRUE,18,10+0,1317,1538,-221,B01,2,Resign,Black
FALSE,46,15+0,1317,1500,-183,C20,3,Mate,Black
FALSE,23,15+0,1500,1317,183,B00,5,Mate,White
TRUE,39,45+10,1940,1327,613,B00,3,Mate,White
TRUE,63,6+5,1504,1500,4,B00,2,Mate,White
TRUE,3,10+0,1590,1388,202,A10,1,Resign,White
TRUE,26,10+0,1391,1774,-383,C62,6,Mate,Black
TRUE,69,10+0,1731,1395,336,D21,6,Mate,White
TRUE,117,10+0,1686,1400,286,C45,7,Mate,White
TRUE,48,30+0,1408,1577,-169,C55,6,Mate,Black
TRUE,32,10+0,1418,1741,-323,B01,4,Mate,Black
TRUE,81,10+0,2010,1419,591,C55,7,Mate,White
TRUE,61,10+0,1908,1421,487,D06,8,Mate,White
TRUE,40,10+0,1422,2026,-604,C46,5,Mate,Black
TRUE,29,10+0,1523,1375,148,C46,7,Resign,Black
FALSE,93,7+2,1375,1992,-617,B01,4,Resign,Black
TRUE,95,8+25,1281,930,351,C00,3,Mate,White
FALSE,80,10+0,1221,1281,-60,B40,10,Out of Time,Black
TRUE,47,15+0,1278,946,332,A15,3,Mate,White
TRUE,18,15+0,950,1274,-324,B20,3,Resign,Black
TRUE,31,15+0,1270,953,317,C44,5,Mate,White
TRUE,61,10+0,1245,1277,-32,D02,4,Mate,White
TRUE,93,10+0,1240,1012,228,A30,2,Mate,White
TRUE,114,15+0,1255,1157,98,C41,7,Resign,Black
FALSE,46,7+3,874,1255,-381,B23,4,Out of Time,Black
TRUE,28,20+0,1152,1246,-94,B20,2,Mate,Black
TRUE,33,15+0,1242,953,289,C70,10,Mate,White
TRUE,107,10+6,1234,1087,147,B00,4,Resign,White
TRUE,9,19+19,1231,905,326,D02,3,Resign,White
TRUE,38,19+19,909,1227,-318,D00,4,Resign,Black
TRUE,105,15+10,1218,1111,107,D05,6,Mate,White
TRUE,32,15+0,1268,1204,64,B20,3,Mate,Black
TRUE,115,15+0,1017,1223,-206,D01,4,Resign,White
TRUE,123,7+4,1276,1234,42,C20,3,Mate,White
TRUE,72,7+4,1246,1238,8,A46,3,Resign,Black
TRUE,29,7+4,1190,1261,-71,B40,4,Mate,White
TRUE,105,7+4,1249,1233,16,A40,4,Mate,White
FALSE,41,20+0,1249,1500,-251,D02,4,Resign,White
FALSE,49,25+0,1249,1531,-282,A40,2,Resign,Black
TRUE,105,30+0,1138,1266,-128,A01,2,Resign,White
TRUE,35,30+0,1256,1163,93,A10,2,Resign,White
TRUE,43,30+0,1111,1275,-164,D01,4,Resign,White
TRUE,97,10+0,1667,1250,417,D20,5,Mate,White
TRUE,40,10+0,1252,1770,-518,C20,3,Resign,Black
TRUE,57,10+0,1689,1254,435,D02,4,Resign,White
TRUE,56,10+0,1255,1833,-578,C25,4,Mate,Black
TRUE,35,10+0,2033,1256,777,A00,1,Resign,White
TRUE,46,10+0,1525,1232,293,C41,5,Mate,Black
TRUE,60,10+0,1235,1592,-357,B06,2,Resign,Black
TRUE,31,10+0,1444,1242,202,C51,7,Mate,White
TRUE,60,10+0,1246,1565,-319,C21,3,Resign,Black
TRUE,52,10+0,1257,1342,-85,C44,4,Mate,Black
TRUE,19,10+0,1495,1263,232,A06,3,Mate,White
TRUE,41,10+0,1790,1265,525,C40,4,Resign,White
TRUE,36,10+0,1266,1854,-588,A46,3,Mate,Black
TRUE,54,30+1,1278,1329,-51,C51,7,Mate,Black
TRUE,42,10+0,1290,1436,-146,A00,1,Resign,Black
TRUE,30,10+0,1293,1710,-417,B27,4,Resign,Black
TRUE,70,30+1,958,1289,-331,A00,1,Mate,Black
TRUE,35,10+0,1709,1291,418,B00,2,Resign,White
TRUE,31,10+0,1755,1293,462,D30,4,Mate,White
TRUE,64,10+0,1296,1702,-406,B30,4,Resign,Black
TRUE,45,10+0,1680,1299,381,C23,3,Mate,White
TRUE,56,10+0,1302,1647,-345,C20,3,Resign,Black
TRUE,42,10+0,1303,1876,-573,A00,1,Mate,Black
TRUE,27,10+0,1473,1311,162,C40,4,Resign,White
TRUE,39,10+0,1774,1313,461,C30,3,Resign,White
TRUE,19,10+0,1302,1236,66,C20,3,Resign,White
TRUE,34,10+0,1313,1401,-88,A00,1,Mate,Black
TRUE,31,10+0,1809,1314,495,C50,5,Resign,White
TRUE,54,10+0,1323,1451,-128,C20,3,Out of Time,Black
TRUE,134,30+1,1369,1307,62,C26,5,Mate,Black
TRUE,86,30+1,1319,1363,-44,A00,1,Resign,Black
TRUE,30,30+1,1324,1599,-275,C41,4,Resign,Black
TRUE,29,10+0,1698,1327,371,C24,5,Resign,White
TRUE,55,10+0,1552,1334,218,C24,5,Resign,White
TRUE,34,30+1,1289,1321,-32,A00,1,Mate,Black
TRUE,81,10+0,1297,1532,-235,B01,2,Out of Time,White
TRUE,84,10+0,1300,1749,-449,B07,2,Resign,Black
TRUE,56,10+0,1302,1696,-394,C65,6,Mate,Black
TRUE,35,30+1,1282,1428,-146,B52,6,Resign,White
TRUE,30,30+1,1453,1261,192,D00,3,Mate,Black
TRUE,21,30+1,1235,1246,-11,C42,5,Resign,Black
TRUE,98,30+1,1453,1222,231,D00,2,Resign,Black
TRUE,70,30+1,1338,1200,138,C41,4,Mate,Black
TRUE,82,10+0,1208,1406,-198,A00,5,Mate,Black
TRUE,74,10+0,1213,1519,-306,B21,3,Out of Time,Black
TRUE,53,10+0,1833,1214,619,D00,3,Resign,White
TRUE,41,10+0,1185,1590,-405,A07,3,Resign,White
TRUE,25,10+0,1848,1186,662,A02,1,Resign,White
TRUE,88,10+0,1188,1605,-417,A00,1,Resign,Black
TRUE,60,10+0,2035,1629,406,D02,5,Mate,Black
TRUE,79,10+0,1609,1754,-145,C65,6,Resign,White
TRUE,52,10+0,1584,1957,-373,C00,3,Resign,White
TRUE,68,10+0,1374,1553,-179,D00,3,Mate,Black
TRUE,40,10+0,1813,1528,285,B45,11,Resign,Black
TRUE,71,10+0,1503,1819,-316,C02,11,Mate,White
TRUE,56,10+0,1669,1481,188,A40,2,Mate,Black
TRUE,37,10+0,1467,1454,13,C60,5,Mate,White
TRUE,28,10+0,1429,1384,45,B30,5,Resign,White
TRUE,46,10+0,1453,1412,41,D06,4,Mate,Black
TRUE,51,10+0,1385,1637,-252,C68,10,Resign,White
TRUE,66,10+0,1235,1375,-140,B06,2,Mate,Black
TRUE,26,10+0,1431,1355,76,A00,1,Mate,Black
TRUE,53,10+0,1763,1358,405,D00,4,Out of Time,White
TRUE,19,10+0,1306,1546,-240,B01,4,Resign,White
TRUE,32,10+0,1248,1291,-43,C43,9,Resign,Black
TRUE,21,10+0,1258,1673,-415,C00,3,Resign,White
TRUE,41,10+0,1916,1222,694,C45,9,Resign,Black
TRUE,50,10+0,1788,1187,601,C37,12,Resign,Black
TRUE,65,10+0,1155,1510,-355,C60,5,Mate,White
TRUE,37,10+0,1132,1227,-95,C40,4,Mate,White
TRUE,27,10+0,1113,1122,-9,C41,5,Mate,White
TRUE,9,10+0,1102,930,172,B02,4,Resign,White
FALSE,59,10+60,1102,1810,-708,A00,1,Resign,White
TRUE,22,10+0,1023,1086,-63,C00,3,Resign,Black
TRUE,106,10+0,1098,1249,-151,A00,1,Mate,Black
TRUE,79,10+0,1241,1112,129,C00,2,Mate,White
TRUE,124,10+0,1130,1210,-80,A00,1,Mate,Black
TRUE,60,10+0,1169,1104,65,C00,3,Mate,Black
TRUE,88,10+0,1114,1384,-270,A00,1,Mate,Black
TRUE,39,10+0,1636,1116,520,C00,3,Mate,White
TRUE,53,10+0,1825,1074,751,C00,2,Mate,White
TRUE,28,10+0,1074,2151,-1077,A00,1,Mate,Black
TRUE,61,6+8,1429,1416,13,A45,2,Resign,White
TRUE,64,5+10,1425,1447,-22,C55,6,Mate,Black
TRUE,127,20+0,1451,1414,37,B50,4,Resign,Black
TRUE,114,20+0,1424,1431,-7,C55,7,Resign,Black
TRUE,43,20+0,1436,1389,47,B01,4,Resign,Black
TRUE,19,10+0,1426,1411,15,C53,9,Mate,White
TRUE,83,15+7,1419,1437,-18,A01,5,Resign,White
TRUE,69,5+10,1399,1449,-50,B25,4,Mate,White
TRUE,39,15+3,1441,1366,75,C55,7,Resign,White
TRUE,40,20+10,1453,1369,84,C53,9,Resign,Black
TRUE,114,30+0,1464,1465,-1,C53,9,Resign,Black
TRUE,70,30+0,1476,1453,23,B25,4,Resign,Black
TRUE,91,10+2,1497,1462,35,B50,5,Out of Time,White
TRUE,51,10+25,1472,1498,-26,B12,3,Resign,Black
TRUE,93,20+15,1459,1461,-2,B20,3,Resign,Black
TRUE,89,8+0,1456,1472,-16,B50,4,Mate,White
TRUE,43,8+0,1462,1441,21,C53,7,Resign,White
TRUE,42,9+3,1450,1452,-2,B20,3,Resign,Black
TRUE,43,9+3,1441,1462,-21,C55,6,Mate,White
TRUE,66,8+5,1451,1451,0,B20,3,Resign,White
TRUE,100,8+0,1461,1491,-30,C55,6,Out of Time,Black
TRUE,51,12+8,1465,1472,-7,B20,2,Resign,White
TRUE,67,9+10,1462,1424,38,B54,6,Resign,White
TRUE,54,9+9,1450,1452,-2,B21,3,Out of Time,Black
TRUE,36,15+2,1464,1415,49,C55,6,Resign,Black
TRUE,63,5+5,1417,1454,-37,B57,8,Resign,Black
TRUE,65,30+0,1443,1454,-11,C50,7,Mate,White
TRUE,96,10+0,1471,1454,17,B20,2,Resign,White
TRUE,50,15+15,1465,1438,27,B84,14,Resign,Black
TRUE,81,45+15,1417,1477,-60,B50,4,Resign,White
TRUE,65,5+8,1474,1201,273,C41,5,Resign,White
TRUE,21,5+5,1510,1483,27,B20,3,Resign,White
TRUE,35,15+16,1480,1494,-14,B90,10,Resign,White
TRUE,42,10+0,1498,1768,-270,C55,6,Resign,Black
TRUE,48,10+0,1510,1452,58,C41,7,Resign,Black
TRUE,75,10+0,1435,1523,-88,B21,3,Resign,White
TRUE,66,20+0,1536,1460,76,C41,5,Resign,Black
TRUE,21,10+10,1514,1547,-33,B34,9,Resign,White
TRUE,61,10+5,1559,1514,45,B54,6,Resign,Black
TRUE,78,10+3,1568,1581,-13,C14,13,Mate,Black
TRUE,38,15+5,1475,1560,-85,B51,5,Mate,Black
TRUE,113,20+0,1561,1525,36,C50,5,Draw,Draw
TRUE,40,10+15,1553,1459,94,C53,9,Resign,White
TRUE,42,10+15,1456,1556,-100,B20,3,Draw,Draw
TRUE,145,25+0,1546,1532,14,C41,5,Mate,White
TRUE,78,15+2,1543,1536,7,A45,2,Mate,Black
TRUE,40,10+3,1547,1513,34,C50,6,Mate,Black
TRUE,76,11+0,1477,1560,-83,A00,1,Resign,White
TRUE,89,11+0,1551,1486,65,C16,7,Resign,White
TRUE,61,11+0,1472,1564,-92,A00,1,Resign,White
TRUE,78,8+0,1436,1568,-132,B06,2,Resign,Black
TRUE,59,5+5,1567,1108,459,A00,1,Out of Time,White
TRUE,89,9+0,1301,1587,-286,B06,2,Mate,White
TRUE,103,8+8,1292,1622,-330,B06,2,Mate,White
TRUE,163,6+5,1616,1404,212,A00,1,Mate,White
TRUE,19,9+9,1613,1279,334,A00,1,Resign,White
TRUE,53,5+8,1607,1403,204,A00,1,Resign,White
TRUE,71,5+5,1600,1421,179,A00,1,Resign,White
TRUE,88,10+0,1580,1763,-183,D00,3,Resign,Black
TRUE,140,10+0,1711,1753,-42,B12,7,Mate,Black
TRUE,69,10+5,2211,1900,311,C10,5,Mate,White
TRUE,76,10+5,2070,2203,-133,C88,13,Mate,Black
TRUE,155,10+5,2196,2030,166,B33,8,Resign,White
TRUE,75,10+5,2290,2205,85,C77,9,Resign,White
TRUE,59,5+6,1962,2219,-257,A15,4,Mate,White
TRUE,64,5+5,1966,2214,-248,D00,3,Mate,Black
TRUE,72,7+4,2232,2081,151,C50,9,Out of Time,Black
TRUE,67,7+4,2169,2221,-52,D06,4,Resign,Black
TRUE,93,7+4,2209,2193,16,B90,11,Mate,White
TRUE,39,7+4,1788,2207,-419,C45,11,Resign,Black
TRUE,52,7+4,2202,1915,287,B34,9,Resign,White
TRUE,121,7+4,2199,1843,356,C02,7,Mate,White
TRUE,66,7+4,2178,2187,-9,A01,2,Resign,Black
TRUE,7,7+4,2173,2189,-16,B01,4,Resign,White
TRUE,101,7+4,2167,1933,234,B07,4,Resign,White
TRUE,56,7+4,2080,2157,-77,D35,6,Resign,Black
TRUE,122,7+4,2176,2027,149,B20,2,Resign,Black
TRUE,87,7+4,2018,2167,-149,D30,4,Resign,Black
TRUE,84,7+4,1989,2160,-171,D06,4,Mate,Black
TRUE,81,7+4,2147,2120,27,C00,3,Resign,White
TRUE,33,7+4,2145,1631,514,B30,4,Resign,White
TRUE,48,7+4,1692,2143,-451,D30,4,Resign,Black
TRUE,25,7+4,1690,2141,-451,C45,7,Resign,Black
TRUE,93,7+4,2129,2088,41,B50,4,Resign,White
TRUE,73,7+4,2022,2148,-126,A01,5,Out of Time,White
TRUE,67,7+4,2146,1645,501,B91,11,Resign,White
TRUE,83,7+4,1739,2143,-404,C77,9,Resign,Black
TRUE,118,7+4,2155,1758,397,C00,3,Draw,Draw
TRUE,65,7+4,2148,1947,201,C40,4,Out of Time,White
TRUE,78,10+0,1852,1874,-22,D00,3,Resign,Black
TRUE,87,10+0,1828,1767,61,A40,2,Resign,White
TRUE,54,10+0,1863,1831,32,D00,3,Mate,Black
TRUE,17,10+0,1846,1561,285,D00,3,Mate,White
TRUE,136,10+0,1565,1831,-266,B20,3,Resign,Black
TRUE,79,10+0,1814,1569,245,D00,3,Mate,White
TRUE,42,10+0,1741,1771,-30,D02,3,Mate,Black
TRUE,63,10+0,1712,1752,-40,D00,3,Mate,White
TRUE,133,10+0,1832,1762,70,B50,5,Mate,White
TRUE,49,10+0,1921,1815,106,B71,11,Resign,White
TRUE,42,10+0,1581,1767,-186,B20,3,Resign,Black
TRUE,138,10+0,1410,1736,-326,B21,3,Out of Time,Black
TRUE,52,10+0,1688,1414,274,A40,2,Resign,White
TRUE,74,10+0,1852,1862,-10,A39,13,Resign,Black
TRUE,107,10+0,1868,1716,152,A04,2,Resign,Black
TRUE,62,10+0,1881,1825,56,A05,4,Mate,Black
TRUE,57,10+0,1854,1893,-39,B21,5,Resign,White
TRUE,73,10+0,1885,1798,87,A04,2,Mate,White
TRUE,45,10+0,1864,2267,-403,A39,13,Resign,White
TRUE,155,10+0,1832,1877,-45,B20,3,Mate,White
TRUE,75,10+0,1859,1741,118,A04,2,Mate,White
TRUE,33,10+0,1913,1643,270,A01,1,Mate,White
TRUE,42,10+0,1732,1653,79,D30,4,Resign,White
TRUE,91,10+0,1645,1525,120,B34,8,Resign,White
TRUE,56,10+0,1663,1631,32,C00,3,Resign,Black
TRUE,105,10+0,2063,1633,430,C02,11,Mate,White
TRUE,82,10+0,1445,1627,-182,D32,6,Resign,Black
TRUE,67,10+0,1625,1212,413,B34,9,Out of Time,White
TRUE,64,10+0,1634,1715,-81,C41,4,Resign,Black
TRUE,53,10+0,2054,1636,418,D35,9,Mate,White
TRUE,70,10+0,1638,2075,-437,C48,8,Resign,Black
TRUE,53,10+0,1617,2024,-407,C77,9,Resign,White
TRUE,55,10+0,1727,1625,102,C01,5,Mate,White
TRUE,56,10+0,1638,1606,32,C00,4,Resign,Black
TRUE,42,10+0,973,1173,-200,A00,1,Resign,Black
TRUE,43,10+0,1170,981,189,C40,3,Out of Time,White
TRUE,73,10+0,1272,986,286,A00,1,Out of Time,White
TRUE,78,10+0,999,1068,-69,C20,3,Mate,Black
TRUE,93,10+0,979,1043,-64,B00,2,Out of Time,White
TRUE,41,10+0,906,1001,-95,A40,3,Out of Time,White
TRUE,45,10+0,1053,1017,36,C23,3,Out of Time,White
TRUE,72,10+0,1037,1004,33,B02,2,Out of Time,Black
TRUE,56,10+0,1059,1016,43,C40,4,Out of Time,Black
TRUE,76,10+0,1036,1035,1,B20,3,Out of Time,Black
TRUE,69,10+0,1261,1045,216,A00,1,Resign,White
TRUE,19,10+0,1351,1052,299,D43,8,Resign,White
TRUE,98,10+0,1071,1118,-47,B02,2,Out of Time,Black
TRUE,109,10+0,1064,1174,-110,C33,4,Draw,Draw
TRUE,27,10+0,1378,1071,307,C55,6,Resign,White
TRUE,36,10+0,1092,1143,-51,A00,1,Mate,Black
TRUE,59,10+0,1140,1117,23,C00,3,Out of Time,White
TRUE,56,10+0,1141,1168,-27,B01,2,Out of Time,Black
TRUE,39,10+0,1221,1166,55,C42,5,Mate,White
TRUE,72,10+0,1296,1120,176,A45,3,Mate,Black
TRUE,44,10+0,1136,1344,-208,B01,4,Mate,Black
TRUE,39,10+0,1076,1343,-267,B21,3,Mate,White
TRUE,101,10+0,1004,1085,-81,C40,4,Draw,Draw
TRUE,70,10+0,1023,1197,-174,C30,5,Resign,White
TRUE,61,10+0,1190,1052,138,C20,3,Out of Time,White
TRUE,53,10+0,1110,1104,6,C42,5,Mate,White
TRUE,38,10+0,1152,1218,-66,D00,2,Resign,Black
TRUE,30,10+0,1221,1238,-17,A10,3,Mate,Black
TRUE,84,10+0,1135,1129,6,B23,3,Mate,Black
TRUE,33,10+0,1218,1266,-48,B23,3,Mate,White
TRUE,62,10+0,1500,1398,102,C46,6,Out of Time,Black
TRUE,46,10+0,1500,1504,-4,C44,5,Out of Time,Black
TRUE,23,10+0,1644,1638,6,C68,8,Resign,White
FALSE,38,15+60,1638,2019,-381,B10,5,Out of Time,Black
TRUE,43,10+0,1500,1770,-270,C41,4,Draw,Draw
FALSE,77,10+0,1480,1496,-16,C02,7,Resign,White
FALSE,87,10+0,1480,1310,170,C50,8,Mate,White
FALSE,104,10+0,1082,1480,-398,D02,4,Mate,Black
FALSE,44,10+0,1480,1488,-8,C55,6,Resign,Black
FALSE,71,10+0,1359,1480,-121,C47,8,Resign,White
FALSE,36,10+0,1350,1480,-130,C61,6,Resign,Black
FALSE,23,10+0,1480,1350,130,C55,6,Resign,White
FALSE,40,10+0,1357,1480,-123,C26,5,Resign,White
FALSE,49,10+0,1480,1500,-20,C55,7,Resign,White
FALSE,52,10+0,1500,1480,20,C61,6,Resign,Black
FALSE,100,10+0,1444,1480,-36,D08,4,Mate,Black
FALSE,38,10+0,1480,1376,104,B01,6,Resign,Black
FALSE,35,10+0,1480,1027,453,C55,7,Resign,White
FALSE,14,10+0,1027,1480,-453,C46,7,Resign,Black
FALSE,35,10+0,1480,1499,-19,B30,5,Mate,White
FALSE,77,10+0,1480,1357,123,C55,7,Resign,White
FALSE,59,10+0,1480,1500,-20,B07,5,Mate,White
FALSE,40,10+0,1225,1480,-255,C50,6,Mate,Black
FALSE,40,10+0,1480,1490,-10,C50,8,Resign,Black
FALSE,54,10+0,1316,1480,-164,C61,6,Resign,Black
FALSE,71,10+0,1082,1480,-398,C62,6,Resign,White
FALSE,55,10+0,1480,1161,319,C41,7,Resign,White
FALSE,16,10+0,1500,1480,20,C50,6,Mate,Black
FALSE,66,10+0,1314,1480,-166,C20,3,Mate,Black
FALSE,50,10+0,1225,1480,-255,D08,7,Resign,White
FALSE,108,10+0,1480,1298,182,C44,6,Resign,Black
FALSE,25,10+0,1480,1456,24,C55,7,Resign,Black
FALSE,57,10+0,1480,1465,15,C50,8,Resign,White
FALSE,51,10+0,1480,1209,271,B07,3,Mate,White
FALSE,58,10+0,1209,1480,-271,A00,1,Mate,Black
FALSE,64,10+0,1500,1480,20,A10,2,Out of Time,Black
FALSE,60,10+0,1500,1480,20,A00,1,Mate,Black
FALSE,141,10+0,1480,1221,259,C50,8,Resign,White
FALSE,58,10+0,1480,1500,-20,B01,4,Resign,Black
FALSE,63,10+0,1480,1282,198,B56,11,Resign,White
FALSE,154,10+0,1276,1480,-204,C20,3,Mate,Black
FALSE,109,10+0,1475,1480,-5,C45,7,Draw,Draw
FALSE,22,10+0,1301,1480,-179,C28,5,Resign,Black
FALSE,55,10+0,1480,1301,179,C46,7,Mate,White
FALSE,35,10+0,1500,1480,20,D00,3,Resign,White
FALSE,59,10+0,1480,1233,247,C40,4,Mate,White
FALSE,6,10+0,1480,1269,211,C46,5,Resign,White
FALSE,148,10+0,1498,1480,18,C47,7,Mate,Black
FALSE,49,10+0,1480,944,536,C46,7,Mate,White
TRUE,16,8+0,1109,1171,-62,C15,7,Resign,Black
TRUE,29,15+0,1269,1136,133,D02,4,Resign,White
TRUE,78,20+0,1197,1078,119,A00,1,Resign,Black
TRUE,25,15+5,1637,1205,432,A40,1,Resign,White
TRUE,59,7+2,1137,1324,-187,A40,2,Mate,White
TRUE,55,7+2,1181,1200,-19,B07,4,Out of Time,White
TRUE,15,7+2,1123,1256,-133,A40,1,Resign,White
TRUE,75,7+2,1290,1179,111,C23,4,Out of Time,White
TRUE,5,15+15,1297,1346,-49,B07,3,Resign,White
FALSE,46,6+8,1346,1354,-8,A40,2,Mate,Black
TRUE,35,15+0,1545,1500,45,C44,5,Resign,White
FALSE,39,5+5,1500,1409,91,B00,2,Mate,White
TRUE,28,20+2,1500,1725,-225,A00,1,Mate,Black
FALSE,63,7+12,1691,1500,191,C41,5,Mate,White
FALSE,51,30+5,1500,1500,0,B07,3,Resign,White
FALSE,26,20+0,1500,1542,-42,C20,3,Mate,Black
FALSE,35,20+0,1542,1500,42,B00,2,Mate,White
FALSE,10,20+0,1500,1827,-327,C20,3,Mate,Black
FALSE,58,5+8,1500,1348,152,C20,3,Mate,Black
TRUE,52,5+8,1500,1331,169,C00,3,Mate,Black
TRUE,84,20+5,1876,1906,-30,B40,5,Resign,Black
TRUE,79,10+10,1837,1900,-63,D02,4,Mate,White
TRUE,40,5+8,1923,1887,36,C41,6,Resign,Black
TRUE,64,5+8,1935,1875,60,C41,5,Resign,Black
TRUE,66,8+0,1885,1897,-12,C02,9,Resign,Black
TRUE,141,8+0,1874,1876,-2,B06,2,Mate,White
TRUE,68,5+20,1883,1961,-78,B40,5,Resign,Black
TRUE,59,6+5,1872,1895,-23,A06,2,Resign,White
TRUE,56,6+5,1907,1860,47,B22,3,Resign,Black
TRUE,41,6+5,1847,1921,-74,E01,6,Resign,White
TRUE,68,10+0,1932,1951,-19,C23,3,Resign,Black
TRUE,92,10+0,1972,1919,53,B30,4,Resign,Black
TRUE,126,10+0,1929,1955,-26,C23,3,Resign,Black
TRUE,56,10+0,1941,1925,16,C69,9,Resign,Black
TRUE,102,10+0,1947,1929,18,B40,5,Out of Time,Black
TRUE,114,10+0,1941,1925,16,C50,6,Resign,Black
TRUE,36,10+10,1947,2114,-167,C02,8,Resign,Black
TRUE,3,10+10,1942,2119,-177,B22,3,Draw,Draw
TRUE,112,10+10,1949,2104,-155,C02,9,Resign,Black
FALSE,99,180+180,1176,1704,-528,C22,6,Resign,Black
FALSE,54,8+0,1259,1704,-445,C00,3,Resign,Black
FALSE,74,30+0,1307,1704,-397,C10,5,Mate,Black
FALSE,25,15+0,1691,1704,-13,C21,9,Resign,White
FALSE,73,5+5,1432,1704,-272,A00,1,Resign,White
FALSE,25,15+0,1459,1704,-245,C68,7,Resign,White
FALSE,21,5+5,1746,1704,42,C33,5,Resign,White
FALSE,40,10+0,1500,1521,-21,A00,1,Mate,Black
TRUE,153,7+2,2001,1740,261,D00,3,Resign,White
TRUE,126,7+2,1759,1532,227,B01,4,Out of Time,Black
TRUE,62,7+2,1757,1895,-138,B01,6,Resign,Black
TRUE,45,7+2,1853,1766,87,C41,5,Resign,White
TRUE,92,7+2,1579,1760,-181,C24,4,Resign,Black
TRUE,143,7+2,1768,1824,-56,C00,4,Draw,Draw
TRUE,68,7+2,1775,1544,231,C00,3,Draw,Draw
TRUE,71,15+0,1603,1559,44,A00,1,Resign,White
TRUE,45,10+0,1371,1576,-205,D20,4,Resign,White
TRUE,62,10+0,1455,1568,-113,D02,4,Mate,Black
TRUE,62,15+0,1581,1535,46,A41,3,Mate,Black
TRUE,38,10+0,1585,1820,-235,A60,6,Resign,Black
TRUE,23,10+0,1633,1595,38,C50,8,Resign,White
TRUE,68,10+0,1795,1578,217,D31,5,Resign,Black
TRUE,16,10+0,1489,1592,-103,D00,3,Resign,White
TRUE,52,10+0,1602,1636,-34,D30,4,Resign,Black
TRUE,67,15+0,1591,1581,10,A56,6,Out of Time,White
TRUE,105,20+0,1547,1604,-57,B25,4,Mate,White
TRUE,39,15+0,1594,1554,40,D02,4,Mate,White
TRUE,29,15+0,1578,1787,-209,D10,7,Mate,White
TRUE,51,15+0,1568,1549,19,D46,12,Resign,White
TRUE,148,15+0,1371,1573,-202,D02,4,Draw,Draw
TRUE,23,10+0,1635,1583,52,C65,6,Resign,White
TRUE,111,10+0,1576,1437,139,B32,5,Resign,White
TRUE,51,10+0,1567,1494,73,C62,6,Mate,White
TRUE,62,10+10,1504,1558,-54,C50,7,Resign,Black
TRUE,38,15+0,1600,1545,55,C50,6,Resign,Black
TRUE,83,15+0,1532,1614,-82,C60,5,Mate,White
TRUE,26,15+0,1629,1517,112,C20,4,Mate,Black
TRUE,49,10+2,1525,1633,-108,B27,6,Resign,Black
TRUE,74,10+2,1649,1510,139,A01,2,Resign,Black
TRUE,60,15+0,1525,1385,140,C55,7,Mate,Black
TRUE,118,10+0,1531,1689,-158,D20,5,Resign,Black
TRUE,94,30+0,1545,1461,84,C62,6,Resign,Black
TRUE,118,10+0,1612,1531,81,A22,6,Out of Time,Black
TRUE,52,10+0,1534,1868,-334,B12,6,Resign,Black
TRUE,116,10+0,1600,1521,79,B01,2,Mate,Black
TRUE,35,10+0,1533,1532,1,C68,7,Resign,White
TRUE,99,10+0,1532,1472,60,C00,3,Out of Time,White
TRUE,47,10+0,1632,1541,91,C50,6,Resign,White
TRUE,170,10+0,1551,1574,-23,C55,6,Mate,Black
TRUE,99,10+0,1628,1560,68,C77,9,Mate,White
TRUE,101,10+0,1638,1570,68,D02,4,Mate,White
TRUE,64,15+0,1575,1772,-197,C42,5,Mate,Black
TRUE,87,10+0,1477,1590,-113,B01,4,Out of Time,White
TRUE,118,10+0,1651,1608,43,D00,4,Draw,Draw
TRUE,121,10+0,1598,1539,59,B01,6,Mate,White
TRUE,131,10+0,1586,1607,-21,C02,8,Mate,White
TRUE,79,10+0,1585,1045,540,C40,4,Mate,White
TRUE,35,10+0,1671,1594,77,C60,7,Resign,White
TRUE,30,10+0,1633,1604,29,B21,3,Resign,White
TRUE,21,10+0,1616,1600,16,D20,6,Resign,Black
TRUE,65,10+0,1939,1619,320,B01,4,Resign,White
TRUE,102,10+0,1423,1614,-191,B01,2,Mate,Black
TRUE,78,15+0,1628,1538,90,C02,7,Resign,Black
TRUE,41,10+10,1838,1610,228,D20,5,Mate,White
TRUE,82,20+10,2067,1843,224,D00,3,Resign,White
TRUE,55,20+10,1825,2109,-284,E91,11,Mate,White
TRUE,71,20+10,2099,1829,270,A08,4,Mate,White
TRUE,108,15+10,1836,1987,-151,D55,11,Resign,Black
TRUE,113,20+10,1817,2085,-268,A46,5,Resign,White
TRUE,43,30+6,1799,2073,-274,D53,8,Resign,White
TRUE,100,20+10,1867,1785,82,B28,8,Mate,Black
TRUE,97,20+10,1771,1875,-104,A40,2,Mate,White
TRUE,36,20+10,1861,1757,104,C30,4,Resign,Black
TRUE,26,15+5,1728,1769,-41,D00,3,Resign,White
TRUE,40,10+0,1786,1609,177,D05,6,Resign,Black
TRUE,98,10+0,1500,1782,-282,A40,3,Resign,Black
TRUE,32,10+0,1684,1785,-101,D31,5,Resign,White
TRUE,59,10+0,1782,1484,298,D08,4,Resign,White
TRUE,29,10+0,1809,1792,17,B21,5,Resign,White
TRUE,34,10+0,1805,1757,48,D00,2,Resign,Black
TRUE,35,10+0,1803,1335,468,D06,4,Resign,White
TRUE,69,10+0,1663,1826,-163,B21,5,Resign,White
TRUE,41,10+0,1813,1874,-61,D20,5,Resign,White
TRUE,127,10+0,1801,1854,-53,D00,2,Resign,White
TRUE,45,10+0,1808,1947,-139,D04,5,Resign,Black
TRUE,46,10+0,1831,1796,35,B28,5,Resign,Black
TRUE,19,10+0,1480,1815,-335,B28,8,Resign,White
TRUE,83,10+0,1806,1728,78,D12,11,Resign,White
TRUE,65,15+10,1798,1885,-87,A48,8,Resign,White
TRUE,86,15+10,1804,1869,-65,C01,5,Draw,Draw
TRUE,97,15+10,1858,1814,44,B21,3,Mate,White
TRUE,105,15+10,1812,1874,-62,D10,4,Draw,Draw
TRUE,51,15+10,1847,1822,25,B28,8,Mate,White
TRUE,53,12+12,1888,1831,57,B21,3,Out of Time,White
TRUE,64,15+10,1839,1967,-128,D55,11,Out of Time,Black
TRUE,76,15+10,1846,1977,-131,C01,5,Resign,Black
TRUE,76,20+30,1845,2011,-166,D56,14,Mate,Black
TRUE,33,15+10,1997,1852,145,A06,3,Resign,White
TRUE,139,15+10,1976,1848,128,B32,6,Draw,Draw
TRUE,65,15+10,1841,1847,-6,B20,3,Out of Time,White
TRUE,25,15+0,1235,1669,-434,C55,6,Mate,White
TRUE,67,15+0,1924,1674,250,C35,6,Resign,White
TRUE,96,15+0,1693,1455,238,D06,4,Mate,Black
TRUE,62,15+0,1683,1619,64,D55,11,Resign,White
TRUE,102,15+0,1588,1674,-86,C50,6,Mate,Black
TRUE,63,15+0,1661,1680,-19,A53,4,Resign,White
TRUE,46,15+0,1199,1659,-460,C46,6,Resign,Black
TRUE,100,15+0,1565,1673,-108,C79,10,Resign,White
TRUE,134,15+0,1690,1540,150,D20,5,Resign,Black
TRUE,72,15+0,1696,1896,-200,E90,11,Resign,Black
TRUE,81,15+0,1888,1702,186,C45,8,Mate,White
TRUE,87,15+0,1696,1515,181,D53,8,Out of Time,White
TRUE,56,15+0,1554,1713,-159,D02,4,Resign,White
TRUE,160,15+0,1722,1817,-95,D51,9,Mate,Black
TRUE,60,15+0,1720,1334,386,A40,2,Resign,White
TRUE,119,15+0,1718,1205,513,D20,5,Resign,White
TRUE,18,15+0,1652,1708,-56,C44,5,Mate,Black
TRUE,109,10+0,1525,1494,31,C44,5,Resign,Black
TRUE,84,10+0,1530,1561,-31,C00,3,Resign,Black
TRUE,76,10+0,1575,1516,59,E81,10,Resign,Black
TRUE,65,10+0,1514,1108,406,C44,5,Mate,White
TRUE,27,10+0,1602,1523,79,A48,5,Resign,White
TRUE,13,10+0,1538,1452,86,C44,5,Resign,Black
TRUE,66,10+0,1541,1900,-359,C45,7,Mate,Black
TRUE,79,10+0,1708,1548,160,B07,2,Resign,White
TRUE,76,10+0,1270,1544,-274,B07,5,Mate,Black
FALSE,70,10+0,1733,1732,1,D00,4,Mate,Black
FALSE,105,10+0,1732,1733,-1,A80,2,Resign,White
FALSE,5,10+0,1733,1732,1,A01,2,Resign,White
FALSE,8,10+0,1732,1733,-1,B00,2,Out of Time,Black
FALSE,60,10+0,1733,1732,1,C33,5,Resign,Black
FALSE,54,10+0,1732,1733,-1,E77,15,Out of Time,Black
FALSE,53,10+0,1733,1732,1,A08,4,Resign,White
FALSE,55,10+0,1732,1654,78,D43,8,Mate,White
FALSE,64,10+0,1654,1732,-78,D35,6,Resign,Black
FALSE,146,10+0,1732,1733,-1,B00,5,Resign,Black
FALSE,113,10+0,1732,1733,-1,E32,7,Draw,Draw
FALSE,102,10+0,1733,1732,1,D46,12,Resign,Black
FALSE,15,30+12,1733,1732,1,A02,4,Resign,White
TRUE,33,10+0,1558,1551,7,B01,4,Resign,White
TRUE,119,10+0,1532,1546,-14,B00,2,Mate,White
TRUE,50,10+0,1377,1520,-143,B01,2,Mate,Black
TRUE,66,15+1,1429,1487,-58,C25,4,Resign,Black
FALSE,45,60+0,1249,1500,-251,A00,1,Mate,White
FALSE,36,20+0,1249,1500,-251,C58,11,Mate,Black
TRUE,31,10+0,1202,1238,-36,C21,4,Mate,White
TRUE,51,10+0,1227,1254,-27,C02,5,Resign,White
TRUE,29,10+0,1134,1259,-125,C42,5,Resign,White
FALSE,11,5+20,1500,1134,366,A45,2,Resign,White
TRUE,77,10+0,1220,1205,15,C10,5,Out of Time,White
TRUE,42,10+0,1278,1357,-79,D06,3,Mate,Black
FALSE,16,10+4,1278,1711,-433,D06,4,Resign,Black
FALSE,58,10+4,1278,1500,-222,B01,2,Mate,Black
FALSE,41,10+4,1500,1278,222,D00,2,Mate,White
FALSE,16,10+4,1278,1500,-222,B01,2,Resign,Black
FALSE,18,5+8,1018,1278,-260,D50,7,Resign,White
FALSE,10,10+5,1278,1500,-222,C23,3,Resign,Black
FALSE,6,10+5,1278,1500,-222,C23,3,Resign,Black
FALSE,7,15+0,1620,1278,342,C23,3,Mate,White
FALSE,74,20+3,1278,1500,-222,C65,6,Mate,Black
FALSE,53,10+0,1500,1278,222,D20,4,Resign,White
FALSE,79,5+10,1546,1278,268,D31,5,Out of Time,White
FALSE,70,5+10,1278,1611,-333,B21,3,Mate,Black
FALSE,47,5+10,1406,1278,128,D07,6,Mate,White
TRUE,41,10+5,1477,1364,113,B21,3,Mate,White
FALSE,21,6+5,1364,1283,81,B52,6,Resign,White
FALSE,87,15+10,1400,1259,141,A04,2,Mate,White
FALSE,57,25+2,1423,1400,23,B00,2,Resign,White
FALSE,60,10+2,1400,1476,-76,A04,2,Out of Time,Black
FALSE,72,15+10,1290,1400,-110,A10,1,Out of Time,Black
FALSE,73,15+10,1530,1400,130,B00,2,Resign,White
FALSE,27,15+10,1619,1400,219,A40,2,Mate,White
FALSE,44,15+10,1400,1619,-219,A06,3,Resign,Black
FALSE,72,15+10,1302,1400,-98,A40,2,Mate,Black
FALSE,113,10+0,1400,1475,-75,A06,3,Mate,White
FALSE,46,15+10,1400,1476,-76,A04,2,Resign,White
FALSE,16,25+0,1741,1400,341,B00,2,Resign,White
FALSE,73,15+10,1400,1028,372,A04,2,Mate,White
FALSE,106,5+8,1766,1400,366,B00,2,Draw,Draw
FALSE,51,15+0,1437,1400,37,A40,2,Resign,White
FALSE,18,15+0,1352,1400,-48,B00,2,Resign,Black
FALSE,95,15+0,1631,1400,231,B00,5,Out of Time,White
FALSE,18,10+0,1559,1400,159,A40,2,Resign,White
FALSE,64,15+0,1400,1635,-235,A04,2,Resign,Black
FALSE,9,40+10,1400,1381,19,A06,3,Resign,White
FALSE,25,15+15,1171,1400,-229,B00,2,Resign,Black
FALSE,59,10+0,1318,1400,-82,B00,2,Resign,White
FALSE,85,20+0,1400,1372,28,A04,2,Mate,White
FALSE,30,20+0,1400,1387,13,A06,3,Resign,Black
FALSE,15,20+0,1371,1400,-29,B00,2,Mate,White
FALSE,66,20+0,1400,1349,51,A06,3,Resign,Black
FALSE,38,20+0,1675,1400,275,B00,2,Mate,Black
FALSE,18,10+0,1515,1400,115,B00,2,Resign,Black
FALSE,81,15+10,1400,1332,68,A04,2,Mate,White
FALSE,58,5+8,1366,1400,-34,B00,2,Mate,Black
FALSE,31,5+5,1589,1400,189,B00,2,Resign,Black
FALSE,49,10+5,1400,1466,-66,A06,3,Resign,White
FALSE,44,8+0,1400,1437,-37,A04,2,Resign,Black
FALSE,65,15+10,1566,1400,166,A00,1,Resign,White
FALSE,40,15+10,1356,1400,-44,B00,2,Mate,Black
FALSE,28,15+10,1400,1395,5,A04,2,Resign,Black
FALSE,56,15+10,1500,1400,100,B00,2,Mate,Black
FALSE,19,15+10,1400,1396,4,A04,2,Resign,White
FALSE,105,15+10,1400,1412,-12,A04,2,Mate,White
FALSE,40,15+10,1442,1400,42,A00,1,Mate,Black
FALSE,50,10+10,1532,1503,29,D01,4,Mate,Black
TRUE,40,15+0,1385,1526,-141,C50,7,Resign,Black
TRUE,90,15+5,1537,1509,28,C44,8,Resign,Black
TRUE,42,16+2,1470,1528,-58,C50,6,Mate,Black
TRUE,15,16+2,1477,1541,-64,C62,6,Resign,White
TRUE,48,16+2,1556,1420,136,B01,4,Resign,Black
TRUE,15,16+2,1552,1314,238,C00,3,Mate,White
TRUE,57,14+0,1545,1393,152,B40,4,Resign,White
TRUE,50,15+2,1517,1535,-18,C30,3,Mate,Black
TRUE,44,20+5,1514,1524,-10,C20,3,Mate,Black
TRUE,52,10+0,1552,1512,40,C46,5,Out of Time,Black
TRUE,40,10+0,1499,1501,-2,A20,2,Mate,Black
TRUE,27,8+2,1492,1456,36,C40,5,Mate,White
TRUE,95,90+0,1484,1378,106,B40,6,Resign,White
TRUE,138,20+0,1394,1475,-81,C50,6,Mate,Black
TRUE,23,20+0,1491,1283,208,C41,5,Resign,Black
TRUE,48,8+0,1508,1243,265,C40,4,Resign,Black
TRUE,128,15+0,1275,1504,-229,A00,1,Mate,Black
TRUE,16,15+0,1514,1515,-1,C42,5,Resign,Black
TRUE,34,15+0,1482,1504,-22,C41,5,Resign,Black
TRUE,131,10+0,1552,1491,61,C20,3,Draw,Draw
TRUE,28,10+0,1455,1480,-25,C64,6,Resign,Black
TRUE,31,10+0,1352,1496,-144,A00,3,Resign,White
TRUE,46,10+0,1507,1494,13,C00,3,Resign,Black
TRUE,35,10+0,1496,1489,7,B01,4,Mate,White
TRUE,52,10+0,1461,1486,-25,C50,11,Resign,Black
TRUE,23,10+0,1475,1465,10,C00,3,Resign,White
TRUE,111,10+0,2193,1882,311,E51,10,Resign,White
TRUE,19,25+30,2193,1963,230,D07,5,Resign,White
TRUE,40,5+8,1927,2193,-266,A33,10,Resign,Black
TRUE,13,5+8,2193,1965,228,D21,6,Out of Time,White
TRUE,4,7+4,1996,2193,-197,A03,2,Resign,Black
TRUE,36,15+10,1799,2193,-394,C21,10,Resign,Black
TRUE,53,15+10,2193,1799,394,D12,8,Resign,White
TRUE,46,15+10,1799,2193,-394,C00,3,Resign,Black
TRUE,135,15+0,2145,2193,-48,C55,7,Mate,White
FALSE,24,10+0,1814,2193,-379,C02,7,Resign,Black
FALSE,57,30+30,2193,1864,329,C60,6,Resign,White
FALSE,19,30+11,2193,2002,191,C68,10,Resign,White
TRUE,62,10+3,2037,2157,-120,D02,8,Mate,Black
TRUE,51,10+3,2105,2047,58,C00,3,Mate,White
TRUE,33,10+0,2029,2040,-11,D80,7,Resign,White
TRUE,47,5+5,1939,2177,-238,A29,7,Resign,White
TRUE,31,5+5,2115,1945,170,B54,6,Resign,White
TRUE,38,5+5,1953,1973,-20,A29,7,Resign,Black
TRUE,27,30+0,1500,1906,-406,C65,8,Mate,White
FALSE,52,4+10,1861,1500,361,D35,6,Mate,Black
FALSE,127,6+4,1500,2119,-619,C42,9,Resign,White
FALSE,138,6+4,2119,1500,619,C67,10,Resign,Black
FALSE,28,12+13,1281,1500,-219,A00,1,Resign,Black
FALSE,43,12+13,1500,1281,219,A40,6,Mate,White
TRUE,80,5+8,1633,1625,8,C57,11,Resign,Black
TRUE,21,15+5,1667,1634,33,C72,9,Resign,White
TRUE,49,15+4,1645,1645,0,D10,5,Resign,White
TRUE,60,10+3,1653,1742,-89,D00,3,Mate,Black
TRUE,45,11+8,1666,1663,3,C45,8,Resign,White
TRUE,112,8+8,1679,1652,27,B20,3,Resign,Black
TRUE,171,10+5,1641,1643,-2,D00,3,Resign,White
TRUE,65,15+0,1629,1699,-70,D00,3,Mate,White
TRUE,114,15+3,1588,1619,-31,C52,11,Out of Time,Black
FALSE,75,5+5,2222,2126,96,C80,12,Resign,White
FALSE,114,25+0,2070,2126,-56,C68,8,Resign,Black
FALSE,68,7+5,1287,2126,-839,A00,1,Mate,Black
FALSE,3,20+0,1081,2126,-1045,C40,3,Resign,White
FALSE,46,10+0,2126,1878,248,C47,8,Out of Time,Black
FALSE,35,20+5,2126,1225,901,C40,4,Resign,White
TRUE,91,20+5,1659,2126,-467,C59,16,Resign,White
FALSE,30,10+0,1911,2126,-215,C44,9,Resign,Black
TRUE,106,6+10,2009,2126,-117,C77,9,Out of Time,Black
FALSE,35,15+3,2126,1845,281,C66,8,Resign,White
FALSE,93,20+0,2126,1125,1001,C64,7,Resign,White
FALSE,40,15+15,2126,2047,79,C78,9,Resign,White
FALSE,48,15+15,2047,2126,-79,C53,9,Resign,Black
TRUE,51,10+0,2126,2202,-76,B01,6,Resign,White
TRUE,32,15+8,1673,2126,-453,C45,10,Resign,Black
FALSE,29,45+0,1768,2126,-358,D30,4,Resign,Black
TRUE,62,60+4,2057,2126,-69,C45,10,Resign,Black
TRUE,24,15+0,2101,2048,53,D32,10,Out of Time,Black
TRUE,80,15+5,1975,1962,13,C55,7,Resign,Black
TRUE,33,15+10,1790,2034,-244,C10,6,Resign,White
TRUE,51,10+30,1500,1319,181,C41,5,Mate,White
TRUE,71,25+0,1642,1055,587,B07,2,Mate,White
TRUE,9,15+0,1251,1086,165,B10,2,Mate,White
TRUE,31,60+3,1091,1645,-554,A00,1,Resign,Black
TRUE,43,30+10,1306,1124,182,A04,2,Resign,White
TRUE,54,10+0,1183,1248,-65,A00,1,Mate,Black
TRUE,69,10+0,1236,1285,-49,B07,2,Resign,White
TRUE,83,10+0,1662,1315,347,B06,2,Resign,White
TRUE,51,10+0,1718,1345,373,B00,4,Mate,White
TRUE,41,15+3,1615,1500,115,A40,2,Mate,White
FALSE,96,10+5,1549,1425,124,C46,5,Resign,Black
TRUE,60,10+0,1488,1478,10,C62,6,Mate,Black
TRUE,90,10+0,1491,1541,-50,A00,1,Resign,Black
TRUE,98,10+0,1746,1466,280,C60,6,Resign,Black
TRUE,67,10+0,1460,1242,218,C44,4,Mate,White
TRUE,23,10+0,1825,1463,362,C45,7,Resign,White
TRUE,21,10+0,1448,1461,-13,C44,4,Resign,White
TRUE,61,10+0,1433,1421,12,A00,1,Resign,White
TRUE,92,10+0,1442,1609,-167,A00,1,Out of Time,Black
TRUE,16,10+0,1453,1558,-105,A00,1,Resign,Black
TRUE,67,10+0,1550,1466,84,C42,5,Resign,White
TRUE,79,10+0,1452,1378,74,A00,1,Resign,White
TRUE,67,8+2,1647,1461,186,D20,6,Resign,White
TRUE,45,8+2,1434,1665,-231,C44,4,Resign,White
TRUE,61,10+0,1412,1477,-65,A00,1,Out of Time,White
TRUE,94,10+0,1393,1404,-11,C41,4,Resign,White
TRUE,65,10+0,1372,1409,-37,C44,4,Mate,White
TRUE,83,10+0,1298,1398,-100,C62,6,Mate,White
TRUE,133,10+0,1423,1418,5,C62,6,Resign,White
TRUE,67,10+0,1311,1402,-91,C44,4,Resign,Black
TRUE,47,10+0,1383,1323,60,A00,1,Resign,White
TRUE,46,10+0,1333,1361,-28,C41,5,Mate,Black
TRUE,64,30+0,1522,1404,118,C55,7,Mate,Black
TRUE,74,20+10,1537,1453,84,B40,8,Mate,Black
TRUE,47,20+10,1433,1553,-120,C78,10,Mate,White
TRUE,123,20+10,1544,1444,100,C42,5,Resign,White
TRUE,39,15+10,1657,1544,113,C26,5,Mate,White
TRUE,114,15+10,1853,1523,330,C26,5,Resign,Black
TRUE,53,20+6,1491,1537,-46,C77,9,Mate,White
TRUE,27,20+6,1525,1501,24,B20,3,Resign,White
TRUE,27,20+0,1504,1811,-307,B07,4,Resign,White
TRUE,61,13+10,1493,1439,54,B20,3,Resign,White
TRUE,123,10+0,1685,1499,186,C20,3,Mate,White
TRUE,99,10+0,1862,1502,360,B01,4,Out of Time,White
TRUE,17,10+0,1496,1316,180,C55,7,Mate,White
TRUE,101,10+0,1908,1498,410,C65,6,Mate,White
TRUE,54,10+0,1500,1989,-489,C53,10,Mate,Black
TRUE,45,10+0,1482,1648,-166,C55,6,Resign,White
TRUE,32,10+0,1500,1473,27,C00,5,Mate,Black
TRUE,113,15+8,1566,1494,72,C65,7,Mate,White
TRUE,44,20+7,1497,1820,-323,A20,2,Mate,Black
TRUE,23,25+0,1480,1637,-157,C55,6,Resign,White
TRUE,47,20+2,1675,1486,189,C44,4,Mate,White
TRUE,54,30+0,1474,1460,14,A00,1,Resign,White
TRUE,53,1+30,1492,1487,5,D00,3,Mate,White
TRUE,43,10+0,1540,1569,-29,B01,4,Resign,White
TRUE,10,10+0,1570,2090,-520,C60,7,Resign,Black
TRUE,85,10+0,1574,1853,-279,C50,9,Resign,Black
TRUE,56,10+0,1587,1573,14,B00,2,Resign,Black
TRUE,29,10+0,1576,1587,-11,C02,5,Resign,White
TRUE,48,10+0,1299,1583,-284,D00,3,Out of Time,Black
TRUE,56,10+0,1507,1573,-66,D20,5,Mate,Black
TRUE,88,10+0,1574,2093,-519,B22,3,Mate,Black
TRUE,84,10+0,1576,2023,-447,C46,6,Mate,Black
TRUE,83,10+0,1560,1661,-101,B21,3,Out of Time,White
TRUE,76,10+0,1253,1556,-303,A00,1,Mate,Black
TRUE,75,10+0,1538,1721,-183,C21,7,Resign,White
TRUE,43,10+0,1354,1557,-203,B01,4,Mate,White
TRUE,66,10+0,1183,1554,-371,A00,1,Mate,Black
TRUE,48,10+0,1548,1334,214,B00,2,Resign,White
TRUE,22,10+0,1304,1543,-239,B00,5,Resign,Black
TRUE,36,10+0,1558,1479,79,C46,6,Resign,Black
TRUE,42,10+0,1572,1544,28,B01,4,Out of Time,Black
TRUE,96,10+0,1555,1632,-77,C48,9,Mate,Black
TRUE,64,10+0,1563,1697,-134,B01,6,Resign,Black
FALSE,65,20+0,1563,1411,152,D31,6,Mate,White
TRUE,69,16+0,1421,1347,74,D06,4,Out of Time,White
TRUE,25,60+0,1563,1352,211,A45,2,Out of Time,White
TRUE,51,20+0,1336,1468,-132,C50,8,Resign,White
TRUE,99,10+4,1525,1343,182,C55,7,Resign,White
TRUE,60,10+5,1349,1497,-148,C44,5,Out of Time,Black
TRUE,69,15+0,1468,1358,110,C41,4,Resign,White
TRUE,44,15+5,1360,1764,-404,C45,7,Out of Time,Black
TRUE,99,10+5,1344,1478,-134,B32,8,Resign,White
TRUE,132,10+2,1474,1328,146,C20,3,Resign,Black
TRUE,69,8+8,1615,1332,283,D06,4,Resign,White
TRUE,12,90+30,1338,1541,-203,C50,9,Out of Time,Black
TRUE,64,10+0,1345,1483,-138,B06,4,Resign,Black
TRUE,48,30+0,1351,1532,-181,C41,5,Resign,Black
TRUE,36,10+5,1360,1432,-72,C45,10,Resign,Black
TRUE,28,10+5,1445,1345,100,C42,4,Mate,Black
TRUE,30,15+5,1353,1485,-132,C00,3,Resign,Black
TRUE,46,4+8,1342,1546,-204,C45,7,Resign,Black
TRUE,25,7+7,1696,1344,352,C20,3,Resign,White
TRUE,92,10+0,1348,1652,-304,C42,7,Resign,Black
TRUE,90,20+0,1356,1461,-105,B01,4,Mate,Black
TRUE,111,9+2,1596,1360,236,D02,4,Resign,White
TRUE,45,12+6,1525,1367,158,D02,4,Resign,White
TRUE,50,12+6,1362,1529,-167,B32,8,Draw,Draw
TRUE,56,12+6,1534,1357,177,D37,7,Draw,Draw
TRUE,46,10+5,1497,1364,133,A00,1,Resign,White
TRUE,12,10+5,1372,1461,-89,B00,2,Resign,Black
TRUE,56,10+3,1375,1679,-304,C00,3,Resign,Black
TRUE,47,15+0,1454,1384,70,C42,4,Out of Time,White
TRUE,30,25+5,1392,1488,-96,C44,5,Resign,Black
TRUE,53,25+5,1479,1400,79,C20,3,Mate,White
TRUE,138,10+5,1341,1391,-50,C42,5,Mate,Black
TRUE,30,40+0,1399,1483,-84,C55,6,Resign,Black
FALSE,61,10+8,1564,1399,165,A00,1,Out of Time,White
TRUE,68,15+0,1440,1387,53,B06,4,Mate,Black
TRUE,81,19+0,1381,1181,200,B00,2,Resign,White
TRUE,119,5+8,1651,1385,266,C20,3,Resign,White
TRUE,18,15+5,1347,1376,-29,C42,6,Resign,Black
FALSE,30,10+2,1376,1444,-68,C00,3,Resign,Black
TRUE,89,10+1,1383,1386,-3,C00,3,Out of Time,White
TRUE,35,17+2,1489,1394,95,A00,1,Mate,White
TRUE,11,10+0,1429,1404,25,C00,3,Resign,White
TRUE,22,10+5,1431,1376,55,B10,2,Resign,Black
TRUE,43,15+5,2005,2151,-146,B25,4,Mate,White
TRUE,59,3+8,2285,2173,112,A20,2,Resign,White
TRUE,41,10+0,1500,1370,130,A06,3,Mate,White
TRUE,58,10+0,1370,1500,-130,B18,8,Mate,Black
TRUE,16,10+0,1514,1378,136,D00,3,Resign,White
TRUE,48,10+0,1311,1368,-57,D00,3,Mate,Black
TRUE,88,10+0,1369,2070,-701,D01,4,Out of Time,Black
TRUE,61,10+0,1344,1961,-617,C45,7,Resign,White
TRUE,70,10+0,1880,1320,560,B01,4,Resign,Black
TRUE,12,10+0,1807,1274,533,A00,3,Resign,Black
TRUE,45,10+0,1253,1620,-367,C41,6,Mate,White
TRUE,68,10+0,1632,1232,400,D20,5,Mate,Black
TRUE,62,10+0,1232,2017,-785,C45,8,Mate,Black
TRUE,41,10+0,1359,1218,141,C50,5,Resign,Black
TRUE,39,10+0,1210,1112,98,B00,2,Mate,White
TRUE,35,10+0,1210,1191,19,B00,4,Mate,White
TRUE,106,10+0,1221,1226,-5,C20,3,Mate,Black
TRUE,29,10+0,1157,1211,-54,C20,3,Resign,Black
TRUE,19,10+0,1201,1180,21,C44,5,Resign,White
TRUE,18,10+0,1207,1190,17,C57,8,Resign,Black
TRUE,19,10+0,1179,1197,-18,B00,7,Mate,White
TRUE,138,10+0,1315,1163,152,C47,7,Resign,Black
TRUE,61,10+0,1166,1061,105,B01,2,Resign,Black
TRUE,25,10+0,1197,1176,21,C62,6,Mate,White
TRUE,47,10+0,1163,1214,-51,D30,4,Mate,White
TRUE,32,10+0,1152,1152,0,C20,3,Mate,Black
TRUE,60,10+0,1156,1442,-286,D20,4,Resign,Black
TRUE,118,10+0,1154,1332,-178,B10,2,Mate,Black
TRUE,51,10+0,1348,1160,188,C02,5,Mate,White
TRUE,27,10+0,1322,1147,175,B21,3,Resign,White
TRUE,14,10+0,1153,1370,-217,C23,3,Resign,Black
TRUE,123,10+0,1152,1162,-10,D20,4,Out of Time,Draw
TRUE,74,10+0,1064,1144,-80,A00,1,Out of Time,Black
FALSE,8,30+0,1144,1500,-356,C23,3,Resign,Black
TRUE,125,10+0,1192,1153,39,C26,4,Out of Time,White
TRUE,122,10+0,1106,1143,-37,C60,6,Mate,Black
TRUE,120,10+0,1157,1092,65,C20,3,Mate,Black
TRUE,123,10+0,1076,1171,-95,B02,4,Mate,White
TRUE,56,10+0,1083,1165,-82,B02,4,Mate,Black
TRUE,35,10+0,1189,1164,25,B02,4,Draw,Draw
TRUE,55,10+0,1151,1202,-51,A40,2,Mate,White
TRUE,59,10+0,1236,1137,99,A40,2,Resign,Black
TRUE,85,10+0,1301,1143,158,B00,2,Mate,White
TRUE,78,10+0,1148,1417,-269,D10,5,Mate,Black
TRUE,67,10+0,1155,1292,-137,A40,2,Resign,Black
FALSE,74,5+10,1660,1838,-178,D30,4,Out of Time,Black
FALSE,85,10+0,1751,1838,-87,C65,6,Resign,White
FALSE,64,15+0,1961,1838,123,C62,11,Resign,White
FALSE,39,10+0,1848,1838,10,C44,8,Mate,White
FALSE,157,15+10,1838,1699,139,C69,9,Mate,White
TRUE,56,10+0,1977,1919,58,D04,6,Resign,Black
TRUE,51,10+0,1868,1991,-123,C02,9,Resign,White
TRUE,21,15+15,1835,1760,75,C58,11,Mate,White
TRUE,44,15+15,1769,1791,-22,C01,9,Mate,Black
TRUE,42,15+15,1473,1775,-302,A00,1,Resign,Black
TRUE,31,15+15,1755,1477,278,B02,6,Resign,White
TRUE,20,15+15,1481,1730,-249,A00,1,Mate,Black
TRUE,35,15+15,1697,1486,211,C00,3,Resign,White
TRUE,50,15+15,1492,1649,-157,A00,1,Mate,Black
TRUE,59,15+15,1603,1384,219,C55,7,Mate,White
TRUE,25,15+15,1500,1524,-24,B01,2,Mate,White
TRUE,31,12+12,1492,1173,319,C44,5,Resign,White
TRUE,15,10+8,1356,1186,170,C42,6,Resign,White
TRUE,74,10+0,1208,1311,-103,C46,5,Resign,Black
TRUE,45,15+0,1513,1197,316,E10,5,Mate,White
TRUE,13,15+0,1175,1142,33,C20,3,Resign,White
FALSE,52,20+0,1175,1673,-498,C20,3,Mate,Black
FALSE,27,20+0,1673,1175,498,C57,7,Mate,White
FALSE,9,20+0,1175,1673,-498,C20,3,Mate,White
TRUE,130,15+8,1462,1158,304,C46,6,Draw,Draw
TRUE,11,15+15,1473,1166,307,C23,3,Resign,White
TRUE,44,20+15,1155,1170,-15,C23,3,Resign,Black
TRUE,56,20+15,1137,1190,-53,B00,2,Resign,White
TRUE,22,20+15,1234,1096,138,E00,1,Resign,Black
TRUE,68,20+15,1097,1902,-805,B10,2,Mate,Black
TRUE,25,20+15,1901,1097,804,A40,6,Resign,White
FALSE,29,180+8,1500,1097,403,C46,6,Resign,White
FALSE,25,180+8,1097,1500,-403,C20,4,Resign,Black
TRUE,62,30+0,1101,1635,-534,C20,3,Mate,Black
TRUE,13,30+0,1633,1104,529,C40,3,Mate,White
TRUE,16,30+0,1107,1631,-524,C20,3,Resign,Black
TRUE,49,30+0,1273,1129,144,A00,1,Resign,White
TRUE,94,30+0,1155,1265,-110,C00,2,Resign,Black
TRUE,22,10+10,1158,1766,-608,C20,3,Resign,Black
TRUE,8,30+5,1517,1134,383,A40,6,Draw,Draw
FALSE,16,15+10,1551,1703,-152,B50,4,Draw,Draw
FALSE,71,15+10,1703,1551,152,C60,5,Resign,White
FALSE,69,15+10,1703,1677,26,B06,4,Resign,Black
FALSE,27,15+10,1677,1703,-26,A05,10,Resign,White
FALSE,47,15+10,1703,1677,26,A01,5,Mate,White
FALSE,44,15+10,1703,1583,120,A01,3,Resign,White
FALSE,46,15+10,1682,1703,-21,B20,2,Resign,White
TRUE,111,15+10,1579,1722,-143,A45,4,Mate,White
FALSE,33,15+10,1722,1745,-23,C62,6,Resign,White
FALSE,57,15+10,1722,1767,-45,B72,11,Resign,White
FALSE,41,15+10,1767,1722,45,B57,8,Resign,White
FALSE,99,15+10,1722,1735,-13,C41,4,Resign,Black
FALSE,89,15+10,1722,1674,48,B80,13,Resign,White
FALSE,76,15+10,1674,1722,-48,B54,6,Mate,Black
TRUE,96,15+10,1727,1586,141,D20,5,Draw,Draw
FALSE,43,15+10,1727,1621,106,D46,12,Resign,White
FALSE,44,15+10,1856,1727,129,B54,6,Resign,White
TRUE,63,15+10,1670,1744,-74,B50,4,Mate,White
FALSE,54,15+10,1744,1924,-180,D06,4,Resign,Black
FALSE,54,15+10,1897,1744,153,B22,3,Resign,White
TRUE,21,15+10,1732,1759,-27,B22,3,Resign,White
TRUE,43,15+10,1747,1703,44,D10,4,Resign,White
TRUE,75,15+10,1749,1702,47,D37,7,Draw,Draw
FALSE,28,15+15,1749,1806,-57,A01,2,Resign,Black
TRUE,39,15+10,1738,1623,115,A40,4,Resign,White
TRUE,28,15+10,1632,1727,-95,B20,3,Mate,Black
TRUE,57,15+10,1857,1737,120,D04,5,Resign,White
TRUE,112,15+10,1776,1736,40,D02,5,Draw,Draw
TRUE,109,15+10,1715,1788,-73,D06,4,Resign,White
TRUE,153,15+10,1798,1729,69,E20,5,Mate,White
TRUE,11,15+10,1714,1658,56,D06,4,Resign,White
FALSE,45,15+2,2076,1714,362,B21,3,Resign,White
FALSE,32,15+10,1714,1709,5,D06,4,Resign,Black
FALSE,20,15+10,1800,1714,86,B23,3,Resign,Black
FALSE,28,15+10,1714,1800,-86,A25,4,Resign,Black
FALSE,52,15+10,1800,1714,86,B50,4,Mate,Black
TRUE,61,15+10,1651,1737,-86,B20,3,Resign,White
FALSE,17,15+5,1737,1647,90,E38,8,Resign,White
FALSE,62,15+5,1647,1737,-90,B22,3,Resign,Black
FALSE,31,15+5,1737,1647,90,E12,7,Resign,White
FALSE,32,15+10,1737,1631,106,A22,6,Resign,Black
FALSE,29,15+5,1868,1737,131,B53,7,Resign,White
TRUE,85,15+0,1549,1419,130,B50,6,Resign,White
TRUE,15,15+5,1772,1554,218,A04,2,Resign,White
TRUE,40,10+10,1559,1767,-208,C55,6,Mate,Black
TRUE,59,5+8,1664,1568,96,B50,4,Resign,White
TRUE,36,15+5,1578,1603,-25,B43,9,Resign,Black
TRUE,25,8+0,1835,1582,253,B21,7,Mate,White
TRUE,72,15+0,1593,1608,-15,B46,10,Resign,Black
TRUE,64,15+0,1620,1581,39,D02,4,Resign,Black
TRUE,85,15+0,1567,1632,-65,B10,2,Resign,White
TRUE,48,15+0,1646,1553,93,B20,3,Resign,Black
TRUE,89,15+0,1538,1660,-122,B40,6,Resign,White
TRUE,51,10+3,1859,1541,318,B50,4,Resign,White
TRUE,37,5+8,1370,1558,-188,B20,3,Resign,White
TRUE,56,15+15,1565,1712,-147,B01,4,Mate,Black
TRUE,39,10+7,1571,1725,-154,B40,6,Resign,Black
FALSE,59,15+0,1748,1571,177,B70,10,Resign,White
TRUE,122,15+5,1575,1844,-269,B02,4,Mate,Black
TRUE,82,15+5,1840,1580,260,A52,6,Resign,White
TRUE,44,7+8,1698,1564,134,B53,7,Resign,Black
TRUE,41,5+5,1557,1443,114,C10,8,Mate,White
TRUE,18,5+5,1452,1549,-97,A04,2,Mate,Black
TRUE,113,10+5,1666,1556,110,B01,4,Resign,White
TRUE,59,15+3,1575,1567,8,B72,13,Resign,White
TRUE,37,12+0,1701,1575,126,B20,3,Resign,White
TRUE,101,5+5,1570,1321,249,C10,5,Resign,White
TRUE,81,20+0,1556,1676,-120,C55,6,Out of Time,White
TRUE,70,5+5,1597,1543,54,C45,7,Resign,Black
TRUE,15,5+5,1529,1610,-81,C50,5,Mate,White
TRUE,71,12+0,1623,1538,85,A51,4,Resign,White
TRUE,32,10+0,1752,1543,209,D01,5,Resign,White
TRUE,44,10+5,1549,1720,-171,C41,4,Resign,Black
TRUE,39,20+0,1557,1675,-118,C10,6,Resign,Black
TRUE,63,10+0,1663,1565,98,B20,3,Resign,White
TRUE,59,8+0,1644,1574,70,B20,3,Mate,White
TRUE,87,5+8,1573,1599,-26,B00,2,Draw,Draw
TRUE,16,5+8,1611,1560,51,A52,7,Mate,Black
TRUE,52,10+2,1548,1549,-1,A51,4,Resign,Black
TRUE,55,10+0,1555,1730,-175,B46,10,Resign,Black
TRUE,26,10+5,1559,1839,-280,A00,1,Resign,Black
TRUE,36,5+20,1570,1578,-8,B40,8,Mate,Black
TRUE,50,15+0,1640,1556,84,B01,4,Resign,Black
TRUE,26,10+5,1600,1542,58,B01,4,Resign,Black
TRUE,17,8+5,1728,1549,179,B01,4,Mate,White
TRUE,42,15+0,1643,1558,85,E00,4,Resign,White
TRUE,119,10+0,1822,1562,260,A45,2,Resign,White
TRUE,64,10+0,1569,1710,-141,A06,3,Resign,Black
TRUE,94,10+0,1579,1557,22,B72,11,Out of Time,Black
TRUE,46,5+8,1706,1540,166,B01,4,Resign,Black
TRUE,24,15+10,1543,1858,-315,C40,4,Resign,Black
TRUE,101,5+8,1805,1548,257,B50,4,Resign,White
FALSE,88,10+0,1500,1769,-269,C20,3,Mate,Black
FALSE,78,10+0,1413,1500,-87,B53,7,Out of Time,Black
FALSE,31,20+0,1500,1500,0,C44,4,Resign,White
FALSE,2,8+0,1500,1784,-284,C00,2,Resign,White
FALSE,72,30+0,1706,1500,206,D07,7,Resign,White
FALSE,70,30+3,1347,1500,-153,A27,5,Mate,Black
TRUE,30,15+5,1644,1810,-166,B25,4,Resign,Black
FALSE,87,10+0,939,963,-24,B02,4,Mate,White
FALSE,66,7+2,1458,939,519,A06,2,Resign,White
TRUE,59,10+0,1449,940,509,C24,4,Resign,White
TRUE,80,10+0,949,1064,-115,A15,4,Resign,Black
TRUE,66,10+0,961,974,-13,A00,1,Mate,Black
TRUE,89,10+0,963,975,-12,C20,3,Resign,White
TRUE,5,10+0,1046,986,60,C27,3,Out of Time,White
TRUE,52,5+8,1500,1482,18,A00,1,Mate,Black
TRUE,46,30+0,1306,1275,31,B10,2,Resign,White
TRUE,35,30+0,1259,1319,-60,C42,4,Mate,White
TRUE,40,15+5,1272,1169,103,B10,2,Out of Time,Black
TRUE,8,10+0,1278,1500,-222,B00,2,Resign,Black
TRUE,53,10+0,1265,1500,-235,B00,4,Resign,White
FALSE,120,10+5,1265,1500,-235,C41,4,Resign,Black
FALSE,73,15+0,1265,1500,-235,C40,4,Resign,Black
TRUE,22,30+0,1264,1268,-4,C40,4,Draw,Draw
TRUE,66,10+0,1278,1280,-2,B02,4,Out of Time,Black
TRUE,85,12+10,1282,1293,-11,B10,5,Resign,White
TRUE,30,10+5,1500,1279,221,B00,3,Mate,Black
TRUE,49,20+15,1271,1096,175,C68,7,Mate,White
TRUE,70,180+0,964,1267,-303,B00,3,Resign,Black
TRUE,19,20+3,1270,1179,91,A06,3,Draw,Draw
TRUE,80,10+0,1277,1490,-213,B29,5,Mate,Black
FALSE,5,10+10,1370,1422,-52,C40,4,Resign,White
FALSE,41,10+10,1370,1176,194,B20,3,Resign,White
TRUE,53,10+10,1366,1402,-36,B00,2,Mate,White
TRUE,30,10+10,1442,1310,132,A00,1,Mate,Black
TRUE,153,5+8,1495,1283,212,C00,3,Resign,Black
TRUE,86,5+8,1387,1507,-120,B02,4,Draw,Draw
FALSE,2,5+30,1264,1507,-243,B07,2,Resign,Black
TRUE,81,15+15,1554,1546,8,A40,2,Resign,White
TRUE,56,10+0,1586,1632,-46,C20,3,Mate,Black
TRUE,42,10+5,2103,2198,-95,A06,2,Resign,Black
TRUE,35,10+5,2188,2173,15,A40,2,Resign,White
TRUE,132,10+0,2066,2180,-114,A00,5,Out of Time,Black
TRUE,42,10+5,2180,2186,-6,A46,4,Draw,Draw
TRUE,178,10+5,2190,2234,-44,D02,5,Mate,Black
TRUE,130,10+5,2201,2173,28,A46,4,Mate,Black
TRUE,91,10+5,2104,2215,-111,A58,17,Mate,White
TRUE,56,15+5,2226,2219,7,D02,5,Out of Time,Black
TRUE,61,10+5,2330,2234,96,D03,10,Mate,White
TRUE,67,10+5,2121,2234,-113,B74,17,Mate,White
TRUE,79,5+5,2218,1953,265,D02,5,Resign,White
TRUE,190,10+5,2151,2209,-58,B50,5,Mate,Black
TRUE,116,10+5,2221,2209,12,D02,5,Resign,Black
TRUE,79,10+5,2194,2232,-38,B72,11,Mate,White
TRUE,35,10+5,2221,2222,-1,A40,2,Mate,White
TRUE,59,10+0,2230,1666,564,B08,8,Resign,White
TRUE,83,10+5,2276,2230,46,A46,4,Mate,White
TRUE,74,10+0,2230,2201,29,D02,5,Mate,Black
TRUE,65,5+5,2226,1977,249,D02,5,Resign,White
TRUE,67,10+5,2218,2133,85,A40,2,Out of Time,White
TRUE,114,10+5,2225,2207,18,B50,5,Mate,Black
TRUE,51,10+5,2199,2112,87,D02,5,Resign,White
TRUE,100,10+5,2199,2179,20,D02,5,Draw,Draw
TRUE,76,10+5,2179,2189,-10,A56,4,Out of Time,Black
TRUE,132,10+0,1502,1530,-28,C60,5,Mate,Black
TRUE,29,10+0,1368,1496,-128,D01,4,Resign,Black
TRUE,115,10+0,1488,1437,51,C00,3,Out of Time,White
TRUE,109,10+0,1470,1499,-29,C41,5,Mate,White
TRUE,86,10+0,1513,1384,129,C41,5,Mate,Black
TRUE,57,10+0,1514,1523,-9,C34,6,Mate,White
TRUE,64,10+0,1534,1528,6,C60,6,Mate,Black
TRUE,89,10+0,1523,1538,-15,B20,3,Resign,White
TRUE,122,10+0,1550,1511,39,C41,4,Resign,Black
TRUE,20,15+1,810,1218,-408,B07,4,Out of Time,Black
TRUE,33,15+1,1209,831,378,D00,3,Mate,White
TRUE,38,15+1,1210,2026,-816,D00,3,Mate,Black
TRUE,96,15+1,1211,2025,-814,D04,6,Mate,Black
TRUE,137,16+1,1586,1236,350,C30,4,Mate,White
TRUE,44,1+10,1255,1815,-560,A40,2,Resign,Black
TRUE,81,1+10,1179,1610,-431,D02,4,Resign,White
TRUE,22,25+0,1188,1716,-528,C46,6,Mate,Black
TRUE,11,5+8,1718,1215,503,C20,3,Mate,White
TRUE,17,15+10,1733,1226,507,C20,4,Mate,White
TRUE,35,8+3,1483,1275,208,C40,3,Mate,White
TRUE,43,15+0,1378,1430,-52,B01,6,Mate,White
TRUE,14,15+0,1387,1621,-234,C45,10,Resign,Black
TRUE,12,15+0,1421,1278,143,C00,3,Resign,Black
TRUE,143,15+0,1391,1448,-57,C41,5,Resign,White
TRUE,52,15+0,1461,1357,104,C61,6,Mate,Black
TRUE,14,15+0,1476,1316,160,C61,6,Resign,Black
TRUE,13,15+0,1180,1358,-178,C45,7,Mate,White
TRUE,30,15+0,1394,1358,36,C42,5,Resign,Black
TRUE,61,15+0,1638,1408,230,C46,5,Resign,White
TRUE,52,15+0,1439,1493,-54,B01,4,Mate,Black
TRUE,15,15+0,1483,1478,5,D00,5,Resign,White
TRUE,44,5+6,1447,1581,-134,B20,3,Resign,White
TRUE,47,10+0,1498,1677,-179,C45,7,Mate,White
TRUE,34,5+8,1561,1574,-13,B07,3,Resign,Black
TRUE,42,5+8,1500,1507,-7,D00,5,Mate,Black
TRUE,86,5+8,1624,1504,120,C41,4,Resign,Black
FALSE,33,10+0,1430,1492,-62,B20,3,Mate,White
TRUE,74,6+4,1524,1269,255,B20,3,Resign,Black
TRUE,23,5+5,1500,1401,99,B10,2,Resign,Black
FALSE,87,15+0,1500,1508,-8,A40,2,Resign,White
FALSE,32,15+0,1508,1500,8,E10,6,Mate,Black
FALSE,16,10+0,1508,2016,-508,A40,1,Resign,Black
FALSE,59,180+0,1508,1500,8,C40,4,Resign,White
FALSE,24,15+0,1508,1727,-219,C02,7,Resign,Black
FALSE,67,60+3,1500,1508,-8,C24,4,Mate,White
FALSE,93,5+7,1508,1403,105,A40,2,Out of Time,White
FALSE,104,5+8,1500,1581,-81,D00,3,Mate,Black
TRUE,102,25+0,1238,1500,-262,B02,2,Mate,Black
FALSE,10,10+6,1500,1693,-193,A21,3,Mate,Black
FALSE,37,10+6,1693,1500,193,D00,3,Mate,White
FALSE,60,10+6,1500,1693,-193,D02,3,Resign,Black
FALSE,20,10+6,1622,1500,122,C40,4,Resign,Black
TRUE,13,15+20,1160,1323,-163,B00,2,Mate,White
TRUE,6,15+20,1418,1588,-170,A00,1,Mate,Black
TRUE,43,5+5,1930,1500,430,B00,2,Mate,White
FALSE,2,10+0,1761,1579,182,B20,2,Out of Time,Black
TRUE,79,15+5,1745,1853,-108,B01,6,Resign,White
TRUE,98,15+5,1750,1733,17,B57,8,Mate,Black
FALSE,31,15+5,1733,1624,109,B20,3,Resign,White
TRUE,101,15+5,2108,1736,372,D31,5,Resign,White
TRUE,40,15+5,2105,1738,367,D53,8,Resign,White
TRUE,46,15+5,2101,1741,360,D32,9,Resign,White
TRUE,24,10+5,1852,1748,104,E32,7,Resign,White
TRUE,60,10+5,1759,1500,259,C42,9,Mate,Black
TRUE,51,10+0,1749,1716,33,C53,7,Resign,White
TRUE,112,15+5,1763,1661,102,C54,13,Mate,Black
TRUE,77,10+0,1809,1700,109,B20,2,Mate,White
TRUE,42,10+0,1801,1686,115,D20,5,Resign,Black
TRUE,65,5+8,1711,1713,-2,C68,8,Resign,White
TRUE,137,15+10,1712,1751,-39,C01,5,Draw,Draw
TRUE,52,15+10,1764,1711,53,D20,5,Mate,Black
TRUE,85,5+5,1737,1745,-8,C62,6,Out of Time,White
TRUE,35,5+5,1734,1748,-14,B30,5,Resign,White
TRUE,80,10+0,1696,1725,-29,C24,4,Out of Time,Black
TRUE,105,5+7,1712,1770,-58,D03,5,Resign,White
TRUE,90,7+14,1734,1701,33,C20,3,Resign,Black
TRUE,149,5+5,1796,1709,87,A03,2,Out of Time,White
TRUE,96,15+0,1720,1697,23,C53,7,Out of Time,Black
TRUE,38,8+0,1704,1852,-148,D02,3,Resign,Black
TRUE,84,8+0,1718,1587,131,D02,4,Out of Time,Black
TRUE,41,8+5,1779,1727,52,C34,5,Resign,White
TRUE,62,10+5,1737,1775,-38,B31,6,Out of Time,Black
TRUE,53,7+8,1888,1744,144,C62,6,Out of Time,White
TRUE,27,3+15,1852,1761,91,C50,6,Mate,White
TRUE,78,10+5,1772,1770,2,B30,5,Resign,Black
TRUE,47,8+2,1799,1782,17,C34,6,Resign,White
TRUE,33,10+10,1820,1792,28,C42,5,Resign,White
TRUE,103,5+10,1734,1805,-71,C50,6,Resign,White
TRUE,46,10+0,1696,1797,-101,C62,6,Out of Time,Black
TRUE,79,1+30,1695,1789,-94,D00,3,Resign,Black
TRUE,73,10+8,1780,1722,58,A41,4,Mate,White
FALSE,37,5+8,1914,1780,134,C21,10,Resign,White
FALSE,23,5+5,1786,1966,-180,B01,4,Resign,White
TRUE,41,8+0,1882,1806,76,A00,1,Resign,White
TRUE,29,8+0,1792,1898,-106,A04,2,Resign,White
TRUE,50,10+10,1760,1782,-22,D00,3,Resign,Black
FALSE,85,8+0,1818,1793,25,A04,2,Out of Time,White
TRUE,29,5+15,1785,2054,-269,C01,5,Resign,White
TRUE,39,10+0,1215,1511,-296,C00,3,Mate,White
TRUE,39,10+0,1687,1218,469,D00,3,Mate,White
TRUE,35,2+15,1316,1237,79,C20,4,Mate,White
TRUE,32,2+15,1261,1279,-18,C40,3,Mate,Black
TRUE,21,2+15,1228,1292,-64,C20,3,Mate,White
FALSE,13,180+0,1255,1151,104,A00,2,Out of Time,White
TRUE,79,10+8,1391,1161,230,E70,7,Resign,White
TRUE,43,10+15,1142,1066,76,A00,1,Resign,White
TRUE,40,15+5,1162,1242,-80,A00,1,Resign,Black
TRUE,78,15+0,1204,1187,17,B06,2,Resign,White
TRUE,29,6+3,1229,1215,14,B06,2,Resign,White
FALSE,12,5+30,1336,1190,146,A40,2,Resign,Black
TRUE,47,15+0,1150,1223,-73,A00,1,Mate,White
FALSE,40,20+10,1450,1150,300,A40,2,Resign,White
TRUE,85,60+60,1425,1164,261,B06,4,Resign,White
TRUE,46,180+0,1452,1108,344,B06,4,Resign,Black
FALSE,65,180+0,1255,1108,147,A00,2,Out of Time,White
FALSE,17,180+0,1108,1255,-147,A00,3,Draw,Draw
FALSE,73,180+0,1255,1108,147,A05,10,Draw,Draw
FALSE,91,180+0,1255,1108,147,A00,1,Out of Time,White
FALSE,88,180+0,1108,1255,-147,D00,3,Draw,Draw
FALSE,64,180+0,1255,1108,147,D26,10,Resign,Black
TRUE,90,5+8,1142,1431,-289,C01,4,Mate,Black
TRUE,57,3+10,1107,1022,85,A45,5,Mate,White
FALSE,32,180+0,1107,1352,-245,C20,3,Out of Time,Black
TRUE,45,10+0,1581,1513,68,A01,2,Mate,White
TRUE,69,10+0,1505,1393,112,A30,2,Resign,White
TRUE,25,10+0,1493,1517,-24,B20,3,Resign,White
TRUE,50,10+0,1494,1506,-12,A30,2,Resign,Black
TRUE,75,10+0,1497,1494,3,A13,2,Resign,White
TRUE,90,10+0,1572,1484,88,D02,4,Resign,Black
TRUE,14,10+0,1492,1563,-71,A22,5,Resign,Black
TRUE,37,10+0,1511,1502,9,B30,4,Resign,White
TRUE,52,10+0,1513,1527,-14,A17,4,Resign,Black
TRUE,52,10+0,1478,1503,-25,D02,4,Mate,Black
TRUE,54,10+0,1513,1541,-28,A10,2,Resign,Black
TRUE,22,10+0,1322,1507,-185,B21,3,Mate,Black
TRUE,31,10+0,1504,1509,-5,B20,3,Resign,White
TRUE,85,10+0,1502,1500,2,A21,3,Mate,White
TRUE,64,10+0,1491,1505,-14,A10,2,Resign,White
TRUE,9,10+0,1512,1490,22,B22,3,Mate,White
TRUE,40,10+0,1502,1469,33,A13,2,Resign,Black
TRUE,132,10+0,1497,1491,6,B20,3,Resign,Black
TRUE,42,10+0,1430,1482,-52,B20,3,Mate,Black
TRUE,50,10+0,1465,1493,-28,B31,6,Resign,White
TRUE,37,10+0,1476,1432,44,A20,2,Resign,White
TRUE,117,10+0,1501,1486,15,B20,3,Resign,White
TRUE,70,10+0,1531,1473,58,A00,1,Out of Time,Black
TRUE,14,10+0,1483,1521,-38,A36,5,Resign,Black
TRUE,59,10+0,1491,1493,-2,B23,3,Resign,White
TRUE,39,10+0,1480,1592,-112,A20,2,Resign,White
TRUE,26,10+0,1479,1514,-35,A13,2,Resign,Black
TRUE,58,10+0,1468,1468,0,B34,9,Resign,Black
TRUE,104,10+0,1479,1462,17,A20,2,Mate,Black
TRUE,63,10+0,1624,1486,138,B34,9,Mate,White
TRUE,97,10+0,1476,1469,7,A20,2,Mate,White
TRUE,51,10+0,1467,1404,63,A10,2,Resign,White
TRUE,63,10+0,1479,1427,52,A22,6,Resign,Black
TRUE,33,10+0,1489,1478,11,B20,3,Resign,White
TRUE,79,10+0,1467,1468,-1,A22,6,Resign,White
TRUE,33,10+0,1578,1475,103,B34,9,Resign,White
TRUE,11,10+0,1466,1395,71,A10,2,Resign,White
TRUE,21,10+0,1532,1475,57,B30,4,Resign,White
TRUE,17,10+0,1462,1545,-83,A10,2,Resign,White
TRUE,26,10+0,1536,1471,65,B20,3,Resign,White
TRUE,29,10+0,1457,1550,-93,A10,2,Mate,White
TRUE,61,10+0,1422,1469,-47,B20,2,Resign,White
TRUE,39,10+0,1481,1436,45,A21,3,Resign,Black
TRUE,59,10+0,1477,1492,-15,A43,3,Resign,White
FALSE,27,10+15,1500,1407,93,B00,2,Mate,White
FALSE,34,10+15,1407,1500,-93,A00,1,Mate,Black
FALSE,17,10+0,1500,1407,93,B00,2,Mate,White
FALSE,5,20+0,1937,1407,530,A40,1,Resign,White
TRUE,47,8+0,2141,1414,727,B07,3,Mate,White
TRUE,18,5+5,1500,1742,-242,A00,2,Mate,Black
FALSE,9,12+0,1342,1221,121,C50,7,Resign,White
TRUE,44,15+10,1254,1204,50,C48,8,Mate,Black
TRUE,53,15+10,1184,1269,-85,C46,7,Mate,White
TRUE,26,10+0,1203,1140,63,C41,4,Resign,Black
TRUE,7,5+8,1329,1215,114,C20,3,Resign,White
TRUE,4,8+8,1325,1227,98,C44,4,Resign,White
FALSE,45,8+0,1500,1227,273,A03,2,Resign,White
TRUE,17,10+0,1233,1532,-299,C40,3,Resign,Black
TRUE,57,13+3,1567,1238,329,C50,6,Resign,White
TRUE,85,15+3,1681,1216,465,D02,5,Mate,White
TRUE,171,15+3,1189,1373,-184,C40,4,Mate,White
TRUE,28,15+0,1162,1319,-157,B00,3,Resign,White
TRUE,78,10+15,1446,1133,313,C21,5,Mate,Black
FALSE,1,5+15,2404,1616,788,B00,1,Out of Time,White
FALSE,91,10+5,1616,1657,-41,B00,2,Resign,White
TRUE,70,10+0,1499,1449,50,D00,5,Resign,Black
TRUE,48,20+0,1405,1365,40,C20,3,Resign,Black
TRUE,7,8+0,1302,1351,-49,B20,3,Resign,White
TRUE,30,20+3,989,1658,-669,C45,8,Resign,Black
TRUE,52,20+3,989,1658,-669,C20,3,Mate,Black
TRUE,2,10+10,1610,989,621,A40,2,Resign,Black
TRUE,3,10+10,989,1610,-621,B01,2,Resign,White
TRUE,3,15+10,1538,991,547,C40,3,Resign,White
TRUE,20,15+0,1003,1246,-243,C20,3,Resign,Black
TRUE,7,5+5,958,1274,-316,C20,3,Mate,White
FALSE,41,60+0,1500,963,537,A00,1,Mate,White
FALSE,36,60+0,963,1500,-537,B07,3,Resign,Black
TRUE,62,15+15,978,1179,-201,B08,8,Mate,Black
TRUE,71,15+15,1172,996,176,D00,3,Mate,White
TRUE,44,15+15,1032,1011,21,A00,1,Mate,Black
TRUE,33,15+15,1142,1061,81,A00,1,Mate,White
FALSE,29,10+0,1424,1061,363,B00,4,Mate,White
TRUE,64,45+4,1691,1451,240,B21,3,Draw,Draw
TRUE,89,5+8,1471,1461,10,B20,3,Mate,White
TRUE,57,10+10,1440,1451,-11,B20,3,Resign,Black
TRUE,113,10+10,1450,1468,-18,C00,3,Draw,Draw
TRUE,34,10+10,1455,1679,-224,C41,8,Mate,Black
TRUE,99,10+10,1454,1489,-35,C46,5,Draw,Draw
TRUE,32,10+10,1508,1440,68,B21,3,Resign,Black
TRUE,33,10+10,1425,1576,-151,C01,5,Resign,White
TRUE,103,10+10,1580,1420,160,D02,4,Draw,Draw
TRUE,111,10+10,1418,1480,-62,B00,2,Draw,Draw
TRUE,18,10+10,1545,1402,143,A20,2,Resign,Black
TRUE,67,10+10,1392,1332,60,B94,11,Resign,White
TRUE,81,10+10,1382,1388,-6,C47,8,Mate,White
TRUE,57,10+10,1347,1395,-48,B23,3,Mate,White
FALSE,99,10+10,1395,1367,28,C44,5,Mate,White
TRUE,102,15+15,1418,1472,-54,B00,4,Mate,Black
TRUE,40,15+15,1423,1645,-222,B21,3,Resign,Black
FALSE,38,15+15,1500,1423,77,A40,1,Resign,White
TRUE,20,20+30,1457,1418,39,B52,6,Resign,Black
TRUE,112,15+0,1421,1754,-333,C45,7,Mate,Black
TRUE,91,45+5,1464,1432,32,C20,4,Resign,White
TRUE,37,15+15,1363,1447,-84,A40,1,Mate,White
TRUE,115,45+0,1653,1453,200,A40,1,Mate,White
TRUE,47,20+10,1710,1460,250,D10,5,Mate,White
TRUE,46,20+10,1465,1706,-241,C42,7,Mate,Black
TRUE,31,20+10,1701,1470,231,D02,4,Resign,White
TRUE,53,20+30,1554,1479,75,A40,1,Resign,White
TRUE,20,20+30,1488,1591,-103,C48,8,Mate,Black
TRUE,167,20+30,1579,1497,82,B11,6,Mate,White
TRUE,63,20+30,1482,1537,-55,B20,2,Resign,White
TRUE,70,20+30,1528,1468,60,B12,7,Mate,Black
TRUE,77,20+30,1467,1501,-34,C41,4,Draw,Draw
TRUE,41,20+30,1559,1472,87,D11,5,Draw,Draw
TRUE,112,20+30,1549,1456,93,A11,2,Resign,Black
TRUE,68,30+0,1436,1434,2,A40,1,Mate,Black
TRUE,59,60+0,1858,1436,422,B11,8,Resign,White
TRUE,96,20+30,1431,1585,-154,C45,8,Draw,Draw
TRUE,80,20+30,1443,1471,-28,C44,5,Mate,Black
TRUE,67,10+0,1661,1132,529,C40,4,Mate,White
TRUE,36,10+0,1073,1135,-62,A00,1,Mate,Black
TRUE,91,10+0,1551,1142,409,C20,3,Mate,White
TRUE,16,5+10,1155,1483,-328,C42,5,Mate,Black
TRUE,24,10+10,1780,1157,623,C42,5,Resign,White
TRUE,8,10+0,1157,2312,-1155,B20,3,Resign,Black
TRUE,18,10+0,1164,1616,-452,C23,3,Resign,Black
TRUE,103,10+0,1563,1173,390,E00,4,Mate,White
TRUE,10,10+0,1805,1176,629,A40,2,Resign,White
TRUE,76,10+0,1209,1320,-111,C23,3,Mate,Black
TRUE,106,8+10,1215,1703,-488,C20,4,Mate,Black
TRUE,26,6+3,1515,1127,388,E00,4,Mate,Black
TRUE,13,6+3,1002,1534,-532,C23,3,Mate,White
TRUE,54,10+0,1009,1513,-504,B02,3,Resign,Black
TRUE,67,10+0,1511,1017,494,C00,3,Mate,White
TRUE,12,10+0,1027,1509,-482,B02,3,Resign,Black
TRUE,57,10+180,1264,1064,200,C00,3,Resign,White
TRUE,60,20+5,1072,1625,-553,A00,1,Mate,Black
TRUE,16,90+0,1073,1939,-866,C20,3,Mate,Black
TRUE,39,15+0,1793,1076,717,C01,5,Resign,White
TRUE,9,5+10,1374,1115,259,C00,4,Out of Time,White
TRUE,38,5+10,1539,1136,403,C02,5,Resign,White
TRUE,34,6+10,1149,1677,-528,A00,1,Resign,Black
TRUE,41,10+3,1535,1182,353,C00,3,Out of Time,White
FALSE,26,180+0,1500,1182,318,C00,2,Resign,Black
TRUE,57,5+10,856,1541,-685,A00,1,Mate,White
TRUE,52,10+0,1435,2042,-607,D04,5,Out of Time,Black
TRUE,31,10+0,1828,1500,328,C41,7,Mate,White
TRUE,12,15+0,1353,1207,146,B06,5,Resign,Black
TRUE,35,15+2,1347,1013,334,A40,2,Mate,White
TRUE,73,15+8,1334,1183,151,A40,1,Out of Time,White
TRUE,86,10+0,1079,1325,-246,B01,2,Mate,Black
TRUE,11,15+0,1314,1099,215,D00,3,Resign,White
TRUE,2,5+6,1052,1304,-252,D00,2,Resign,Black
FALSE,10,10+5,1100,1393,-293,D01,5,Out of Time,Black
FALSE,81,10+5,1393,1100,293,B12,5,Resign,White
FALSE,15,10+5,1100,1393,-293,A43,3,Resign,Black
TRUE,12,10+5,1027,1084,-57,B01,4,Resign,Black
TRUE,55,10+5,1065,1073,-8,D00,5,Resign,White
TRUE,81,10+5,1085,1082,3,D00,3,Mate,White
TRUE,50,10+5,1104,1057,47,B12,5,Mate,Black
TRUE,46,10+5,1130,1019,111,C00,4,Out of Time,Black
TRUE,21,10+5,1125,1153,-28,B01,2,Resign,White
TRUE,27,10+5,1152,1159,-7,C21,3,Resign,White
TRUE,2,10+5,1112,1283,-171,B01,2,Resign,White
TRUE,54,10+0,1141,1098,43,C20,3,Mate,Black
TRUE,35,10+0,1080,1177,-97,B01,2,Mate,White
TRUE,23,10+0,1152,1206,-54,A00,1,Resign,White
TRUE,20,10+0,1145,1174,-29,B01,2,Resign,Black
TRUE,10,10+0,1205,1199,6,B02,4,Resign,Black
TRUE,12,10+0,1216,1093,123,C00,4,Draw,Draw
TRUE,4,10+0,1141,1175,-34,B01,2,Resign,Black
TRUE,44,10+0,1018,1142,-124,B01,2,Mate,Black
TRUE,22,10+0,1208,1140,68,C22,6,Out of Time,Black
TRUE,86,10+0,1195,1123,72,C40,4,Mate,Black
TRUE,50,10+0,1221,1168,53,D00,5,Mate,Black
TRUE,108,10+0,1054,1384,-330,C23,4,Mate,Black
TRUE,41,15+15,1703,1484,219,C01,5,Out of Time,White
TRUE,16,15+15,1455,1427,28,C02,5,Resign,White
TRUE,21,15+15,1433,1306,127,C80,11,Resign,White
TRUE,30,15+10,1469,1476,-7,B01,4,Out of Time,Black
TRUE,109,7+2,1785,1481,304,C00,3,Resign,White
TRUE,54,7+2,1315,1455,-140,C02,7,Resign,Black
TRUE,96,7+2,1466,1815,-349,B90,10,Resign,Black
TRUE,255,7+2,1585,1448,137,C00,3,Draw,Draw
FALSE,68,20+0,1907,1448,459,A28,7,Draw,Draw
TRUE,39,15+5,1291,1451,-160,C02,7,Draw,Draw
TRUE,104,7+2,1278,1406,-128,C00,4,Mate,Black
TRUE,54,7+2,1515,1404,111,C02,5,Out of Time,Black
TRUE,75,7+2,1473,1221,252,C84,10,Mate,White
TRUE,67,7+2,1610,1599,11,C00,3,Out of Time,White
FALSE,68,20+0,1907,1599,308,A28,7,Out of Time,Black
TRUE,88,15+5,1299,1500,-201,C02,7,Mate,Black
TRUE,54,120+0,1430,1500,-70,B00,3,Mate,Black
TRUE,56,10+3,1576,1500,76,B00,3,Resign,Black
FALSE,39,5+8,1901,1500,401,C20,3,Mate,White
TRUE,121,9+2,1093,1119,-26,C41,4,Mate,White
TRUE,44,10+5,1117,898,219,C41,6,Mate,Black
TRUE,27,30+7,1169,1133,36,B00,5,Out of Time,White
TRUE,35,10+5,1106,1273,-167,C60,6,Mate,White
TRUE,45,15+1,1251,1119,132,C68,8,Mate,White
TRUE,20,15+0,1128,1347,-219,C41,4,Resign,Black
TRUE,78,10+3,1146,1355,-209,C44,5,Mate,Black
TRUE,56,10+3,1254,1116,138,C44,4,Mate,Black
TRUE,141,10+3,1228,1133,95,D00,3,Mate,White
TRUE,61,10+0,1705,1135,570,C50,5,Out of Time,White
TRUE,64,10+0,1158,1306,-148,B00,3,Mate,Black
TRUE,19,10+0,1759,1163,596,C50,5,Mate,White
TRUE,26,10+0,1167,1627,-460,C61,6,Mate,Black
TRUE,51,10+0,2023,1168,855,A20,2,Mate,White
TRUE,115,7+2,1426,1178,248,C01,5,Out of Time,White
TRUE,100,7+2,1200,1252,-52,C91,17,Mate,Black
TRUE,75,7+2,1427,1213,214,C68,7,Mate,White
TRUE,64,7+2,1303,1175,128,C84,10,Mate,Black
TRUE,14,15+0,1155,1424,-269,C11,6,Draw,Draw
FALSE,36,20+0,1155,1907,-752,C88,15,Mate,Black
TRUE,85,7+2,1170,1302,-132,C92,18,Draw,Draw
TRUE,64,7+2,1173,1718,-545,C00,4,Mate,Black
TRUE,77,7+2,1278,1204,74,C70,10,Out of Time,White
TRUE,75,7+2,1473,1221,252,C84,10,Mate,White
TRUE,74,7+2,1264,1288,-24,C91,17,Mate,Black
FALSE,70,20+0,1907,1264,643,A40,2,Out of Time,Black
TRUE,38,15+5,1420,1239,181,C50,5,Draw,Draw
TRUE,40,15+5,1277,1409,-132,C11,6,Mate,Black
TRUE,31,20+10,1804,1284,520,C50,5,Out of Time,White
TRUE,56,14+4,1406,1404,2,B21,3,Mate,Black
TRUE,47,15+5,1231,1516,-285,B01,4,Mate,White
TRUE,33,15+5,1466,1303,163,C68,7,Resign,White
TRUE,32,15+5,1500,1458,42,C42,4,Resign,Black
TRUE,23,30+5,1127,1234,-107,A22,4,Mate,White
TRUE,77,30+5,1242,1162,80,B06,2,Resign,White
TRUE,17,30+5,1104,1168,-64,A28,7,Resign,White
TRUE,128,30+5,1138,1276,-138,A21,3,Mate,Black
TRUE,32,30+5,1186,1283,-97,A27,5,Resign,Black
TRUE,48,30+5,1256,1301,-45,A27,5,Resign,Black
TRUE,26,30+5,1102,1301,-199,A30,2,Resign,White
TRUE,46,20+5,1205,1279,-74,A20,4,Resign,Black
FALSE,12,10+0,1311,1205,106,A01,3,Resign,White
TRUE,32,15+5,1500,1311,189,C40,4,Resign,Black
TRUE,124,30+30,1676,2003,-327,D10,5,Resign,Black
TRUE,17,30+30,2001,1571,430,C44,7,Resign,White
FALSE,94,10+0,1629,2001,-372,B01,2,Resign,Black
FALSE,23,10+3,1582,1079,503,C50,5,Resign,White
FALSE,51,10+3,1582,1079,503,C53,9,Mate,White
FALSE,38,5+5,1079,1582,-503,D02,4,Out of Time,Black
FALSE,85,5+5,1582,1410,172,A00,1,Mate,White
FALSE,114,5+5,1410,1582,-172,A45,2,Mate,Black
FALSE,70,5+5,1500,1582,-82,A45,2,Out of Time,Black
FALSE,85,5+5,1582,1500,82,B02,5,Mate,White
FALSE,62,5+5,1500,1582,-82,C20,3,Mate,Black
FALSE,53,5+5,1582,1500,82,D07,6,Mate,White
FALSE,60,5+5,1143,1591,-448,C00,2,Mate,Black
FALSE,41,5+5,1591,1143,448,A50,7,Mate,White
FALSE,20,5+5,1143,1591,-448,C24,4,Resign,Black
FALSE,14,5+6,1143,1591,-448,A06,3,Resign,Black
FALSE,51,5+6,1591,1143,448,C34,6,Mate,White
FALSE,39,5+6,1591,1143,448,A00,5,Mate,White
TRUE,70,8+0,924,1097,-173,B07,4,Out of Time,Black
TRUE,9,17+3,918,996,-78,C44,5,Resign,White
TRUE,15,15+0,1146,1048,98,C20,4,Resign,White
TRUE,80,15+0,1077,1359,-282,C40,4,Out of Time,Black
TRUE,39,20+1,1196,1162,34,C50,8,Mate,White
TRUE,66,10+1,1362,1157,205,B01,2,Mate,Black
FALSE,81,15+5,989,1362,-373,C68,7,Resign,White
FALSE,69,15+0,1033,1362,-329,B02,2,Mate,White
FALSE,28,10+15,1362,1500,-138,B00,2,Mate,Black
TRUE,46,7+8,1500,1584,-84,D10,4,Out of Time,Black
TRUE,113,10+0,1847,1541,306,A43,3,Out of Time,Draw
TRUE,46,10+0,1555,1844,-289,C45,7,Mate,Black
TRUE,114,10+0,1856,1819,37,D02,4,Mate,Black
TRUE,59,10+0,1681,1874,-193,A40,2,Resign,White
TRUE,93,10+0,1868,1663,205,D30,7,Mate,White
TRUE,68,10+0,1741,1860,-119,C57,11,Mate,Black
TRUE,84,10+0,1881,1518,363,A56,6,Resign,Black
TRUE,71,10+0,1573,1877,-304,C20,3,Resign,Black
TRUE,61,10+0,1871,1704,167,E90,9,Resign,White
TRUE,93,10+0,1858,1920,-62,E30,7,Mate,White
TRUE,49,10+0,1846,1834,12,A40,2,Resign,White
TRUE,40,10+0,1836,1832,4,D00,3,Resign,Black
TRUE,168,10+0,1841,1914,-73,D80,6,Resign,Black
TRUE,61,10+0,1826,1965,-139,D30,4,Resign,White
TRUE,28,10+0,1626,1820,-194,C00,2,Resign,Black
TRUE,53,10+0,1818,1368,450,E90,9,Mate,White
TRUE,61,10+0,1901,1827,74,C00,3,Resign,White
TRUE,83,10+0,1791,1803,-12,C00,3,Resign,White
TRUE,71,10+0,1792,1788,4,D50,7,Resign,White
TRUE,77,10+0,1780,1808,-28,D20,5,Resign,White
TRUE,97,10+0,1456,1789,-333,C00,3,Draw,Draw
TRUE,156,10+0,1802,1740,62,B12,6,Out of Time,Black
TRUE,69,10+0,2031,1807,224,D02,4,Mate,White
TRUE,77,10+0,2182,1809,373,C01,5,Resign,White
TRUE,65,10+0,2062,1814,248,A40,2,Resign,White
TRUE,76,10+0,1828,1697,131,D02,3,Mate,Black
TRUE,29,10+0,1821,1699,122,E90,9,Resign,White
TRUE,66,10+0,1915,1807,108,A03,2,Mate,Black
TRUE,91,10+0,1791,1929,-138,A85,5,Mate,White
TRUE,73,10+0,1922,1799,123,A02,1,Mate,White
TRUE,62,10+0,1810,1817,-7,D02,4,Mate,Black
TRUE,105,10+0,1822,1798,24,A00,1,Resign,Black
TRUE,75,10+0,1784,1871,-87,A20,2,Resign,White
TRUE,98,10+0,1788,2059,-271,D02,4,Resign,Black
TRUE,72,10+0,1461,1785,-324,D02,3,Resign,Black
TRUE,62,15+0,1094,1047,47,C55,6,Resign,Black
TRUE,54,15+8,1104,1280,-176,A01,4,Resign,Black
TRUE,66,7+8,1633,1106,527,A04,2,Resign,White
TRUE,37,15+4,1506,1109,397,A01,1,Resign,White
FALSE,29,10+0,1109,1227,-118,C00,3,Resign,Black
TRUE,55,15+5,1709,1117,592,C00,3,Resign,White
TRUE,48,10+0,1302,1116,186,A00,1,Draw,Draw
TRUE,73,10+0,1084,1370,-286,D10,4,Resign,White
TRUE,39,10+0,1732,1085,647,C00,3,Mate,White
FALSE,49,8+5,2022,1085,937,D02,4,Mate,White
TRUE,48,10+0,1086,1774,-688,D12,8,Mate,Black
TRUE,79,15+0,1651,1087,564,C29,6,Mate,White
TRUE,9,10+25,1319,1096,223,A00,1,Resign,White
TRUE,51,7+5,1683,1097,586,B00,4,Resign,White
TRUE,33,6+8,1080,1047,33,A40,2,Out of Time,White
TRUE,94,15+3,1092,1247,-155,C20,3,Resign,Black
TRUE,47,13+2,1707,1093,614,C02,5,Resign,White
TRUE,27,15+15,1425,1099,326,B00,4,Resign,White
TRUE,11,5+5,1121,1105,16,C20,3,Resign,Black
FALSE,70,10+0,1121,1501,-380,C20,3,Resign,Black
TRUE,60,20+0,1126,1483,-357,C00,3,Resign,Black
FALSE,27,15+0,1778,1126,652,C00,3,Resign,White
FALSE,50,15+0,1186,1126,60,A00,1,Draw,Draw
TRUE,73,10+0,1476,1131,345,C01,5,Resign,White
FALSE,21,10+5,1884,1131,753,C01,5,Resign,White
TRUE,39,10+10,1494,1137,357,C00,3,Resign,White
TRUE,45,7+7,2335,2262,73,B31,6,Mate,White
TRUE,110,7+7,2271,2322,-51,C64,9,Resign,Black
TRUE,45,7+7,2307,2280,27,B30,5,Resign,White
TRUE,40,7+7,2291,2290,1,D32,9,Resign,Black
TRUE,77,15+0,2269,2347,-78,C01,5,Resign,White
TRUE,47,14+0,2247,2323,-76,A04,2,Resign,White
TRUE,45,5+5,2235,2118,117,D46,12,Resign,White
TRUE,40,5+5,2126,2221,-95,C47,8,Resign,Black
TRUE,41,15+0,2202,2234,-32,B45,9,Resign,White
TRUE,48,8+3,2193,2181,12,A20,2,Resign,Black
TRUE,62,5+5,2204,2157,47,E16,10,Out of Time,Black
TRUE,46,5+5,2120,2135,-15,C05,6,Out of Time,Black
FALSE,31,25+0,2135,1151,984,A44,6,Mate,White
FALSE,38,25+0,1151,2135,-984,A00,1,Mate,Black
TRUE,34,8+0,1586,2133,-547,B03,7,Mate,Black
TRUE,22,8+8,1635,2131,-496,C00,3,Mate,Black
TRUE,92,18+0,1967,2116,-149,B18,11,Resign,Black
TRUE,65,10+0,2080,2278,-198,D53,10,Resign,White
TRUE,53,10+0,2070,1821,249,C10,5,Out of Time,White
TRUE,22,10+0,1791,2060,-269,B01,6,Resign,Black
TRUE,68,10+0,2043,2032,11,B01,8,Mate,Black
TRUE,57,10+0,2016,1839,177,B10,5,Out of Time,White
TRUE,52,10+0,1989,1945,44,C03,5,Resign,White
TRUE,49,10+0,1943,2091,-148,D85,13,Resign,White
TRUE,51,10+0,1909,1887,22,B15,10,Resign,White
TRUE,20,10+0,1729,1886,-157,A52,7,Resign,Black
TRUE,137,10+3,1627,1627,0,B00,4,Out of Time,White
TRUE,46,10+3,1657,1638,19,B30,4,Resign,Black
TRUE,39,10+3,1970,1666,304,B07,5,Resign,White
TRUE,76,10+3,1696,1629,67,A41,2,Out of Time,Black
TRUE,126,10+3,1669,1792,-123,B06,2,Resign,Black
TRUE,66,10+3,1714,1676,38,B01,4,Mate,Black
TRUE,106,10+3,1744,1440,304,C60,5,Draw,Draw
TRUE,112,10+3,1573,1715,-142,B07,4,Resign,Black
TRUE,46,10+3,1472,1691,-219,A41,2,Resign,Black
TRUE,134,10+3,1787,1533,254,B01,4,Mate,Black
TRUE,80,10+3,1550,1755,-205,A41,3,Out of Time,Black
TRUE,47,10+3,1757,1748,9,C57,10,Draw,Draw
TRUE,88,10+3,1840,1606,234,A41,2,Resign,Black
TRUE,45,10+3,1589,1444,145,B07,2,Resign,Black
TRUE,76,10+3,1545,1684,-139,C50,6,Out of Time,Black
TRUE,43,10+3,1500,1081,419,C42,6,Mate,White
TRUE,43,5+10,2422,2324,98,C45,11,Resign,White
TRUE,64,8+0,2458,2424,34,C81,17,Resign,Black
TRUE,39,15+0,2415,2331,84,C80,12,Resign,White
TRUE,50,5+5,2420,2404,16,A58,9,Resign,Black
TRUE,150,10+0,2513,2383,130,B07,2,Resign,Black
TRUE,96,10+0,2469,2369,100,B06,8,Out of Time,Black
TRUE,136,10+0,2220,2374,-154,B35,13,Draw,Draw
TRUE,71,10+0,2367,2234,133,E54,12,Resign,White
TRUE,86,10+0,2249,2359,-110,E53,12,Out of Time,Black
TRUE,55,10+0,2324,2349,-25,B25,4,Resign,Black
TRUE,28,10+0,2226,2342,-116,C16,7,Resign,Black
TRUE,83,10+0,2331,2336,-5,A57,7,Resign,White
TRUE,117,10+0,2203,2346,-143,C67,10,Resign,White
TRUE,95,10+0,2338,2272,66,E73,12,Out of Time,White
TRUE,98,10+0,2347,2394,-47,A40,2,Resign,Black
TRUE,120,8+0,2355,2449,-94,A16,7,Resign,Black
TRUE,107,10+0,1817,1798,19,C46,7,Out of Time,White
TRUE,154,30+0,1645,1737,-92,B30,4,Mate,Black
TRUE,48,15+4,1641,1726,-85,B20,3,Mate,Black
FALSE,38,10+0,1726,1653,73,A42,5,Resign,Black
FALSE,16,15+8,1592,1500,92,C00,3,Resign,White
TRUE,44,5+5,1587,1519,68,C22,6,Resign,Black
TRUE,36,10+5,1547,1801,-254,C64,6,Mate,Black
TRUE,59,20+0,1678,1618,60,C30,4,Resign,White
TRUE,20,10+4,1674,1862,-188,C68,10,Resign,Black
TRUE,3,12+0,1430,2173,-743,C40,3,Resign,White
FALSE,54,10+0,1430,1618,-188,B01,6,Draw,Draw
TRUE,42,20+0,1500,1810,-310,C62,6,Mate,Black
TRUE,21,30+5,1257,1042,215,B01,2,Resign,White
TRUE,46,7+5,971,1153,-182,C21,5,Resign,White
TRUE,23,5+8,1214,994,220,B01,4,Resign,White
TRUE,55,6+20,1748,996,752,D30,4,Mate,White
TRUE,63,10+0,1127,1193,-66,B01,2,Mate,White
FALSE,90,180+60,1193,1319,-126,C44,4,Mate,Black
TRUE,24,15+0,1244,1394,-150,C20,3,Mate,Black
TRUE,91,15+0,1386,1352,34,C20,3,Resign,White
TRUE,33,10+7,1559,1500,59,C30,5,Mate,White
TRUE,77,30+30,2131,2103,28,B32,10,Resign,White
TRUE,91,10+0,2095,1991,104,A20,2,Out of Time,White
TRUE,125,10+0,2088,1974,114,A20,2,Mate,White
TRUE,41,5+5,2247,2094,153,B20,6,Mate,White
TRUE,118,10+0,1453,1380,73,C46,5,Mate,Black
TRUE,49,10+0,1446,1317,129,C46,7,Mate,White
TRUE,64,10+0,1459,1392,67,C41,4,Resign,Black
TRUE,42,10+0,1434,1449,-15,C58,11,Mate,Black
FALSE,35,5+7,2621,1449,1172,C50,9,Mate,White
TRUE,67,90+30,1816,1409,407,B81,11,Resign,White
TRUE,63,90+30,1757,1500,257,B94,11,Resign,White
FALSE,71,60+30,1757,1500,257,A16,10,Resign,White
FALSE,26,5+5,1500,1901,-401,A22,4,Out of Time,Black
FALSE,19,5+5,1500,1161,339,A20,2,Out of Time,White
FALSE,1,5+5,1500,2723,-1223,B00,1,Out of Time,White
FALSE,42,5+5,1500,1937,-437,A15,4,Out of Time,Black
FALSE,32,5+5,1500,2021,-521,C89,28,Out of Time,Black
FALSE,24,5+5,1500,1477,23,A21,3,Out of Time,Black
FALSE,53,20+60,1500,1442,58,A30,2,Resign,White
FALSE,89,20+60,1500,1849,-349,A17,7,Resign,White
FALSE,43,20+60,1500,1710,-210,A20,2,Resign,White
FALSE,85,20+60,1500,2047,-547,A35,4,Resign,White
FALSE,76,10+30,1500,1989,-489,A22,4,Draw,Draw
FALSE,51,10+30,1500,2117,-617,A10,2,Resign,White
FALSE,139,10+30,1500,1500,0,E91,11,Draw,Draw
FALSE,78,10+30,1500,1535,-35,A16,4,Resign,White
FALSE,75,10+30,1500,2080,-580,D87,16,Resign,White
FALSE,89,10+30,1500,2054,-554,A17,4,Resign,White
FALSE,94,10+30,1500,2081,-581,E92,14,Draw,Draw
FALSE,72,30+30,2070,1500,570,B90,11,Draw,Draw
FALSE,72,30+30,1916,1500,416,D85,13,Resign,Black
FALSE,34,30+30,1500,1500,0,B80,13,Resign,Black
FALSE,134,30+30,1656,1500,156,B84,12,Draw,Draw
FALSE,64,30+30,1557,1500,57,B50,4,Resign,Black
FALSE,28,30+30,1500,1615,-115,A10,2,Resign,White
FALSE,80,30+30,1500,1679,-179,A20,2,Resign,White
FALSE,53,30+30,1500,2122,-622,A13,2,Resign,White
FALSE,45,30+30,1500,1259,241,A10,2,Mate,White
FALSE,70,30+30,1500,2003,-503,A20,2,Resign,White
FALSE,47,30+30,1500,1758,-258,A20,2,Out of Time,White
FALSE,59,30+30,1500,1960,-460,A10,2,Resign,White
FALSE,67,30+30,1500,1869,-369,A35,6,Resign,White
FALSE,124,40+30,1500,2445,-945,B54,9,Resign,White
TRUE,73,10+0,1826,1851,-25,B54,6,Mate,White
TRUE,110,10+0,1854,1814,40,B00,3,Resign,Black
TRUE,156,5+5,1813,1834,-21,C00,3,Draw,Draw
TRUE,62,10+0,1828,1801,27,B00,5,Resign,Black
TRUE,21,8+0,1900,1810,90,D00,3,Resign,White
TRUE,64,8+0,1819,1891,-72,B00,2,Mate,Black
TRUE,35,8+0,1882,1828,54,D00,3,Resign,White
TRUE,75,7+3,1813,1940,-127,B30,5,Resign,White
TRUE,23,8+0,2035,1818,217,D00,4,Resign,White
TRUE,55,10+0,1912,1827,85,B20,3,Resign,White
TRUE,9,10+0,1227,1204,23,C34,5,Resign,White
TRUE,38,10+0,1253,1236,17,B10,2,Resign,White
TRUE,100,10+0,1245,1294,-49,B00,4,Resign,Black
TRUE,60,10+0,1234,1235,-1,B10,2,Mate,Black
TRUE,57,10+0,1254,1245,9,C26,4,Mate,White
TRUE,137,10+0,1277,1255,22,C44,5,Mate,White
TRUE,132,10+0,1265,1267,-2,B25,4,Resign,Black
TRUE,58,10+0,1275,1286,-11,B01,2,Resign,Black
TRUE,102,10+0,1256,1286,-30,D00,4,Resign,White
TRUE,22,10+0,1298,1244,54,B01,2,Resign,Black
TRUE,67,10+0,1231,1311,-80,B10,2,Mate,White
TRUE,60,10+0,1291,1301,-10,B10,2,Mate,Black
TRUE,55,10+0,1290,1290,0,C30,5,Mate,White
TRUE,112,10+0,1300,1319,-19,B23,3,Mate,Black
TRUE,53,10+0,1345,1310,35,B18,8,Mate,White
TRUE,58,10+0,1330,1320,10,C44,5,Resign,White
TRUE,11,10+0,1309,1314,-5,C30,5,Resign,White
TRUE,101,10+0,1298,1369,-71,C28,5,Mate,White
TRUE,39,10+0,1306,1307,-1,C20,3,Mate,White
TRUE,28,10+0,1318,1318,0,B01,2,Mate,Black
TRUE,89,10+0,1378,1326,52,D06,4,Resign,White
TRUE,101,10+0,1336,1355,-19,C30,3,Resign,Black
TRUE,45,10+0,1365,1345,20,C44,4,Mate,White
TRUE,76,10+0,1356,1355,1,B00,2,Resign,Black
TRUE,136,10+0,1315,1346,-31,A50,4,Resign,Black
TRUE,81,10+0,1388,1356,32,C60,6,Mate,White
TRUE,63,10+0,1335,1333,2,B12,7,Resign,White
TRUE,37,10+0,1325,1262,63,B21,3,Mate,White
TRUE,61,10+0,1316,1282,34,C34,6,Mate,White
TRUE,137,10+0,1312,1316,-4,D10,4,Draw,Draw
TRUE,86,10+0,1277,1306,-29,B12,5,Resign,Black
TRUE,17,10+0,1244,1297,-53,D10,6,Resign,Black
TRUE,45,10+0,1288,1254,34,B01,2,Resign,White
TRUE,96,10+0,1346,1276,70,B10,2,Out of Time,Black
TRUE,37,0+15,2013,1773,240,B54,5,Resign,White
TRUE,57,5+5,2105,1806,299,D35,6,Mate,White
TRUE,46,14+0,1836,1741,95,C45,7,Resign,Black
TRUE,128,10+10,1858,1903,-45,A00,4,Mate,Black
FALSE,14,10+4,1793,2131,-338,C02,9,Resign,Black
FALSE,23,10+4,1754,2131,-377,C00,3,Mate,White
FALSE,46,10+4,1596,2131,-535,E20,6,Resign,Black
FALSE,77,20+0,1236,2131,-895,B12,5,Resign,Black
TRUE,73,5+6,2135,1980,155,B98,14,Resign,White
TRUE,71,7+3,1540,2025,-485,B20,3,Mate,White
TRUE,51,10+0,1709,1703,6,A00,1,Resign,White
TRUE,29,60+0,1707,1542,165,C20,3,Resign,White
FALSE,70,20+8,1127,1707,-580,C43,6,Mate,Black
TRUE,107,15+1,1699,1366,333,B02,2,Mate,White
TRUE,59,10+0,1679,1517,162,C00,3,Mate,White
TRUE,89,5+5,1645,1411,234,B01,6,Resign,White
TRUE,50,5+5,1416,1625,-209,C22,6,Mate,Black
FALSE,88,10+0,1500,1625,-125,C40,4,Out of Time,Black
FALSE,43,5+8,1625,1500,125,C20,3,Resign,White
TRUE,23,180+0,1618,1136,482,B20,2,Mate,White
FALSE,63,10+5,1618,1500,118,C20,3,Resign,White
TRUE,96,15+2,1688,1485,203,C22,7,Resign,Black
TRUE,58,15+2,1344,1648,-304,C20,3,Mate,Black
TRUE,85,10+10,1639,1203,436,B02,2,Resign,White
TRUE,61,5+8,1379,1746,-367,C23,3,Mate,White
TRUE,65,9+0,1697,1606,91,C20,3,Mate,White
TRUE,58,9+0,1763,1816,-53,C20,3,Mate,Black
TRUE,83,8+1,1621,1475,146,C20,3,Mate,White
TRUE,45,8+1,1500,1371,129,C20,3,Resign,White
TRUE,10,20+0,1657,1033,624,A40,1,Resign,White
FALSE,60,30+35,1033,1500,-467,A06,2,Mate,Black
TRUE,10,12+2,1035,1603,-568,A00,1,Resign,Black
TRUE,56,5+5,1036,1653,-617,A06,2,Mate,Black
TRUE,77,5+5,1652,1038,614,B00,3,Mate,White
TRUE,81,20+0,1359,1044,315,B02,3,Mate,White
TRUE,36,20+0,1051,1356,-305,A00,1,Mate,Black
FALSE,18,30+35,1051,1257,-206,A04,2,Draw,Draw
FALSE,39,180+180,1257,1051,206,B00,3,Mate,White
FALSE,29,180+180,1051,1257,-206,A04,2,Draw,Draw
TRUE,11,60+0,1598,1053,545,B02,2,Mate,White
TRUE,50,10+11,1062,1322,-260,A04,2,Mate,Black
TRUE,50,20+5,1025,1579,-554,A04,2,Mate,Black
FALSE,23,15+15,1331,1025,306,C20,3,Resign,White
FALSE,6,15+15,1025,1734,-709,A00,1,Draw,Draw
TRUE,59,8+15,1470,1029,441,D06,4,Resign,White
TRUE,10,16+0,1035,1401,-366,A06,2,Out of Time,Black
TRUE,41,15+0,1470,1039,431,C20,3,Resign,White
TRUE,9,15+0,1041,1600,-559,A00,3,Resign,Black
TRUE,4,1+12,1156,1005,151,C20,3,Out of Time,Black
TRUE,20,1+12,1006,1679,-673,A00,1,Mate,Black
TRUE,6,5+10,1414,983,431,C20,3,Draw,Draw
TRUE,35,15+0,1256,937,319,D00,2,Resign,White
TRUE,18,15+0,946,1250,-304,A06,3,Resign,Black
FALSE,87,8+8,1418,1264,154,D00,2,Resign,White
TRUE,63,10+6,1621,1268,353,C01,5,Resign,White
FALSE,51,6+5,1330,1272,58,C26,4,Mate,White
TRUE,66,5+5,1277,1550,-273,B00,2,Resign,Black
TRUE,157,5+5,1546,1282,264,C20,3,Mate,White
TRUE,35,6+10,1259,1472,-213,C46,7,Resign,White
TRUE,71,6+10,1467,1267,200,C20,3,Resign,White
TRUE,113,8+8,1573,1271,302,C20,3,Resign,White
TRUE,9,8+8,1569,1276,293,C20,3,Mate,White
TRUE,26,5+10,1279,1696,-417,B23,3,Resign,Black
TRUE,33,5+7,1340,1293,47,C20,3,Mate,White
TRUE,50,5+8,1294,1804,-510,C50,9,Mate,Black
TRUE,39,5+8,1802,1296,506,C20,4,Mate,White
TRUE,30,5+8,1298,1800,-502,C50,8,Resign,Black
TRUE,39,5+8,1861,1299,562,D02,4,Mate,White
TRUE,89,10+0,1268,1316,-48,C50,6,Resign,White
TRUE,23,10+0,1347,1331,16,A09,4,Mate,White
FALSE,65,8+8,1418,1331,87,A40,2,Resign,White
TRUE,67,10+10,1340,1511,-171,C44,6,Resign,Black
TRUE,18,8+10,1325,1500,-175,A00,1,Resign,White
TRUE,53,4+10,1455,1336,119,A00,2,Out of Time,White
FALSE,51,15+0,1609,1866,-257,A22,4,Out of Time,White
FALSE,47,15+0,1760,1866,-106,B94,11,Mate,White
FALSE,30,15+0,1866,1729,137,B30,5,Resign,White
FALSE,49,15+0,1563,1866,-303,D44,11,Resign,Black
FALSE,2,15+0,1866,1500,366,C20,2,Resign,White
FALSE,3,15+0,1500,1866,-366,B27,3,Resign,Black
FALSE,39,15+0,1866,1510,356,B31,6,Resign,White
FALSE,38,15+0,1866,1466,400,C41,5,Resign,Black
FALSE,94,15+0,1407,1866,-459,D00,4,Mate,Black
FALSE,94,15+0,1614,1866,-252,A00,1,Resign,Black
FALSE,9,15+0,1866,1556,310,B50,5,Resign,White
FALSE,30,20+0,1500,1866,-366,B20,3,Mate,Black
FALSE,19,20+0,1866,1500,366,C40,4,Mate,White
FALSE,13,20+0,1866,1438,428,C55,6,Out of Time,White
FALSE,33,20+0,1500,1866,-366,D00,2,Out of Time,White
FALSE,81,15+0,1866,1500,366,C42,5,Mate,White
FALSE,28,15+0,1500,1866,-366,B50,4,Mate,Black
FALSE,56,15+0,1706,1866,-160,D02,5,Out of Time,Black
FALSE,69,10+0,1866,2236,-370,B40,5,Resign,White
FALSE,86,20+0,1817,1866,-49,B50,4,Mate,Black
FALSE,31,20+0,1866,1514,352,C57,9,Mate,White
TRUE,55,10+0,2326,1907,419,A13,4,Resign,White
TRUE,20,30+0,1907,1770,137,D02,4,Resign,Black
TRUE,26,10+0,1922,1839,83,A40,2,Resign,Black
TRUE,101,10+0,1836,1925,-89,D02,4,Draw,Draw
FALSE,17,10+0,1925,1457,468,A41,2,Resign,White
FALSE,40,10+0,1457,1925,-468,B07,2,Resign,Black
FALSE,67,30+0,2160,1925,235,C65,7,Mate,White
FALSE,17,30+0,2160,1925,235,C41,5,Draw,Draw
FALSE,127,30+0,1986,1925,61,C50,5,Draw,Draw
FALSE,102,10+0,1925,1777,148,A40,2,Resign,Black
FALSE,78,10+0,1777,1925,-148,B01,4,Resign,Black
TRUE,48,10+0,1932,2075,-143,D01,4,Resign,Black
FALSE,24,10+0,1319,1932,-613,D00,3,Mate,Black
FALSE,92,10+0,1800,1932,-132,C55,8,Resign,Black
TRUE,68,10+0,1941,2034,-93,D02,3,Resign,Black
TRUE,38,10+0,1950,2049,-99,B08,8,Resign,Black
TRUE,53,10+0,1810,1967,-157,C33,5,Resign,White
FALSE,141,10+0,1967,1567,400,D02,4,Resign,White
FALSE,43,10+0,1967,1411,556,D02,3,Mate,White
FALSE,50,10+0,1422,1967,-545,C42,5,Resign,Black
TRUE,71,10+0,1959,1839,120,D05,6,Resign,White
FALSE,26,10+0,1896,1959,-63,C41,8,Resign,Black
FALSE,52,30+0,1959,1629,330,D04,6,Resign,Black
TRUE,150,10+0,1972,1959,13,A45,2,Mate,Black
TRUE,20,10+0,1970,1959,11,C41,5,Resign,Black
TRUE,26,10+0,1955,1946,9,C41,5,Resign,Black
TRUE,87,10+0,1929,2046,-117,B12,3,Resign,White
TRUE,77,10+0,1916,1922,-6,B13,5,Mate,White
TRUE,50,30+0,1505,1914,-409,A00,1,Resign,Black
TRUE,21,10+0,1834,1930,-96,C41,4,Mate,White
TRUE,57,10+0,1846,1947,-101,C41,5,Resign,White
TRUE,47,10+0,1939,1778,161,D04,5,Resign,White
TRUE,105,10+0,1938,1980,-42,D01,4,Draw,Draw
TRUE,85,10+0,1919,1994,-75,D00,3,Resign,White
TRUE,97,10+0,1996,1916,80,C50,5,Draw,Draw
TRUE,62,10+0,1928,1988,-60,A45,2,Mate,Black
TRUE,36,10+0,1023,1821,-798,C41,5,Resign,Black
TRUE,28,10+0,1030,1501,-471,B01,2,Resign,Black
TRUE,43,15+0,1422,1040,382,C40,4,Mate,White
TRUE,63,11+11,1043,1701,-658,B00,2,Resign,Black
TRUE,22,15+0,1049,1539,-490,B20,3,Resign,Black
TRUE,57,30+0,1055,1569,-514,C55,6,Resign,Black
FALSE,67,18+5,1500,1500,0,A01,2,Resign,White
FALSE,51,18+5,1500,1500,0,B90,10,Resign,White
FALSE,94,18+5,1500,1500,0,A57,6,Resign,Black
FALSE,35,18+5,1500,1500,0,C65,7,Resign,White
FALSE,62,18+5,1500,1500,0,C03,6,Resign,Black
FALSE,11,18+5,1500,1500,0,C64,9,Resign,White
FALSE,57,10+0,1500,2263,-763,A36,5,Resign,White
FALSE,146,10+0,2263,1500,763,B09,9,Resign,Black
FALSE,79,10+0,1500,2263,-763,A04,2,Resign,White
FALSE,98,10+0,2263,1500,763,B32,8,Draw,Draw
TRUE,23,10+0,2349,1750,599,A00,1,Resign,White
FALSE,46,15+0,1750,1437,313,B00,4,Resign,Black
TRUE,14,5+8,1895,1750,145,C65,7,Resign,White
TRUE,29,16+7,1975,1750,225,C68,10,Draw,Draw
TRUE,9,15+0,1570,1750,-180,D00,2,Resign,White
TRUE,58,15+0,1910,1714,196,C39,10,Resign,Black
TRUE,54,10+0,1695,1688,7,D02,5,Mate,Black
TRUE,27,10+0,1661,1666,-5,C55,6,Resign,White
TRUE,53,10+0,1516,1643,-127,C55,7,Resign,Black
TRUE,42,6+5,1737,1601,136,C44,8,Mate,Black
TRUE,25,6+5,1552,1754,-202,C00,4,Resign,White
TRUE,28,6+5,1773,1495,278,C45,9,Mate,Black
TRUE,131,6+5,1575,1527,48,C46,7,Mate,White
TRUE,30,6+5,1512,1254,258,C00,3,Resign,White
TRUE,35,6+5,1259,1494,-235,A01,5,Resign,Black
TRUE,16,6+5,1509,1439,70,C68,7,Resign,Black
TRUE,42,6+5,1626,1353,273,D00,2,Mate,Black
FALSE,46,8+9,1603,1353,250,C56,10,Resign,Black
TRUE,3,10+0,1848,1873,-25,C40,3,Resign,White
TRUE,39,10+10,1873,1884,-11,B00,2,Resign,Black
FALSE,35,6+3,1873,1744,129,B23,5,Resign,Black
FALSE,33,5+8,1873,2008,-135,A00,2,Resign,Black
FALSE,119,8+0,1873,1851,22,C64,6,Mate,White
FALSE,37,8+0,1873,1541,332,C61,6,Mate,White
FALSE,53,8+0,1873,1500,373,C40,3,Mate,White
FALSE,42,8+0,1500,1873,-373,C22,7,Mate,Black
FALSE,95,10+0,1873,1525,348,D00,3,Out of Time,White
FALSE,81,10+0,1873,1525,348,B01,4,Resign,White
FALSE,22,10+0,1525,1873,-348,C50,7,Resign,White
TRUE,140,10+0,1542,1537,5,B20,3,Out of Time,Draw
TRUE,142,10+0,1521,1526,-5,B30,5,Mate,Black
TRUE,39,10+0,1518,1410,108,C46,7,Mate,White
TRUE,48,10+0,1626,1503,123,B30,4,Resign,Black
TRUE,96,10+0,1519,1547,-28,C55,6,Mate,Black
TRUE,112,10+0,1521,1892,-371,D00,3,Mate,Black
TRUE,86,10+0,1229,1517,-288,D00,9,Out of Time,Black
TRUE,71,10+0,1502,1635,-133,D00,3,Resign,White
TRUE,71,10+0,1913,1504,409,B21,5,Resign,White
TRUE,94,10+0,1351,1498,-147,B20,3,Resign,Black
TRUE,61,10+0,1491,1525,-34,C50,9,Resign,White
TRUE,35,10+0,1504,1509,-5,B30,4,Resign,White
TRUE,68,10+0,1521,1484,37,C42,5,Mate,Black
TRUE,55,10+0,1569,1542,27,B25,4,Mate,White
TRUE,147,10+0,1651,1550,101,B20,2,Mate,White
TRUE,104,10+0,1551,1538,13,B34,9,Mate,Black
TRUE,2,10+15,1633,1287,346,C20,2,Out of Time,Black
TRUE,33,10+7,1434,1724,-290,C20,4,Resign,White
TRUE,35,10+0,1651,1740,-89,C00,3,Resign,White
TRUE,29,10+0,1580,1590,-10,C44,5,Resign,White
TRUE,85,15+0,1561,1163,398,C46,6,Resign,White
TRUE,26,15+0,1716,1422,294,C44,5,Mate,Black
TRUE,24,180+180,1681,1388,293,B50,4,Resign,White
TRUE,47,15+5,1636,1364,272,B01,4,Mate,White
TRUE,41,10+5,1291,1500,-209,D20,5,Resign,Black
TRUE,15,10+0,1417,1213,204,C44,5,Mate,White
TRUE,98,10+0,1013,1206,-193,C23,3,Out of Time,Black
TRUE,54,10+0,1216,1344,-128,A49,4,Mate,Black
TRUE,43,10+0,1194,1356,-162,D02,4,Resign,White
TRUE,11,10+0,1315,1205,110,B00,2,Mate,White
TRUE,78,10+0,1192,1487,-295,A00,1,Resign,Black
TRUE,13,10+0,1451,1198,253,C20,3,Mate,White
TRUE,63,10+0,1171,1408,-237,C20,3,Mate,White
TRUE,9,10+0,1455,1177,278,C50,5,Resign,White
TRUE,99,10+0,1295,1153,142,C20,3,Resign,Black
TRUE,65,15+0,1307,1518,-211,B50,4,Mate,White
TRUE,48,15+0,1240,1297,-57,C02,7,Out of Time,Black
TRUE,71,15+0,1290,1144,146,B07,4,Out of Time,White
TRUE,38,15+0,1574,1260,314,A00,1,Mate,Black
TRUE,47,15+0,1556,1264,292,C02,9,Mate,White
TRUE,38,15+0,1267,1552,-285,B50,4,Resign,Black
TRUE,60,15+0,1279,1629,-350,D30,4,Mate,Black
TRUE,97,15+0,1626,1282,344,D31,5,Mate,White
TRUE,48,15+0,1285,1623,-338,C46,7,Resign,Black
TRUE,36,15+0,1644,1264,380,D32,6,Mate,Black
TRUE,94,15+0,1267,1641,-374,C44,8,Mate,Black
TRUE,136,15+0,1271,1549,-278,C46,7,Mate,Black
TRUE,60,15+0,1526,1253,273,C02,7,Mate,Black
TRUE,44,15+0,1335,1241,94,C00,3,Mate,Black
TRUE,44,15+0,1250,1243,7,C57,7,Mate,Black
TRUE,150,10+0,1248,1239,9,C02,7,Mate,Black
TRUE,96,10+0,1201,1230,-29,C10,6,Mate,Black
TRUE,30,10+0,1217,1219,-2,A40,2,Out of Time,Black
TRUE,34,10+0,1231,1205,26,D30,4,Resign,Black
TRUE,56,10+0,1240,1219,21,C02,5,Mate,Black
TRUE,75,10+0,1226,1230,-4,C02,5,Resign,White
TRUE,52,10+0,1250,1244,6,D32,6,Resign,White
TRUE,21,10+0,1200,1257,-57,C00,3,Resign,White
TRUE,65,10+0,1175,1270,-95,C02,7,Resign,White
TRUE,53,10+0,1262,1184,78,C00,3,Mate,White
TRUE,49,10+0,1169,1276,-107,C00,3,Mate,White
TRUE,40,10+0,1283,1393,-110,B28,6,Resign,Black
TRUE,37,10+0,1385,1291,94,C00,3,Mate,White
TRUE,42,10+0,1299,1376,-77,A00,1,Mate,Black
TRUE,31,10+0,1366,1308,58,C00,3,Resign,White
TRUE,11,10+0,1295,1381,-86,A00,1,Resign,White
TRUE,11,10+0,1315,1305,10,C00,3,Resign,White
TRUE,49,10+0,1294,1334,-40,A00,1,Resign,White
TRUE,72,10+0,1303,1354,-51,C20,3,Resign,Black
TRUE,85,10+0,1344,1313,31,C00,2,Resign,White
TRUE,58,10+0,1323,1334,-11,C00,5,Resign,Black
TRUE,80,10+0,1311,1338,-27,C42,5,Resign,White
TRUE,61,10+0,1327,1322,5,C02,5,Mate,White
FALSE,5,5+8,1505,1500,5,B00,3,Resign,White
FALSE,7,15+0,1613,1500,113,C02,5,Resign,White
FALSE,33,60+60,1884,2500,-616,B78,19,Resign,Black
TRUE,64,15+8,1819,1128,691,C50,5,Resign,White
TRUE,26,20+0,1134,1372,-238,C42,5,Mate,Black
TRUE,51,10+5,1137,1533,-396,B23,3,Resign,Black
TRUE,41,10+0,1217,1149,68,C40,4,Resign,White
TRUE,48,10+0,1206,1163,43,C47,7,Resign,White
TRUE,20,15+11,1242,1176,66,C46,7,Resign,White
TRUE,25,10+0,1147,1520,-373,C66,13,Resign,White
TRUE,20,10+8,1156,1297,-141,C41,5,Out of Time,Black
TRUE,11,10+0,1329,1166,163,C20,3,Out of Time,White
TRUE,63,15+0,1445,1172,273,C44,5,Resign,White
TRUE,19,15+0,1176,1090,86,C65,7,Draw,Draw
TRUE,21,15+0,1379,1149,230,C42,5,Resign,White
TRUE,134,15+0,1155,1459,-304,C47,8,Mate,Black
TRUE,129,15+0,1381,1163,218,C20,3,Mate,White
TRUE,39,15+0,1540,1169,371,C20,4,Resign,White
TRUE,33,12+0,1171,1648,-477,C50,8,Resign,Black
FALSE,22,20+7,1171,1500,-329,C00,3,Mate,Black
TRUE,60,10+3,1172,1760,-588,C45,7,Mate,Black
TRUE,87,15+1,1434,1179,255,C48,7,Resign,White
TRUE,62,15+0,1190,1337,-147,C41,5,Resign,Black
TRUE,22,9+5,1698,1154,544,A22,4,Resign,Black
FALSE,12,15+2,1500,1154,346,C42,6,Resign,White
FALSE,41,10+0,1558,1154,404,C33,5,Resign,White
TRUE,40,20+5,1158,1521,-363,C50,6,Out of Time,Black
TRUE,71,15+0,1758,1160,598,D20,6,Resign,White
TRUE,107,5+8,1162,1606,-444,C41,5,Resign,Black
TRUE,41,10+3,1561,1166,395,C44,5,Mate,White
TRUE,37,8+3,1939,1167,772,C20,3,Resign,White
TRUE,23,40+10,1510,1171,339,D06,4,Resign,White
TRUE,30,10+0,1173,1751,-578,C20,2,Resign,Black
TRUE,1,10+0,1670,1175,495,B00,1,Resign,White
TRUE,51,10+0,1573,1179,394,C50,5,Mate,White
TRUE,47,10+0,1184,1500,-316,A00,1,Resign,Black
TRUE,73,5+5,2038,1957,81,C24,4,Mate,White
TRUE,154,10+0,1965,2087,-122,C01,7,Out of Time,Black
TRUE,40,10+0,1420,1964,-544,C50,6,Mate,Black
TRUE,41,5+7,1951,1975,-24,B21,3,Mate,White
TRUE,45,10+0,2000,1962,38,C54,13,Resign,White
TRUE,51,8+0,2052,1971,81,E76,13,Mate,White
TRUE,146,10+0,1987,1900,87,C45,7,Out of Time,Black
TRUE,76,10+0,1821,1979,-158,C36,7,Resign,Black
TRUE,144,10+0,1996,1886,110,B14,10,Resign,Black
TRUE,43,10+0,1673,1992,-319,B15,7,Resign,Black
TRUE,70,10+0,1672,1988,-316,C20,4,Mate,Black
TRUE,45,10+0,1983,1764,219,B20,3,Resign,White
TRUE,89,10+0,1971,1965,6,B06,4,Mate,White
TRUE,70,5+7,2006,1956,50,A46,4,Resign,Black
TRUE,29,10+3,1955,1454,501,C00,3,Resign,White
TRUE,71,10+0,1668,1976,-308,C50,8,Resign,White
TRUE,24,10+0,1978,2457,-479,A10,2,Resign,Black
TRUE,29,10+0,1651,1974,-323,C51,9,Resign,Black
TRUE,57,10+0,1963,1942,21,C01,7,Resign,White
TRUE,76,7+8,1972,2072,-100,C45,10,Resign,Black
TRUE,20,10+0,1971,1184,787,B20,3,Resign,White
TRUE,39,10+0,1971,1317,654,B01,4,Mate,White
TRUE,118,10+0,1774,1965,-191,C54,11,Mate,Black
TRUE,71,12+12,1975,2015,-40,B21,3,Resign,Black
TRUE,57,10+0,1972,1643,329,C55,6,Mate,White
TRUE,41,10+0,2042,1982,60,A53,4,Resign,White
TRUE,48,10+0,1872,1973,-101,C45,7,Resign,Black
TRUE,63,10+0,1962,1924,38,B21,3,Mate,White
TRUE,60,2+10,1974,1990,-16,B21,3,Resign,Black
TRUE,31,10+0,1588,1996,-408,A00,1,Resign,White
TRUE,29,10+0,1993,1609,384,B07,3,Resign,White
TRUE,29,10+0,2007,2005,2,B00,2,Resign,White
TRUE,33,15+15,1754,1500,254,B01,2,Mate,White
TRUE,46,6+3,1300,1495,-195,C53,9,Mate,Black
TRUE,63,5+8,1433,1508,-75,D00,2,Resign,White
TRUE,62,10+0,1707,1775,-68,A00,4,Resign,Black
TRUE,59,10+0,1762,1833,-71,A07,4,Resign,White
TRUE,53,10+0,1750,1775,-25,A00,1,Resign,White
TRUE,29,10+0,1765,1761,4,C44,5,Resign,White
TRUE,150,15+0,2054,2123,-69,C02,10,Out of Time,Black
TRUE,122,25+5,1666,1701,-35,B14,10,Draw,Draw
TRUE,143,25+5,1690,1677,13,B12,7,Resign,White
TRUE,132,25+5,1702,1664,38,B18,8,Resign,Black
TRUE,30,25+5,1715,1651,64,B12,7,Mate,Black
TRUE,41,25+5,1705,1661,44,B18,8,Resign,White
TRUE,64,15+3,1708,1694,14,E60,5,Resign,Black
TRUE,150,15+3,1694,1709,-15,B10,2,Draw,Draw
TRUE,87,15+3,1697,1705,-8,C55,7,Mate,White
TRUE,52,15+3,1716,1684,32,D01,4,Mate,Black
TRUE,110,15+3,1696,1706,-10,E61,6,Resign,Black
TRUE,107,15+3,1695,1708,-13,B10,2,Resign,White
TRUE,157,15+3,1708,1694,14,C66,8,Draw,Draw
TRUE,49,15+3,1682,1721,-39,A43,3,Resign,White
TRUE,64,180+180,1648,1695,-47,E61,6,Resign,White
TRUE,2,180+0,1646,1696,-50,A45,2,Draw,Draw
FALSE,33,5+10,1696,1500,196,D00,3,Draw,Draw
TRUE,71,5+8,1631,1710,-79,B10,5,Resign,White
TRUE,84,5+8,1830,1694,136,B10,2,Resign,Black
TRUE,67,15+5,1679,1834,-155,C55,6,Mate,White
TRUE,62,15+0,1869,1670,199,A07,3,Resign,Black
TRUE,37,14+0,1877,1675,202,C34,6,Mate,White
TRUE,143,19+17,1661,1762,-101,A56,4,Mate,White
TRUE,56,19+17,1753,1670,83,B00,3,Resign,White
FALSE,40,7+12,1691,1670,21,B12,5,Resign,Black
FALSE,139,10+0,2295,2127,168,B18,8,Resign,Black
FALSE,63,10+0,2127,2295,-168,B09,11,Resign,White
TRUE,19,90+30,2292,1794,498,C65,6,Resign,White
TRUE,76,90+30,1575,2291,-716,D15,8,Resign,Black
TRUE,35,90+30,2291,1576,715,C77,9,Mate,White
FALSE,36,10+0,1500,1804,-304,C24,4,Resign,White
TRUE,117,10+0,1289,1455,-166,E00,4,Resign,White
TRUE,90,10+0,1466,1458,8,A21,3,Mate,Black
TRUE,26,10+0,1458,1363,95,A85,5,Resign,White
TRUE,64,10+0,1367,1450,-83,A46,5,Out of Time,Black
TRUE,87,10+0,1536,1459,77,B20,3,Resign,White
TRUE,25,10+0,1345,1452,-107,B93,11,Resign,Black
TRUE,76,10+0,1459,1569,-110,A04,2,Resign,Black
TRUE,71,10+0,1447,1479,-32,D94,11,Out of Time,White
TRUE,54,10+0,1454,1613,-159,A22,4,Resign,Black
TRUE,106,10+0,1502,1463,39,B94,11,Resign,White
TRUE,91,10+0,1451,1514,-63,A10,2,Mate,White
TRUE,40,10+0,1463,1413,50,D31,5,Mate,Black
TRUE,42,10+0,1423,1453,-30,A45,3,Resign,Black
TRUE,74,10+0,1455,1442,13,B20,2,Resign,Black
TRUE,111,10+0,1488,1451,37,C20,3,Resign,White
TRUE,30,10+0,1459,1566,-107,A13,2,Resign,Black
TRUE,53,10+0,1475,1314,161,A21,3,Resign,Black
TRUE,47,10+0,1451,1477,-26,C65,6,Resign,White
TRUE,111,10+0,1468,1386,82,A22,4,Mate,White
TRUE,54,10+0,1858,1450,408,C00,3,Resign,White
TRUE,118,10+0,1453,1772,-319,E20,6,Mate,Black
TRUE,63,10+0,1447,1273,174,D06,8,Mate,White
TRUE,24,10+0,1457,1510,-53,D02,3,Mate,Black
TRUE,68,10+0,1363,1448,-85,B20,3,Resign,Black
TRUE,41,10+0,1429,1460,-31,C34,6,Resign,White
TRUE,15,10+0,1453,1316,137,B40,4,Resign,White
TRUE,56,10+0,1388,1444,-56,D01,5,Resign,Black
TRUE,82,10+0,1260,1438,-178,A10,2,Out of Time,Black
TRUE,33,10+0,1429,1377,52,D02,4,Resign,White
TRUE,64,10+0,1439,1453,-14,A41,4,Resign,Black
TRUE,68,10+0,1555,1447,108,B20,3,Resign,White
TRUE,46,10+0,1478,1458,20,A45,2,Resign,White
TRUE,84,10+0,1408,1448,-40,A00,1,Mate,Black
TRUE,57,10+0,1437,1418,19,A13,3,Mate,White
TRUE,40,10+0,1540,1446,94,B21,3,Resign,White
TRUE,42,10+0,1438,1698,-260,C50,6,Mate,Black
TRUE,50,10+0,1752,1441,311,A03,2,Resign,White
TRUE,52,10+0,1444,1815,-371,A04,2,Resign,Black
TRUE,30,10+0,1449,1636,-187,A40,3,Resign,Black
TRUE,39,10+0,2076,1450,626,B15,5,Resign,White
TRUE,44,10+0,1427,1359,68,C70,8,Resign,White
TRUE,58,10+0,1425,1415,10,A11,2,Mate,Black
TRUE,52,10+0,1423,1533,-110,D02,4,Resign,Black
TRUE,30,10+0,1573,1407,166,C15,7,Resign,Black
TRUE,77,10+0,1391,1601,-210,A07,3,Mate,White
TRUE,108,15+0,1060,1134,-74,A01,3,Mate,Black
TRUE,38,10+0,1124,1790,-666,A00,1,Mate,Black
TRUE,41,10+0,1460,1153,307,A00,1,Mate,White
TRUE,36,10+0,1203,1422,-219,A00,1,Mate,Black
FALSE,33,30+0,1672,1203,469,A41,2,Mate,White
TRUE,10,14+14,1402,1208,194,A01,2,Mate,Black
TRUE,37,14+14,1689,1500,189,D00,3,Mate,White
TRUE,115,10+0,1349,1306,43,C41,4,Mate,White
FALSE,35,10+30,1500,1349,151,D20,5,Mate,White
TRUE,88,10+3,1404,1326,78,C62,6,Resign,Black
TRUE,39,10+0,1466,1439,27,D20,4,Resign,White
TRUE,26,30+0,1275,1467,-192,C43,6,Draw,Draw
TRUE,17,30+0,1429,1282,147,C20,4,Mate,White
TRUE,77,10+0,1127,1108,19,A40,2,Out of Time,White
TRUE,74,10+0,1254,1256,-2,B00,3,Resign,Black
TRUE,34,10+0,1172,1162,10,C50,5,Out of Time,Black
TRUE,29,10+0,1264,1289,-25,C20,3,Mate,White
TRUE,46,10+0,1500,1435,65,C27,3,Resign,Black
TRUE,96,15+0,1619,1574,45,C00,4,Out of Time,Black
TRUE,10,20+0,1575,1640,-65,C23,3,Resign,Black
TRUE,104,20+0,1654,1561,93,D00,4,Resign,Black
TRUE,74,20+0,1558,1657,-99,D20,5,Draw,Draw
TRUE,51,10+0,1574,1569,5,C01,4,Mate,White
TRUE,20,6+8,1678,1675,3,C62,6,Resign,Black
TRUE,38,7+7,1777,1648,129,C50,8,Resign,Black
TRUE,58,6+8,1652,1624,28,C45,8,Resign,Black
TRUE,4,6+8,1645,1679,-34,B50,4,Resign,Black
TRUE,46,10+0,1894,2133,-239,C02,9,Resign,Black
TRUE,64,10+0,2135,2118,17,C00,3,Resign,Black
TRUE,36,10+5,2021,2107,-86,C00,5,Resign,Black
TRUE,115,10+5,2095,2029,66,C65,6,Resign,White
TRUE,110,8+0,2092,2080,12,C00,3,Out of Time,Black
TRUE,81,10+0,2110,2095,15,C00,3,Resign,White
TRUE,137,8+2,2262,2104,158,A40,2,Mate,White
TRUE,43,8+2,2081,2243,-162,B07,2,Resign,White
TRUE,63,20+0,2062,2140,-78,C00,3,Resign,White
TRUE,54,10+15,1928,2051,-123,C00,2,Resign,Black
TRUE,101,8+0,2203,2061,142,C17,9,Mate,White
TRUE,66,8+0,2073,2195,-122,B40,5,Mate,Black
TRUE,84,8+2,2077,2443,-366,B20,5,Resign,Black
TRUE,42,8+2,2440,2081,359,A97,15,Resign,White
TRUE,28,8+2,2085,2436,-351,B20,5,Resign,Black
TRUE,37,8+2,2432,2090,342,A13,3,Resign,White
TRUE,47,10+10,2351,2097,254,A04,2,Resign,White
TRUE,60,10+10,2104,2340,-236,B07,4,Resign,Black
TRUE,72,8+0,2123,2116,7,B01,7,Resign,Black
TRUE,33,8+0,2105,2145,-40,C00,3,Mate,White
TRUE,83,8+0,2125,2115,10,B01,7,Out of Time,White
TRUE,52,15+10,2140,2244,-104,C78,9,Resign,Black
TRUE,57,15+10,2220,2157,63,A84,5,Resign,White
FALSE,45,5+5,2157,1380,777,C42,4,Mate,White
FALSE,109,5+5,2157,1569,588,C78,12,Mate,White
FALSE,45,5+5,2157,2000,157,B01,7,Resign,White
TRUE,50,9+0,2173,2287,-114,B20,6,Resign,Black
TRUE,150,10+0,2160,2214,-54,B13,5,Resign,Black
TRUE,110,17+15,2175,2322,-147,B06,4,Mate,Black
TRUE,51,17+15,2304,2194,110,C00,3,Resign,White
TRUE,158,8+2,2213,2323,-110,B13,5,Mate,Black
TRUE,50,6+5,2234,2352,-118,B20,5,Mate,Black
TRUE,43,6+5,2343,2259,84,A40,2,Resign,White
TRUE,68,10+10,2290,2317,-27,B20,6,Resign,Black
TRUE,50,10+0,1803,2285,-482,C00,5,Resign,Black
TRUE,55,10+0,2409,2314,95,C18,12,Mate,White
TRUE,15,6+8,1620,1651,-31,C46,7,Out of Time,White
TRUE,45,6+8,1618,1630,-12,C46,5,Resign,White
TRUE,77,6+7,1644,1728,-84,B12,5,Resign,Black
TRUE,82,10+0,1667,1807,-140,C14,13,Out of Time,Black
TRUE,24,5+5,1813,1602,211,C50,9,Mate,Black
TRUE,15,10+0,1647,1745,-98,D11,5,Resign,Black
TRUE,36,10+0,1796,1680,116,C45,8,Mate,Black
TRUE,4,10+0,1650,1895,-245,A00,1,Resign,Black
TRUE,38,30+0,1221,1783,-562,A00,1,Resign,Black
TRUE,27,2+10,1839,1229,610,A40,6,Resign,White
TRUE,50,10+8,1500,1406,94,C44,4,Resign,Black
TRUE,51,10+5,1487,1200,287,C20,4,Mate,White
TRUE,45,5+10,1706,1208,498,A40,1,Mate,White
TRUE,6,10+0,1500,2113,-613,B30,4,Resign,Black
FALSE,62,10+1,2209,1500,709,C65,6,Resign,Black
FALSE,32,5+10,2489,1500,989,D08,4,Resign,White
FALSE,65,5+10,2489,1500,989,D06,4,Mate,White
TRUE,56,18+0,1242,1216,26,E50,9,Mate,Black
TRUE,46,18+0,1248,1417,-169,C57,8,Resign,Black
TRUE,20,18+0,1252,1498,-246,B20,3,Mate,Black
TRUE,100,15+15,1248,1342,-94,C40,4,Mate,Black
TRUE,71,10+0,1227,1260,-33,C24,4,Out of Time,White
TRUE,81,15+15,1386,1268,118,C22,6,Mate,White
TRUE,47,18+0,1250,1475,-225,C41,5,Mate,White
TRUE,82,90+30,1237,1615,-378,D31,5,Mate,Black
TRUE,109,15+30,1227,1191,36,C46,7,Mate,White
TRUE,67,10+0,1218,1158,60,C40,3,Out of Time,White
TRUE,57,10+0,1210,1100,110,B01,4,Mate,White
TRUE,26,10+0,1036,1179,-143,A00,1,Resign,Black
TRUE,41,10+0,1172,1060,112,D31,5,Mate,White
TRUE,141,10+0,1167,1078,89,E00,5,Mate,White
TRUE,41,10+0,1148,1099,49,D44,9,Mate,White
TRUE,95,10+0,1139,1089,50,D10,6,Mate,White
TRUE,107,10+0,1141,1138,3,C47,7,Draw,Draw
TRUE,77,10+0,1130,1048,82,E20,8,Mate,White
TRUE,83,10+0,1034,1144,-110,B21,3,Mate,White
TRUE,68,10+0,1159,1019,140,D07,6,Mate,Black
TRUE,19,10+0,1149,1119,30,D08,4,Resign,White
TRUE,119,5+5,1195,1159,36,C40,3,Mate,White
TRUE,61,7+6,1148,1153,-5,D02,4,Mate,White
TRUE,32,7+6,1154,1148,6,C23,3,Draw,Draw
TRUE,49,10+9,1149,1159,-10,B00,4,Mate,White
TRUE,108,10+9,1172,1137,35,B00,2,Mate,Black
TRUE,34,15+0,1129,1161,-32,C40,4,Resign,Black
TRUE,36,15+0,1174,1115,59,E20,8,Mate,Black
TRUE,120,90+30,1184,1223,-39,B21,3,Mate,Black
TRUE,85,90+30,1172,1329,-157,C50,8,Mate,White
TRUE,58,90+30,1162,1132,30,C42,5,Resign,White
TRUE,98,90+30,1172,1199,-27,A04,4,Mate,Black
TRUE,54,90+30,1181,1310,-129,D10,6,Mate,Black
TRUE,77,15+15,1836,1500,336,E20,8,Mate,White
FALSE,51,20+60,1972,1500,472,B23,3,Resign,White
FALSE,57,20+0,1424,1500,-76,C55,6,Resign,Black
FALSE,46,20+0,1424,1534,-110,C00,3,Resign,Black
FALSE,107,20+0,1534,1424,110,C70,8,Resign,White
FALSE,61,20+0,1500,1424,76,C34,5,Mate,White
FALSE,19,20+0,1673,1424,249,C57,11,Mate,White
FALSE,54,20+0,1396,1424,-28,B21,6,Resign,Black
FALSE,83,20+0,1424,1087,337,B01,4,Mate,White
FALSE,77,20+0,1424,1500,-76,C41,4,Resign,White
FALSE,34,10+0,1330,1424,-94,C20,3,Resign,Black
FALSE,25,10+0,1500,1424,76,C46,5,Resign,White
FALSE,116,10+0,1424,1158,266,C23,3,Draw,Draw
FALSE,50,10+0,1424,1454,-30,C65,6,Resign,Black
FALSE,53,10+0,1662,1424,238,D02,4,Resign,White
FALSE,14,10+0,1424,1662,-238,A00,1,Mate,Black
FALSE,39,10+0,1500,1424,76,D02,3,Out of Time,White
FALSE,90,10+0,1500,1424,76,C55,7,Mate,Black
FALSE,28,10+0,1424,1654,-230,C40,4,Mate,Black
FALSE,69,10+0,1666,1424,242,D00,3,Resign,White
TRUE,23,15+15,1414,1500,-86,B00,2,Mate,White
FALSE,78,10+0,1453,1414,39,D00,3,Out of Time,Black
FALSE,39,10+0,1414,1651,-237,C65,6,Resign,Black
FALSE,104,15+5,1477,1414,63,C20,3,Mate,Black
FALSE,67,15+5,1414,1500,-86,C40,4,Mate,White
FALSE,26,15+5,1500,1414,86,C24,4,Mate,Black
FALSE,13,15+5,1414,1452,-38,C30,4,Resign,Black
FALSE,123,10+0,1500,1414,86,C48,8,Mate,White
FALSE,21,10+0,1500,1414,86,C46,7,Resign,White
FALSE,28,10+0,1414,1591,-177,C00,3,Out of Time,Black
FALSE,119,10+0,1787,1414,373,C46,5,Resign,White
FALSE,44,10+0,1414,1787,-373,C31,5,Resign,Black
FALSE,93,10+0,1097,1414,-317,C44,4,Resign,White
FALSE,51,10+8,1414,1500,-86,A25,4,Resign,White
FALSE,28,10+8,1500,1414,86,C30,4,Draw,Draw
FALSE,41,10+8,1414,1500,-86,A80,3,Resign,White
FALSE,20,25+15,1414,1500,-86,A10,2,Resign,Black
FALSE,30,15+10,1500,1414,86,C20,4,Draw,Draw
TRUE,102,10+0,1426,1461,-35,C40,4,Out of Time,Black
TRUE,74,15+10,1635,1432,203,C42,5,Resign,White
TRUE,16,15+0,1570,1414,156,D30,4,Mate,Black
FALSE,42,10+0,1500,2026,-526,D30,4,Resign,Black
TRUE,62,5+5,2045,1750,295,B00,3,Resign,Black
FALSE,111,9+2,2045,1768,277,C62,6,Resign,White
FALSE,64,5+5,2045,1500,545,C62,6,Resign,White
FALSE,116,15+0,2045,1500,545,C41,4,Out of Time,Black
FALSE,66,10+0,2045,2062,-17,C01,5,Resign,Black
FALSE,19,10+0,2045,1435,610,C00,3,Out of Time,White
FALSE,79,10+0,2045,1500,545,B07,5,Out of Time,White
FALSE,77,5+5,1500,1270,230,B01,4,Resign,White
FALSE,120,5+8,1539,1270,269,A06,3,Resign,White
FALSE,34,10+5,1500,1270,230,B01,2,Resign,Black
FALSE,27,5+8,1500,1270,230,B01,4,Mate,White
FALSE,29,10+0,1270,1523,-253,B21,3,Mate,White
FALSE,41,5+6,1399,1270,129,B01,2,Resign,White
TRUE,28,5+5,1274,1569,-295,C22,7,Resign,Black
FALSE,64,5+8,1500,1274,226,D20,4,Mate,Black
TRUE,24,5+8,1278,1568,-290,B01,4,Resign,Black
TRUE,87,5+8,1390,1286,104,B01,2,Mate,White
FALSE,51,10+5,1286,1426,-140,B00,5,Out of Time,White
TRUE,67,15+0,1312,1298,14,A01,2,Resign,White
TRUE,48,5+8,1305,1462,-157,C20,3,Resign,Black
FALSE,36,3+15,1305,1396,-91,D00,2,Resign,Black
FALSE,12,5+8,1305,1521,-216,C20,2,Resign,Black
TRUE,112,5+8,1483,1287,196,B01,4,Mate,Black
TRUE,115,3+8,1500,1292,208,A06,2,Mate,White
TRUE,76,5+8,1500,1272,228,D02,3,Mate,Black
TRUE,29,5+5,1253,1471,-218,C02,6,Mate,White
TRUE,77,8+8,1323,1263,60,A04,2,Resign,White
TRUE,46,5+8,1417,1271,146,D00,6,Resign,White
FALSE,55,180+0,1808,1191,617,A00,1,Mate,White
FALSE,65,180+0,1808,1191,617,A00,1,Mate,White
FALSE,144,180+0,1808,1191,617,B01,2,Mate,Black
FALSE,51,10+0,1808,1500,308,C44,5,Mate,White
FALSE,37,10+0,1808,1410,398,C41,6,Mate,White
FALSE,36,10+0,1500,1808,-308,A00,1,Mate,Black
FALSE,28,15+0,1808,1500,308,C55,6,Resign,White
FALSE,72,10+0,1191,1808,-617,A00,1,Mate,Black
FALSE,99,10+0,1808,1191,617,A46,5,Mate,White
FALSE,59,15+0,1500,1808,-308,C00,3,Resign,White
TRUE,53,10+0,1791,1983,-192,B08,9,Resign,White
TRUE,34,10+0,1437,1786,-349,D00,4,Resign,Black
TRUE,45,15+0,1782,1417,365,C55,6,Out of Time,White
TRUE,17,15+0,1766,1709,57,C40,4,Resign,White
TRUE,34,15+0,1500,1758,-258,B50,4,Resign,Black
TRUE,32,15+0,1777,1736,41,C00,3,Mate,Black
TRUE,35,15+0,1710,1790,-80,C40,4,Mate,White
TRUE,42,15+0,1805,1680,125,C00,2,Resign,Black
TRUE,55,15+0,1641,1959,-318,B01,4,Mate,White
TRUE,43,15+0,1586,1654,-68,C00,3,Resign,White
FALSE,2,15+0,1500,1586,-86,C20,2,Out of Time,Black
TRUE,38,15+0,1457,1567,-110,B20,2,Resign,Black
FALSE,60,15+0,1567,1500,67,B20,2,Mate,Black
FALSE,37,20+0,1645,1567,78,C41,5,Out of Time,White
TRUE,39,10+0,2274,1350,924,C00,4,Mate,White
TRUE,10,10+3,1406,1655,-249,D01,4,Resign,Black
TRUE,58,5+15,1998,1963,35,D35,6,Mate,Black
TRUE,43,15+8,1894,1961,-67,A30,2,Resign,White
TRUE,103,15+8,1923,1967,-44,A48,8,Resign,White
TRUE,59,5+8,1886,1862,24,A16,3,Resign,White
FALSE,146,40+2,1505,1743,-238,C53,7,Mate,Black
FALSE,84,40+2,1743,1505,238,B27,4,Resign,Black
TRUE,77,15+5,1994,1886,108,E15,8,Resign,White
TRUE,37,6+10,2014,1893,121,E15,8,Resign,White
TRUE,25,10+0,1748,1216,532,A10,2,Mate,White
TRUE,81,10+5,1087,1233,-146,A06,3,Mate,White
TRUE,38,10+3,1244,1297,-53,C40,4,Mate,Black
TRUE,43,10+3,1218,1841,-623,C45,8,Resign,White
TRUE,47,7+5,1662,1220,442,C40,4,Resign,White
TRUE,27,10+5,1405,1227,178,D00,3,Resign,White
FALSE,41,15+0,1227,1500,-273,C00,3,Out of Time,White
TRUE,40,10+5,1652,1229,423,B01,4,Resign,White
TRUE,61,10+0,1431,1235,196,B06,4,Resign,White
TRUE,71,10+5,1222,1240,-18,B10,2,Mate,White
TRUE,101,10+5,1183,1413,-230,C41,5,Out of Time,White
TRUE,2,10+5,1392,1183,209,D00,2,Out of Time,Black
TRUE,68,20+0,1500,1160,340,B00,2,Resign,Black
TRUE,49,10+0,1427,1165,262,B20,3,Resign,White
TRUE,77,10+5,1382,1170,212,B00,5,Resign,White
TRUE,93,15+10,1359,1177,182,B01,2,Resign,White
TRUE,23,10+5,1286,1160,126,B01,2,Resign,Black
TRUE,104,10+5,1160,1164,-4,B01,2,Draw,Draw
TRUE,44,10+5,1140,1346,-206,B07,4,Resign,White
TRUE,77,10+5,1451,1144,307,B06,2,Resign,White
TRUE,72,10+5,1148,1447,-299,A01,1,Mate,Black
TRUE,36,10+5,1443,1152,291,B10,2,Resign,White
TRUE,70,10+5,1156,1440,-284,C40,4,Resign,Black
TRUE,15,10+5,1328,1163,165,D00,3,Resign,White
TRUE,32,10+5,1145,1428,-283,D01,7,Mate,Black
TRUE,58,10+3,1154,1240,-86,B15,5,Mate,Black
TRUE,28,10+3,1441,1158,283,B00,2,Resign,White
TRUE,61,10+3,1150,1004,146,C40,4,Out of Time,White
TRUE,19,8+5,1157,1348,-191,B00,5,Resign,Black
TRUE,23,8+5,1342,1163,179,B06,2,Resign,White
TRUE,116,8+5,1173,1247,-74,B00,3,Mate,Black
TRUE,37,8+5,1426,1178,248,B15,6,Mate,White
TRUE,53,8+5,1397,1183,214,A40,2,Resign,White
TRUE,104,8+5,1189,1391,-202,A01,1,Mate,Black
TRUE,25,8+5,1434,1195,239,B06,4,Resign,White
TRUE,33,8+5,1201,1389,-188,B30,5,Resign,Black
TRUE,93,8+5,1298,1198,100,B00,2,Mate,White
TRUE,121,8+5,1477,1203,274,B02,2,Mate,White
TRUE,56,8+5,1208,1421,-213,B57,8,Mate,Black
TRUE,32,8+5,1214,1448,-234,A00,1,Resign,Black
TRUE,95,8+5,1443,1219,224,B06,2,Mate,White
FALSE,65,5+5,2076,1831,245,D45,10,Resign,White
FALSE,75,15+0,2119,2076,43,A45,3,Resign,Black
FALSE,100,15+0,2076,2119,-43,A21,4,Resign,Black
FALSE,70,15+0,2119,2076,43,B25,4,Resign,Black
FALSE,60,15+0,2076,2119,-43,A15,4,Mate,Black
FALSE,93,15+0,2119,2076,43,B30,4,Resign,White
FALSE,56,15+0,2076,1992,84,A09,4,Mate,Black
FALSE,97,15+0,1992,2076,-84,A03,2,Resign,Black
FALSE,36,15+0,1908,2076,-168,B21,3,Draw,Draw
FALSE,73,15+0,2076,1893,183,D12,8,Out of Time,White
FALSE,25,15+0,1879,2076,-197,A02,1,Resign,White
TRUE,84,15+0,2106,2031,75,D01,4,Out of Time,Black
TRUE,98,15+0,2029,2047,-18,A13,4,Draw,Draw
TRUE,68,20+7,2082,1970,112,A04,2,Resign,Black
FALSE,64,9+2,2082,1988,94,A04,2,Mate,Black
FALSE,133,10+8,1851,2082,-231,B45,10,Draw,Draw
TRUE,159,12+10,2040,1983,57,A04,2,Resign,White
TRUE,11,10+10,1978,2004,-26,A04,2,Out of Time,White
FALSE,22,5+6,1978,1979,-1,B01,6,Resign,Black
TRUE,75,60+0,1916,1887,29,A09,3,Resign,White
TRUE,81,60+0,1874,2020,-146,D02,8,Resign,White
FALSE,52,9+3,2020,2027,-7,A09,4,Mate,Black
FALSE,40,30+5,1904,2020,-116,B30,4,Mate,Black
FALSE,62,15+8,1935,2020,-85,A45,3,Resign,Black
FALSE,35,15+8,2020,1938,82,A21,4,Resign,White
FALSE,52,15+8,1938,2020,-82,B30,5,Resign,Black
FALSE,67,15+8,2020,1938,82,A09,4,Resign,White
FALSE,48,15+8,1938,2020,-82,B45,9,Resign,Black
FALSE,38,15+8,2020,1938,82,A09,3,Resign,Black
FALSE,75,15+10,2020,1985,35,A04,2,Resign,White
FALSE,65,25+30,2147,2020,127,B30,5,Resign,White
FALSE,32,12+10,2020,2160,-140,D45,9,Resign,White
FALSE,41,12+10,2160,2020,140,A30,2,Resign,White
TRUE,57,20+0,1950,1835,115,A27,5,Mate,White
TRUE,40,15+15,1514,1672,-158,A46,5,Resign,White
TRUE,74,10+0,1687,1557,130,C55,6,Resign,Black
TRUE,51,10+0,1684,1394,290,C55,6,Mate,White
TRUE,68,10+0,1687,1993,-306,C50,11,Resign,Black
TRUE,38,10+0,1280,1685,-405,B12,7,Resign,Black
TRUE,90,15+15,1780,1671,109,B44,8,Resign,Black
TRUE,99,15+15,1614,1673,-59,B45,9,Draw,Draw
TRUE,53,10+0,1680,1799,-119,B30,4,Resign,Black
TRUE,113,10+0,1748,1689,59,B20,3,Out of Time,White
TRUE,57,10+0,1700,1684,16,C46,7,Resign,Black
TRUE,54,10+0,1713,1658,55,C50,9,Resign,Black
TRUE,65,10+0,1699,1812,-113,C01,5,Mate,White
TRUE,25,10+0,1706,1839,-133,C42,5,Resign,Black
TRUE,114,10+0,1705,1709,-4,C50,9,Draw,Draw
TRUE,72,10+0,1893,1700,193,D12,8,Draw,Draw
TRUE,59,10+0,1718,1711,7,E20,6,Mate,White
TRUE,45,10+0,1700,1714,-14,C50,9,Resign,White
TRUE,10,10+0,1651,1690,-39,B20,3,Resign,Black
TRUE,49,10+0,1680,1661,19,B01,4,Resign,White
TRUE,115,10+0,1673,1510,163,C50,9,Resign,White
TRUE,45,10+0,1645,1686,-41,E20,5,Resign,White
TRUE,46,10+0,1573,1678,-105,B20,2,Resign,Black
TRUE,62,10+0,1688,1716,-28,D10,5,Resign,Black
TRUE,64,10+0,1699,1706,-7,C55,6,Mate,Black
TRUE,36,10+0,1598,1703,-105,B20,3,Resign,Black
TRUE,81,10+0,1692,1682,10,B57,11,Resign,White
TRUE,46,10+0,1524,1686,-162,B44,8,Mate,Black
TRUE,34,10+0,1753,1672,81,B20,3,Resign,Black
TRUE,113,10+0,1661,1653,8,C50,6,Mate,White
TRUE,92,10+0,1364,1657,-293,B21,5,Resign,Black
TRUE,53,10+0,1640,1881,-241,D30,4,Resign,White
TRUE,68,10+0,1624,1629,-5,E20,6,Mate,Black
TRUE,100,10+0,1641,1619,22,B07,3,Out of Time,Black
FALSE,69,8+0,1328,1500,-172,B02,4,Draw,Draw
FALSE,27,8+0,1328,1500,-172,C46,5,Resign,White
TRUE,27,10+0,1767,1330,437,B29,5,Resign,White
TRUE,15,10+0,2000,1331,669,B00,4,Mate,White
TRUE,46,10+0,1331,2043,-712,C00,3,Resign,Black
TRUE,60,10+0,1331,2209,-878,A40,2,Mate,Black
TRUE,24,10+0,1332,2043,-711,B40,4,Resign,Black
TRUE,67,10+0,1709,1334,375,B54,5,Out of Time,White
FALSE,37,10+0,1500,1334,166,C21,3,Resign,White
TRUE,50,15+0,1309,1347,-38,D00,3,Resign,White
TRUE,37,10+15,1256,1363,-107,B29,5,Mate,White
TRUE,24,10+0,1365,1751,-386,C62,6,Resign,Black
TRUE,54,10+0,1517,1346,171,B20,3,Mate,Black
TRUE,8,10+0,1348,1756,-408,C50,5,Resign,Black
TRUE,26,10+0,1351,1726,-375,B28,4,Resign,Black
TRUE,21,10+0,2078,1351,727,B20,5,Resign,White
TRUE,48,10+0,1352,2041,-689,B40,4,Mate,Black
TRUE,38,10+15,1361,1430,-69,C50,5,Mate,Black
TRUE,45,10+15,1349,1346,3,B11,4,Resign,White
TRUE,64,10+20,1284,1348,-64,D10,5,Draw,Draw
TRUE,19,10+20,1337,1297,40,C42,5,Mate,White
TRUE,27,10+15,1323,1340,-17,B02,4,Mate,White
TRUE,29,10+15,1319,1037,282,B02,3,Resign,White
TRUE,64,12+9,1117,1312,-195,A00,1,Mate,Black
TRUE,23,14+17,1153,1330,-177,B20,3,Resign,White
TRUE,23,14+17,1309,1317,-8,A43,4,Resign,Black
TRUE,45,14+20,1338,1314,24,A40,2,Mate,White
TRUE,50,14+20,1299,1378,-79,C00,5,Resign,White
FALSE,72,15+0,1464,1500,-36,C48,9,Mate,Black
TRUE,109,8+0,1639,1656,-17,B40,4,Out of Time,White
TRUE,35,15+0,1641,1490,151,A00,1,Mate,White
TRUE,63,15+0,1636,1260,376,A00,1,Mate,White
TRUE,20,20+0,1625,1378,247,A00,1,Resign,White
TRUE,59,5+5,1845,1638,207,B00,3,Mate,White
TRUE,64,5+5,1654,1839,-185,D45,9,Mate,Black
TRUE,70,5+5,1696,1563,133,A00,1,Mate,Black
TRUE,19,30+0,1584,1500,84,C46,5,Resign,White
TRUE,19,10+5,1470,1090,380,B00,3,Mate,White
TRUE,15,10+13,1221,1105,116,B00,2,Mate,White
TRUE,11,5+5,1199,1123,76,B00,2,Mate,White
TRUE,13,10+0,1122,1160,-38,B00,2,Mate,White
TRUE,11,15+3,1299,1176,123,B00,2,Mate,White
TRUE,55,15+5,1544,1528,16,B12,5,Resign,White
TRUE,94,10+2,1538,1564,-26,C00,3,Resign,Black
TRUE,41,10+0,1576,1548,28,C42,5,Mate,White
TRUE,28,10+0,1558,1610,-52,C21,3,Resign,Black
TRUE,69,15+15,1652,1566,86,C44,4,Resign,White
TRUE,112,10+0,1574,1678,-104,C41,5,Resign,Black
TRUE,54,10+0,1693,1559,134,D12,11,Mate,Black
TRUE,41,15+15,1564,1761,-197,C50,8,Resign,Black
TRUE,77,10+15,1452,1579,-127,B07,4,Mate,White
TRUE,83,10+15,1571,1459,112,B32,8,Resign,White
TRUE,51,10+15,1330,1590,-260,A06,2,Resign,White
TRUE,82,10+0,1408,1584,-176,C30,3,Mate,Black
TRUE,24,10+0,1595,1581,14,C45,10,Resign,Black
TRUE,66,10+0,1606,1637,-31,C44,5,Resign,Black
TRUE,26,10+0,1650,1592,58,B07,4,Resign,Black
TRUE,106,8+0,1451,1585,-134,D00,3,Mate,Black
TRUE,89,10+0,1604,1306,298,C40,4,Resign,Black
TRUE,45,15+0,1565,1594,-29,B00,5,Resign,Black
TRUE,37,15+0,1584,1545,39,C47,7,Mate,White
TRUE,78,10+0,1593,1654,-61,C50,6,Out of Time,Black
TRUE,84,10+0,1810,1575,235,D40,9,Resign,Black
TRUE,115,10+0,1567,1473,94,C27,3,Mate,White
TRUE,56,10+0,1976,1569,407,C30,4,Resign,White
TRUE,64,15+0,1576,1719,-143,B30,4,Resign,Black
TRUE,23,15+0,1494,1589,-95,A21,3,Resign,White
TRUE,67,30+0,1576,1635,-59,B00,6,Resign,White
TRUE,94,10+0,1857,1852,5,C01,5,Mate,Black
TRUE,94,15+5,1868,1675,193,C00,3,Resign,Black
TRUE,32,15+5,1681,1862,-181,C02,8,Resign,Black
FALSE,42,10+0,1319,2296,-977,C20,3,Mate,Black
FALSE,35,10+0,2296,1319,977,C23,3,Mate,White
FALSE,44,10+0,1319,2296,-977,C20,3,Mate,Black
FALSE,41,10+0,2296,1319,977,C60,5,Mate,White
TRUE,57,10+0,2294,1742,552,B27,6,Resign,White
FALSE,48,10+0,1319,2294,-975,D00,3,Mate,Black
FALSE,39,10+0,2294,1319,975,C60,5,Mate,White
FALSE,32,10+0,1319,2294,-975,A45,2,Mate,Black
FALSE,19,10+0,2294,1319,975,C45,7,Mate,White
FALSE,35,10+0,2294,1319,975,C40,4,Mate,White
FALSE,32,10+0,1319,2294,-975,D02,4,Mate,Black
FALSE,9,10+0,2294,1319,975,C42,6,Mate,White
FALSE,27,30+8,1500,1016,484,B02,2,Mate,White
FALSE,54,10+0,1016,1016,0,C28,6,Mate,Black
FALSE,29,20+0,1326,1016,310,B02,4,Mate,White
FALSE,80,20+0,1016,1326,-310,A04,2,Mate,Black
FALSE,85,15+15,1446,1016,430,B00,3,Mate,White
FALSE,41,15+0,1357,1016,341,D02,4,Mate,White
FALSE,36,15+0,1016,1357,-341,A00,2,Mate,Black
FALSE,8,20+0,1371,1016,355,A45,2,Resign,White
FALSE,57,20+1,1500,1016,484,B02,2,Mate,White
FALSE,64,30+8,1016,1230,-214,A04,2,Resign,White
FALSE,77,15+10,1060,1016,44,B02,3,Mate,White
FALSE,3,15+0,1016,1608,-592,A04,2,Resign,Black
FALSE,47,9+1,1683,1016,667,B02,4,Mate,White
FALSE,54,5+8,1016,1766,-750,D02,4,Mate,Black
FALSE,35,5+8,1500,1016,484,B00,3,Mate,White
FALSE,61,10+0,1702,1016,686,B02,6,Mate,White
FALSE,13,10+0,1702,1016,686,B02,6,Resign,White
FALSE,32,5+8,1500,1016,484,A04,2,Out of Time,Black
FALSE,46,30+9,1016,1119,-103,D02,4,Mate,Black
FALSE,40,15+0,1016,2621,-1605,A00,1,Mate,Black
FALSE,48,10+0,1016,2621,-1605,A48,5,Mate,Black
TRUE,61,10+0,1898,1017,881,B02,4,Mate,White
TRUE,2,15+15,1034,1353,-319,A04,2,Out of Time,Black
FALSE,48,15+0,1222,1400,-178,B01,2,Mate,Black
TRUE,41,20+5,1361,1293,68,C41,4,Mate,White
TRUE,26,5+8,1309,1770,-461,C00,2,Mate,Black
TRUE,71,5+5,1415,1472,-57,C00,2,Resign,Black
TRUE,79,10+0,1730,1500,230,A00,1,Mate,White
FALSE,25,30+0,1543,1517,26,C50,8,Resign,Black
FALSE,57,30+0,1517,1420,97,D30,4,Resign,White
FALSE,25,30+0,1420,1517,-97,B00,3,Resign,White
TRUE,51,15+0,1467,1530,-63,A48,5,Resign,White
FALSE,47,30+0,1530,1413,117,B44,8,Mate,White
FALSE,34,20+0,1530,1547,-17,C44,7,Resign,Black
FALSE,39,20+0,1547,1530,17,A40,1,Resign,White
FALSE,78,20+0,1530,1516,14,B00,2,Resign,Black
FALSE,45,20+0,1530,1503,27,D30,4,Resign,White
FALSE,54,20+0,1530,1529,1,C44,7,Resign,Black
FALSE,38,20+0,1529,1530,-1,E90,11,Resign,Black
TRUE,96,180+180,1530,1543,-13,A40,2,Draw,Draw
TRUE,60,15+0,1543,1518,25,A00,1,Resign,Black
FALSE,53,20+0,1436,1518,-82,B20,3,Mate,White
FALSE,30,20+0,1518,1593,-75,B06,2,Resign,Black
FALSE,99,20+0,1516,1518,-2,B28,5,Mate,White
TRUE,70,10+0,1669,1502,167,D06,4,Mate,Black
TRUE,53,10+0,1503,2041,-538,C01,7,Resign,Black
TRUE,53,10+0,1487,1685,-198,B10,2,Mate,White
TRUE,75,10+0,1472,1593,-121,C40,3,Out of Time,White
FALSE,35,10+0,1503,1472,31,C00,4,Mate,White
FALSE,53,10+0,1500,1472,28,C00,4,Resign,White
TRUE,136,10+0,1401,1618,-217,A00,1,Out of Time,Black
TRUE,74,10+0,1632,1533,99,C46,5,Resign,Black
TRUE,45,10+0,1530,1635,-105,B13,5,Draw,Draw
TRUE,50,10+0,1654,1368,286,C44,5,Resign,Black
TRUE,95,10+0,1647,1531,116,C46,5,Resign,White
TRUE,154,10+0,1494,1640,-146,A07,3,Resign,Black
TRUE,108,10+0,1539,1632,-93,C41,4,Resign,Black
TRUE,118,10+0,1820,1616,204,D15,7,Out of Time,Draw
TRUE,109,10+0,1606,1594,12,C46,6,Mate,White
TRUE,55,10+0,1594,1608,-14,D30,4,Resign,White
TRUE,115,10+0,1621,1605,16,D00,3,Mate,White
FALSE,43,30+4,1605,1593,12,C50,7,Resign,Black
TRUE,100,10+0,1589,1928,-339,B50,4,Mate,Black
TRUE,39,10+0,1581,1493,88,B02,3,Resign,White
TRUE,36,10+0,1523,1571,-48,B10,3,Resign,Black
TRUE,10,10+0,1248,1568,-320,D01,4,Resign,Black
TRUE,59,10+0,1564,1318,246,B01,4,Mate,White
TRUE,92,10+0,1582,1590,-8,C41,4,Resign,Black
TRUE,210,10+0,1600,1571,29,C41,4,Mate,Black
TRUE,83,10+0,1555,1711,-156,B25,4,Mate,White
FALSE,29,10+25,2621,1555,1066,B15,10,Out of Time,White
TRUE,120,10+0,1584,1543,41,C41,4,Mate,Black
TRUE,147,10+0,1536,1500,36,B00,5,Mate,White
TRUE,45,30+0,1594,1545,49,B17,8,Mate,White
TRUE,63,20+0,1546,1522,24,C41,4,Draw,Draw
TRUE,71,10+0,1575,1566,9,B50,4,Resign,White
TRUE,116,20+0,1562,1554,8,C41,4,Mate,Black
TRUE,40,20+0,1567,1520,47,D35,6,Resign,Black
FALSE,73,15+0,1500,1567,-67,D31,5,Out of Time,White
TRUE,107,10+0,1566,1585,-19,C46,6,Draw,Draw
FALSE,2,30+20,2430,1566,864,B10,2,Resign,White
TRUE,72,10+0,1538,1556,-18,A00,1,Mate,Black
TRUE,45,30+10,2209,2102,107,C63,6,Resign,White
TRUE,84,30+10,1988,2199,-211,E77,15,Resign,Black
TRUE,71,30+10,2179,2154,25,A48,5,Resign,White
TRUE,66,30+10,2164,2157,7,B12,5,Resign,Black
TRUE,82,30+10,2181,2153,28,B50,4,Resign,Black
TRUE,39,15+0,2148,2274,-126,A48,5,Resign,White
TRUE,64,15+5,2262,2111,151,B19,15,Resign,Black
TRUE,89,30+10,2098,1897,201,D00,3,Resign,White
TRUE,51,15+5,2022,2080,-58,E70,9,Resign,Black
TRUE,74,15+5,2114,2042,72,D21,6,Resign,Black
TRUE,108,15+5,1956,2093,-137,A00,2,Mate,Black
TRUE,132,15+5,2109,1913,196,A40,2,Draw,Draw
TRUE,36,15+5,2151,2063,88,D02,4,Resign,Black
TRUE,83,15+5,1946,2211,-265,B13,5,Mate,White
TRUE,63,15+0,2214,2187,27,D45,9,Draw,Draw
TRUE,75,15+5,2173,2118,55,B01,8,Resign,White
TRUE,77,20+5,2175,2231,-56,A45,2,Resign,White
TRUE,66,10+5,2239,2151,88,B12,6,Out of Time,Black
TRUE,82,10+0,2250,2091,159,D30,4,Out of Time,Black
TRUE,90,5+8,2120,2170,-50,B13,9,Resign,Black
TRUE,99,5+5,2148,2213,-65,A46,5,Draw,Draw
TRUE,70,7+8,1887,2045,-158,B00,3,Resign,Black
TRUE,41,5+8,1500,1973,-473,A46,5,Out of Time,White
TRUE,7,19+0,1689,1135,554,B00,2,Mate,White
TRUE,7,19+0,1686,1139,547,B00,2,Mate,White
TRUE,7,9+0,1693,1144,549,B00,2,Mate,White
TRUE,7,9+0,1690,1149,541,B00,2,Mate,White
TRUE,7,19+0,1737,1154,583,B00,2,Mate,White
TRUE,7,5+180,1630,1161,469,B00,2,Mate,White
FALSE,52,10+0,1987,1749,238,D50,7,Mate,Black
FALSE,49,15+5,1987,1548,439,C42,5,Mate,White
FALSE,81,10+0,1987,1500,487,D50,7,Draw,Draw
FALSE,46,10+2,1500,1987,-487,C55,7,Mate,Black
FALSE,3,20+15,1987,1568,419,A00,2,Resign,Black
FALSE,94,20+15,1568,1987,-419,A43,2,Resign,White
FALSE,22,20+15,1568,1987,-419,D20,6,Resign,White
FALSE,117,20+15,1987,1568,419,C41,7,Mate,White
FALSE,106,15+0,1568,1987,-419,A40,3,Mate,Black
FALSE,21,15+0,1987,1568,419,C42,7,Mate,White
FALSE,48,15+0,1568,1987,-419,D00,2,Mate,Black
FALSE,4,15+10,1987,1500,487,C44,4,Out of Time,Black
FALSE,31,10+0,1987,1500,487,B20,3,Resign,Black
FALSE,27,10+20,1987,1568,419,C42,7,Resign,Black
FALSE,31,10+20,1987,1560,427,C42,7,Resign,Black
FALSE,56,15+20,1519,1987,-468,D00,3,Resign,White
FALSE,59,10+0,1987,1500,487,D20,4,Mate,White
FALSE,54,10+0,1559,1987,-428,D02,4,Resign,White
TRUE,53,7+9,1789,1843,-54,A45,5,Resign,White
TRUE,29,10+0,1707,1858,-151,C46,5,Resign,White
TRUE,56,5+13,1872,1777,95,C03,5,Resign,Black
FALSE,12,30+45,1423,1799,-376,A00,1,Out of Time,Black
TRUE,58,10+2,1404,1515,-111,B06,6,Mate,Black
FALSE,14,20+0,1500,1404,96,C25,4,Resign,Black
TRUE,57,10+11,1667,1404,263,D21,5,Mate,White
FALSE,124,8+0,1404,1637,-233,C20,3,Mate,Black
FALSE,30,10+0,1404,1312,92,C20,3,Resign,White
FALSE,22,10+0,1312,1404,-92,C45,7,Resign,Black
FALSE,92,25+4,1404,1341,63,B00,3,Resign,White
TRUE,72,20+0,1749,1404,345,C22,7,Resign,Black
TRUE,18,20+0,1749,1404,345,C21,3,Resign,Black
FALSE,1,5+15,2100,1404,696,B00,1,Out of Time,White
TRUE,54,5+8,2009,1404,605,C65,6,Resign,Black
TRUE,43,10+0,1643,1355,288,B20,3,Resign,White
TRUE,21,10+0,1368,1512,-144,C55,6,Resign,White
TRUE,31,15+0,1500,1524,-24,D07,4,Draw,Draw
TRUE,22,10+10,1858,1837,21,B21,5,Resign,White
TRUE,119,10+10,1852,1836,16,B30,4,Draw,Draw
TRUE,41,10+5,1847,1835,12,A40,2,Resign,Black
TRUE,77,15+15,1838,1798,40,D00,3,Mate,White
TRUE,56,5+6,1892,1825,67,A42,5,Resign,Black
TRUE,60,20+0,1836,1814,22,A30,2,Resign,Black
TRUE,66,10+5,1826,1802,24,D10,6,Out of Time,Black
TRUE,45,6+8,1793,1768,25,D00,3,Resign,White
TRUE,57,15+0,1751,1805,-54,B20,3,Mate,White
TRUE,66,8+8,1814,1878,-64,A45,2,Resign,Black
TRUE,104,10+13,1813,1850,-37,A80,2,Draw,Draw
TRUE,55,10+0,1837,1823,14,B32,7,Mate,White
TRUE,24,10+0,1839,1632,207,A80,2,Resign,Black
TRUE,86,10+0,1853,1778,75,A40,2,Mate,Black
TRUE,107,10+0,1874,1863,11,D02,3,Out of Time,White
TRUE,37,10+0,1873,1905,-32,A40,2,Resign,Black
TRUE,36,10+0,1575,1869,-294,B30,4,Resign,Black
TRUE,78,10+0,1818,1860,-42,D00,4,Resign,Black
TRUE,140,10+0,1922,1847,75,D12,11,Mate,Black
TRUE,117,10+0,1839,1743,96,A45,2,Out of Time,White
TRUE,84,10+0,1857,1565,292,A40,2,Out of Time,Black
TRUE,63,10+0,1868,1874,-6,D00,3,Resign,Black
TRUE,96,10+0,1879,1844,35,A41,2,Resign,Black
TRUE,106,10+0,1912,1867,45,D10,4,Out of Time,Black
TRUE,71,10+0,1609,1880,-271,B30,4,Resign,White
TRUE,60,10+0,1893,1830,63,A40,2,Resign,Black
TRUE,63,10+0,1962,1901,61,B50,4,Resign,White
TRUE,40,15+15,1708,1918,-210,B50,4,Resign,White
TRUE,47,10+0,1907,1906,1,A45,2,Resign,White
TRUE,50,10+0,1979,1905,74,D02,3,Draw,Draw
TRUE,40,10+0,1916,1907,9,A45,2,Resign,Black
TRUE,53,10+0,1904,1938,-34,A40,2,Resign,White
TRUE,41,10+0,1964,1913,51,B20,3,Resign,White
TRUE,131,10+0,1904,1862,42,D00,3,Mate,White
TRUE,104,10+0,1847,1895,-48,B54,6,Out of Time,Black
TRUE,48,10+0,1908,1832,76,D00,3,Resign,Black
TRUE,113,10+0,1900,1794,106,A40,6,Resign,White
TRUE,43,10+0,2018,1908,110,D00,10,Resign,White
TRUE,40,10+0,1786,1900,-114,B21,3,Resign,Black
TRUE,54,10+0,1847,1891,-44,B32,7,Mate,Black
TRUE,31,10+0,1881,1857,24,A40,2,Resign,White
TRUE,40,10+0,1831,1872,-41,D12,8,Mate,Black
TRUE,61,10+0,1862,1825,37,A40,2,Resign,White
TRUE,34,10+0,1874,1837,37,D00,3,Resign,Black
FALSE,116,15+5,1319,1739,-420,B57,8,Mate,Black
FALSE,31,15+5,1739,1319,420,B10,2,Mate,White
FALSE,4,25+0,1589,1739,-150,B50,4,Resign,White
FALSE,58,15+5,1500,1739,-239,A00,1,Mate,Black
FALSE,57,15+5,1739,1500,239,B00,2,Mate,White
FALSE,52,15+5,1500,1739,-239,A00,1,Mate,Black
FALSE,79,10+2,1342,1449,-107,C41,5,Resign,Black
FALSE,31,10+2,1605,1342,263,B54,5,Resign,White
TRUE,83,10+0,1629,1476,153,D02,4,Resign,Black
TRUE,49,10+5,1629,1047,582,D30,4,Mate,White
TRUE,103,15+0,1627,1148,479,C69,9,Mate,White
TRUE,105,10+0,1617,1575,42,D06,4,Resign,White
TRUE,52,10+0,1509,1609,-100,D02,5,Resign,Black
FALSE,53,60+10,2334,1453,881,B44,8,Out of Time,White
FALSE,73,15+0,1500,1453,47,B20,3,Resign,White
TRUE,51,10+0,1461,1567,-106,C41,6,Resign,Black
FALSE,90,15+0,1133,1461,-328,B20,3,Resign,Black
TRUE,78,15+0,1477,1297,180,A41,3,Resign,Black
TRUE,70,15+0,1303,1471,-168,B21,3,Resign,Black
TRUE,33,15+0,1464,1310,154,B32,6,Resign,White
TRUE,27,10+4,1456,1366,90,C40,3,Resign,White
TRUE,40,8+0,1385,1470,-85,B20,2,Resign,White
FALSE,53,30+0,1299,1470,-171,B45,9,Resign,Black
TRUE,118,10+0,1453,1482,-29,A06,3,Resign,White
TRUE,75,10+0,1467,1594,-127,B12,5,Resign,White
TRUE,83,10+0,1613,1474,139,B21,3,Resign,White
FALSE,59,8+3,1474,1500,-26,B00,4,Mate,White
TRUE,79,25+1,1466,1358,108,C57,11,Resign,White
FALSE,28,15+0,1047,1466,-419,A00,1,Resign,White
TRUE,66,10+0,1380,1457,-77,B44,8,Resign,Black
TRUE,68,60+0,1468,1489,-21,C43,6,Resign,Black
TRUE,43,60+0,1462,1320,142,C61,6,Mate,White
FALSE,34,20+0,1161,1462,-301,A46,5,Resign,Black
TRUE,46,15+0,1305,1455,-150,A45,3,Resign,Black
TRUE,43,10+0,1343,1470,-127,A45,2,Resign,White
TRUE,49,10+0,1461,1398,63,C40,4,Resign,White
TRUE,68,8+10,1502,1368,134,D04,5,Mate,Black
TRUE,66,12+4,1517,1512,5,C02,10,Resign,White
TRUE,73,12+4,1546,1523,23,D35,7,Resign,White
TRUE,56,11+4,1533,1511,22,C00,3,Resign,Black
TRUE,42,11+4,1522,1523,-1,D02,4,Resign,Black
TRUE,24,11+4,1534,1510,24,C00,6,Resign,Black
TRUE,36,11+4,1524,1414,110,D02,3,Resign,Black
TRUE,59,11+4,1514,1489,25,D04,5,Out of Time,White
TRUE,73,8+7,1526,1525,1,C02,7,Resign,White
FALSE,60,10+9,1525,1574,-49,D02,3,Resign,Black
FALSE,23,5+8,1533,1525,8,A40,2,Resign,White
FALSE,78,5+8,1525,1533,-8,D02,3,Resign,Black
FALSE,69,5+5,1596,1525,71,D32,8,Mate,White
FALSE,53,5+5,1630,1525,105,D40,8,Mate,White
FALSE,33,12+0,1536,1651,-115,C44,5,Out of Time,White
TRUE,33,8+0,1500,1547,-47,B07,2,Resign,White
TRUE,110,8+0,1567,1456,111,C44,5,Mate,Black
TRUE,57,5+5,1553,1485,68,C41,4,Resign,White
FALSE,50,8+0,1500,1553,-53,B10,2,Mate,Black
TRUE,77,10+10,1514,1571,-57,B10,2,Resign,White
FALSE,59,5+8,1610,1571,39,B10,2,Resign,White
FALSE,73,8+8,1418,1571,-153,A40,1,Resign,White
TRUE,78,8+1,1450,1558,-108,B10,3,Out of Time,Black
TRUE,81,15+8,1430,1581,-151,B12,3,Resign,White
FALSE,44,0+15,1169,1571,-402,A00,1,Resign,Black
TRUE,36,11+0,1501,1255,246,C01,5,Draw,Draw
TRUE,48,11+0,1261,1697,-436,B01,6,Out of Time,Black
TRUE,16,11+0,1269,1625,-356,B01,2,Resign,Black
TRUE,24,10+10,1276,1675,-399,B46,10,Resign,Black
TRUE,90,10+0,1287,1611,-324,B27,4,Mate,Black
TRUE,48,8+0,1312,1448,-136,C55,6,Resign,Black
TRUE,13,8+0,1173,1336,-163,B06,2,Mate,White
TRUE,20,9+0,1391,1202,189,B20,2,Resign,White
TRUE,33,9+0,1244,1384,-140,C40,4,Resign,Black
TRUE,9,9+0,1443,1291,152,A00,1,Resign,White
TRUE,80,15+0,1388,1390,-2,C57,11,Mate,Black
TRUE,84,16+0,1433,1315,118,C50,5,Draw,Draw
TRUE,111,60+0,1803,1500,303,B20,3,Mate,White
FALSE,26,13+0,1500,1355,145,C42,5,Resign,Black
TRUE,38,10+10,1506,1505,1,A21,3,Resign,White
TRUE,79,10+10,1488,1466,22,A10,2,Resign,White
FALSE,43,15+5,1488,1282,206,A22,4,Resign,White
TRUE,117,6+10,1434,1505,-71,A06,2,Mate,White
TRUE,29,20+0,1491,1377,114,C55,6,Resign,White
FALSE,74,10+0,1491,1500,-9,C41,6,Out of Time,Black
FALSE,21,7+5,1483,1305,178,C51,7,Mate,White
FALSE,121,7+5,1483,1213,270,B12,3,Mate,White
TRUE,85,7+5,1478,1129,349,C42,5,Mate,White
FALSE,14,4+10,1209,1478,-269,A43,2,Resign,Black
FALSE,62,7+5,1312,1478,-166,A07,4,Resign,Black
TRUE,43,10+5,1618,1652,-34,C50,8,Mate,White
FALSE,55,10+10,1515,1652,-137,C00,4,Resign,White
FALSE,40,10+10,1500,1652,-152,A00,1,Resign,Black
FALSE,47,10+10,1120,1652,-532,D00,4,Resign,Black
FALSE,26,10+10,1652,1120,532,A45,2,Draw,Draw
FALSE,86,5+10,1652,1646,6,B00,6,Resign,Black
FALSE,26,5+10,1450,1652,-202,A45,2,Resign,Black
TRUE,58,7+2,1657,1927,-270,C50,6,Out of Time,Black
TRUE,14,10+0,1669,1717,-48,C50,6,Resign,Black
TRUE,50,10+5,1565,1659,-94,B07,2,Resign,Black
TRUE,30,10+5,1037,1658,-621,A06,3,Resign,Black
TRUE,90,10+5,1671,1709,-38,C55,6,Out of Time,Black
TRUE,82,5+5,1487,1663,-176,B20,3,Out of Time,Black
TRUE,14,5+5,1670,1881,-211,C62,6,Resign,Black
FALSE,87,7+2,1884,1670,214,E40,7,Out of Time,White
FALSE,111,7+2,1828,1670,158,E20,8,Mate,White
FALSE,73,7+2,1670,1543,127,C62,6,Resign,Black
FALSE,54,7+2,1670,1884,-214,D45,9,Resign,Black
FALSE,44,7+2,1670,1966,-296,D20,5,Resign,Black
FALSE,74,7+2,1497,1670,-173,A00,1,Resign,Black
FALSE,39,15+5,1670,1778,-108,C45,9,Resign,Black
TRUE,49,15+15,1659,1543,116,A22,4,Resign,White
TRUE,72,15+15,1673,1717,-44,D30,4,Mate,Black
TRUE,72,8+0,1640,1521,119,A06,3,Out of Time,Black
TRUE,17,5+5,1645,1334,311,A04,2,Mate,White
TRUE,38,5+5,1386,1640,-254,A02,2,Mate,Black
TRUE,19,5+5,1634,1500,134,A04,2,Mate,White
TRUE,124,5+9,1648,1552,96,A06,3,Resign,Black
TRUE,122,5+5,1501,1640,-139,B02,7,Mate,Black
TRUE,60,10+0,1723,1642,81,B00,2,Resign,Black
TRUE,26,15+0,2163,2012,151,A80,2,Resign,Black
TRUE,25,15+0,2094,2163,-69,C65,6,Resign,White
TRUE,85,15+0,2153,2148,5,A85,5,Resign,White
TRUE,54,15+0,2082,2144,-62,C53,9,Resign,Black
TRUE,81,15+0,2136,2039,97,E61,6,Resign,White
TRUE,48,15+0,2136,2353,-217,D34,18,Resign,Black
TRUE,124,15+0,2133,2124,9,C67,8,Out of Time,Black
TRUE,23,15+0,2401,2128,273,C11,13,Resign,White
FALSE,61,15+2,1800,2128,-328,E61,6,Resign,White
TRUE,78,15+0,2144,2001,143,D30,4,Resign,Black
TRUE,122,15+0,2145,2588,-443,E64,12,Out of Time,Black
TRUE,126,2+15,1437,1370,67,C41,4,Resign,Black
FALSE,29,10+5,1500,1437,63,C68,8,Mate,White
TRUE,26,6+5,1427,1389,38,C64,6,Resign,Black
TRUE,114,6+5,1383,1428,-45,C26,5,Draw,Draw
TRUE,17,6+5,1417,1435,-18,C65,6,Mate,White
TRUE,71,10+15,1681,1796,-115,C02,7,Resign,Black
TRUE,41,60+5,1806,1786,20,D30,4,Resign,Black
TRUE,38,5+8,1739,1797,-58,D31,6,Resign,Black
TRUE,37,10+2,1782,1884,-102,A40,2,Mate,White
TRUE,87,10+5,1879,1790,89,C17,8,Resign,White
TRUE,91,5+8,1775,1801,-26,A22,4,Resign,White
TRUE,41,15+1,1884,1809,75,C00,3,Resign,White
TRUE,69,5+5,1812,1811,1,A00,4,Resign,White
TRUE,24,9+11,1738,1801,-63,C02,10,Resign,Black
TRUE,99,11+11,1881,1810,71,C01,5,Resign,White
TRUE,24,1+15,1696,1824,-128,D24,13,Resign,White
TRUE,82,5+5,1832,1873,-41,A40,2,Mate,Black
TRUE,70,15+10,1841,1908,-67,A40,2,Resign,Black
TRUE,48,10+0,1658,1835,-177,C00,3,Mate,Black
TRUE,39,10+0,1822,1851,-29,D12,8,Resign,White
TRUE,125,7+2,1756,1835,-79,C00,3,Resign,White
TRUE,58,30+0,1848,1773,75,E61,12,Resign,Black
TRUE,86,12+3,1858,1888,-30,D45,10,Resign,Black
TRUE,50,2+10,1948,1842,106,C00,3,Resign,Black
TRUE,20,15+3,1955,1850,105,C15,7,Resign,White
TRUE,44,10+0,1862,1823,39,D20,5,Resign,Black
TRUE,40,6+4,1748,1853,-105,D01,4,Resign,Black
TRUE,38,2+10,1820,1842,-22,A00,7,Mate,Black
TRUE,96,8+0,1850,1923,-73,A40,2,Resign,Black
TRUE,100,5+5,1782,1864,-82,C00,2,Resign,White
TRUE,55,8+0,1858,1674,184,E61,5,Resign,White
TRUE,32,5+5,1963,1866,97,C17,9,Resign,White
TRUE,44,15+0,1868,2220,-352,D30,10,Resign,Black
TRUE,37,5+5,2048,1875,173,C00,2,Resign,White
TRUE,87,2+16,1859,1946,-87,A40,2,Resign,White
TRUE,58,7+3,1888,1846,42,C00,3,Resign,Black
TRUE,40,20+0,1859,1798,61,D10,4,Resign,Black
TRUE,118,12+10,1838,1846,-8,D00,3,Resign,Black
TRUE,65,6+5,1828,2012,-184,E51,10,Resign,White
TRUE,92,15+0,1877,1813,64,C01,7,Resign,Black
TRUE,50,15+0,1823,1868,-45,E14,7,Mate,Black
TRUE,63,14+0,1938,1831,107,D15,7,Resign,White
FALSE,79,60+0,1831,1764,67,A54,6,Resign,White
FALSE,103,2+10,2048,1831,217,D31,6,Resign,White
FALSE,65,2+10,1831,2048,-217,A40,2,Mate,White
FALSE,26,2+10,2048,1831,217,D10,5,Resign,White
TRUE,135,20+3,1765,1846,-81,A40,3,Mate,White
TRUE,90,13+5,1784,1834,-50,D00,3,Resign,Black
TRUE,153,15+0,1817,1911,-94,A40,1,Mate,White
TRUE,61,10+0,1878,1801,77,C02,7,Resign,Black
TRUE,59,8+0,1850,1812,38,C00,3,Mate,White
FALSE,42,8+0,2018,1812,206,A22,4,Resign,Black
TRUE,76,10+0,1908,1821,87,C00,3,Resign,White
TRUE,17,30+0,1147,1158,-11,D20,4,Resign,Black
TRUE,25,10+0,1845,1189,656,B06,2,Out of Time,White
TRUE,40,30+0,1271,1703,-432,C21,10,Resign,Black
TRUE,53,7+2,1439,1341,98,C68,8,Resign,White
TRUE,55,30+0,1697,1378,319,C46,6,Mate,White
TRUE,176,30+0,1440,1693,-253,C21,5,Mate,Black
TRUE,27,15+0,1836,1500,336,C40,4,Mate,White
TRUE,61,20+8,1478,1295,183,C41,4,Mate,White
TRUE,122,15+10,1303,1284,19,C41,5,Resign,Black
TRUE,46,10+10,1292,1358,-66,D04,5,Mate,Black
TRUE,56,15+0,1303,1307,-4,A40,2,Mate,Black
TRUE,73,15+10,1333,1318,15,C41,8,Mate,White
TRUE,144,20+0,1327,1388,-61,D00,3,Out of Time,Black
TRUE,43,20+4,1500,1332,168,C41,5,Mate,White
TRUE,33,10+5,1391,1342,49,C41,5,Mate,White
TRUE,71,15+0,1494,1348,146,C30,3,Mate,White
TRUE,69,5+5,1338,1322,16,D00,3,Resign,White
TRUE,45,5+5,1337,1458,-121,A80,2,Resign,White
TRUE,95,25+0,1374,1347,27,C41,4,Mate,White
TRUE,47,15+1,1336,1337,-1,D00,3,Resign,White
TRUE,115,5+5,1437,1333,104,C41,5,Draw,Draw
TRUE,14,15+0,1422,1336,86,C23,3,Resign,Black
TRUE,21,15+0,1325,1353,-28,D04,5,Resign,White
TRUE,64,20+0,1334,1384,-50,D04,5,Mate,Black
TRUE,46,8+0,1478,1319,159,C41,4,Resign,Black
TRUE,35,10+2,1308,1330,-22,C41,4,Mate,White
TRUE,6,7+3,1344,1221,123,D04,5,Resign,Black
TRUE,90,12+5,1351,1459,-108,D00,3,Mate,Black
TRUE,44,15+0,1443,1337,106,C41,4,Resign,Black
TRUE,67,5+8,1579,1331,248,C23,3,Draw,Draw
TRUE,17,8+0,1445,1338,107,C41,5,Mate,White
TRUE,79,8+0,1426,1347,79,D00,3,Mate,White
TRUE,50,8+0,1355,1418,-63,D05,6,Resign,Black
TRUE,108,8+0,1365,1409,-44,A40,2,Resign,Black
FALSE,96,8+0,1267,1365,-98,C41,4,Mate,Black
TRUE,43,10+4,1365,1376,-11,C34,6,Out of Time,White
TRUE,61,15+0,1347,1374,-27,C41,5,Mate,White
TRUE,21,8+10,1384,1395,-11,D05,7,Resign,Black
TRUE,80,10+0,1346,1397,-51,B01,4,Resign,White
TRUE,104,10+7,1408,1374,34,A40,2,Mate,Black
TRUE,64,8+0,1372,1398,-26,C41,4,Resign,Black
TRUE,40,8+0,1382,1388,-6,C41,5,Resign,Black
TRUE,94,15+0,1381,1377,4,C41,4,Resign,Black
TRUE,43,8+0,1381,1646,-265,D05,7,Resign,Black
TRUE,82,40+1,1384,1658,-274,D00,3,Resign,Black
TRUE,58,5+5,1688,1388,300,C41,4,Resign,White
TRUE,26,25+0,1584,1371,213,C20,3,Resign,Black
FALSE,104,45+0,1500,2048,-548,A00,1,Mate,Black
FALSE,11,45+0,2048,1500,548,B07,2,Mate,White
FALSE,5,45+0,1500,2048,-548,B02,3,Resign,White
FALSE,26,30+0,1500,2048,-548,A45,2,Mate,Black
TRUE,73,15+5,1647,1647,0,B01,8,Draw,Draw
TRUE,120,15+15,1677,1635,42,D15,9,Mate,Black
TRUE,62,15+15,1645,1649,-4,B10,2,Resign,Black
TRUE,57,15+0,1788,1652,136,B21,3,Resign,White
TRUE,34,15+5,1683,1640,43,B50,4,Resign,Black
TRUE,70,15+15,1651,1650,1,C41,7,Resign,Black
TRUE,39,15+5,1661,1661,0,A30,2,Resign,White
TRUE,18,15+15,1661,1661,0,B50,4,Draw,Draw
TRUE,82,10+0,1673,1603,70,B02,2,Out of Time,Black
TRUE,22,10+0,1658,1663,-5,D12,8,Mate,Black
TRUE,90,10+0,1673,1729,-56,A38,10,Out of Time,Black
TRUE,51,10+0,1666,1553,113,A15,2,Resign,White
TRUE,49,10+0,1647,1678,-31,B50,4,Resign,White
TRUE,61,10+0,1799,1684,115,B50,4,Out of Time,White
TRUE,61,10+0,1500,1694,-194,B50,4,Out of Time,White
TRUE,54,10+0,1703,1735,-32,A20,2,Resign,Black
TRUE,74,15+10,1828,1715,113,B94,11,Resign,Black
TRUE,56,15+0,1776,1724,52,B90,10,Resign,White
TRUE,56,15+10,1734,1747,-13,A10,2,Resign,Black
TRUE,41,15+0,1722,1773,-51,A20,2,Resign,White
TRUE,60,10+5,1802,1709,93,A00,2,Out of Time,Black
TRUE,56,15+1,1726,1789,-63,A20,2,Resign,Black
TRUE,79,12+0,1778,1722,56,B22,3,Out of Time,White
TRUE,100,15+5,1745,1707,38,B57,11,Draw,Draw
TRUE,95,7+3,1758,1725,33,D45,9,Mate,White
TRUE,76,10+10,1735,1753,-18,A20,2,Resign,Black
TRUE,44,15+10,1837,1743,94,B20,3,Resign,White
TRUE,61,30+0,1734,1714,20,A15,2,Resign,White
TRUE,60,10+10,1744,1748,-4,A20,2,Out of Time,Black
TRUE,42,10+10,1756,1737,19,A20,2,Mate,Black
TRUE,93,9+12,1831,1765,66,B21,3,Resign,White
TRUE,57,10+2,1811,1774,37,B90,10,Mate,White
TRUE,106,15+5,1796,1762,34,D00,3,Resign,Black
TRUE,49,10+0,1844,1771,73,B90,10,Resign,White
TRUE,116,10+10,1799,1760,39,B90,11,Resign,Black
TRUE,86,20+0,1769,1838,-69,A20,2,Out of Time,Black
TRUE,42,13+5,1788,1757,31,D17,10,Resign,Black
TRUE,47,20+0,1746,1745,1,A20,2,Mate,White
TRUE,32,10+10,1749,2040,-291,A15,2,Resign,Black
TRUE,70,10+10,1804,1736,68,D00,3,Resign,Black
TRUE,21,30+10,1724,1770,-46,A13,2,Resign,White
TRUE,27,15+0,1254,1068,186,B07,2,Resign,White
TRUE,26,15+0,1103,1240,-137,A06,3,Mate,Black
TRUE,31,20+20,1465,1119,346,C00,3,Mate,White
TRUE,36,20+20,1140,1457,-317,B07,4,Mate,Black
TRUE,11,10+10,1409,1173,236,B00,3,Mate,White
TRUE,69,10+4,1452,1210,242,B07,3,Mate,White
TRUE,24,5+8,1332,1299,33,C20,3,Mate,Black
TRUE,35,5+8,1498,1500,-2,B00,4,Mate,White
FALSE,128,5+5,2270,2451,-181,B30,4,Draw,Draw
TRUE,56,5+5,2451,2270,181,C72,9,Resign,Black
FALSE,48,10+0,1930,2270,-340,C47,9,Mate,Black
TRUE,16,6+4,2108,2270,-162,C31,6,Resign,Black
FALSE,19,15+0,2270,2199,71,A00,1,Resign,White
FALSE,42,15+0,2199,2270,-71,B06,5,Resign,Black
FALSE,2,5+5,2270,1962,308,A40,2,Resign,White
FALSE,107,5+5,1962,2270,-308,C69,9,Draw,Draw
FALSE,44,10+10,1750,2270,-520,A45,2,Resign,Black
TRUE,41,10+0,2264,1838,426,A10,2,Resign,White
TRUE,29,10+0,2259,1775,484,A00,1,Mate,White
TRUE,52,10+0,1974,2243,-269,B20,3,Mate,Black
TRUE,43,10+0,2230,1929,301,C45,8,Mate,White
TRUE,126,10+0,1821,2221,-400,B06,4,Resign,Black
TRUE,16,10+0,1821,2211,-390,A02,2,Mate,Black
TRUE,65,10+0,2204,1740,464,A00,1,Resign,White
TRUE,25,10+0,2185,1916,269,C45,9,Resign,White
TRUE,62,10+0,1807,2172,-365,B00,2,Mate,Black
FALSE,46,6+6,1500,1510,-10,D00,2,Mate,Black
FALSE,49,6+6,1510,1500,10,C20,3,Mate,White
FALSE,21,6+6,1683,1500,183,C20,3,Mate,White
FALSE,52,6+6,1500,1683,-183,D00,2,Mate,Black
FALSE,75,20+0,1327,1500,-173,C30,3,Mate,White
FALSE,39,30+0,1370,1500,-130,C41,5,Mate,White
FALSE,65,30+0,1500,1370,130,C21,4,Draw,Draw
FALSE,70,30+0,1500,1370,130,C20,3,Draw,Draw
FALSE,91,30+0,1370,1500,-130,C40,4,Mate,White
FALSE,72,30+0,1370,1500,-130,C40,4,Draw,Draw
FALSE,96,30+0,1500,1370,130,C20,2,Mate,Black
FALSE,88,180+0,1500,1370,130,B01,2,Mate,Black
FALSE,49,180+0,1370,1500,-130,A40,3,Mate,White
FALSE,5,180+0,1370,1500,-130,A40,3,Out of Time,White
FALSE,44,180+0,1500,1370,130,B02,2,Mate,Black
FALSE,75,180+0,1370,1500,-130,C20,3,Mate,White
FALSE,44,180+0,1500,1370,130,C20,3,Mate,Black
FALSE,50,180+0,1370,1500,-130,C20,3,Draw,Draw
TRUE,54,45+5,1270,1279,-9,C40,3,Mate,Black
TRUE,44,4+6,1298,1695,-397,A45,2,Mate,Black
TRUE,46,4+6,1348,1573,-225,A40,2,Mate,Black
TRUE,43,4+6,1565,1445,120,D07,5,Resign,White
TRUE,58,4+6,1500,1860,-360,A40,2,Mate,Black
FALSE,77,6+5,1338,1607,-269,C46,7,Resign,White
FALSE,172,6+5,1500,1338,162,C20,4,Out of Time,Black
TRUE,64,10+0,1547,1317,230,D02,4,Mate,Black
TRUE,72,10+0,1322,1557,-235,B50,4,Mate,Black
TRUE,117,10+0,1527,1329,198,A00,1,Mate,White
TRUE,80,10+0,1341,1398,-57,B01,4,Mate,Black
TRUE,62,10+0,1286,1328,-42,C20,3,Mate,Black
TRUE,102,10+0,1331,1695,-364,C41,5,Mate,Black
TRUE,24,10+0,1346,1343,3,C50,6,Draw,Draw
TRUE,1,10+0,1778,1349,429,B00,1,Resign,White
TRUE,46,10+0,1353,1661,-308,B10,2,Mate,Black
TRUE,85,10+0,1645,1353,292,C44,5,Mate,White
TRUE,54,10+0,1356,1752,-396,C46,7,Mate,Black
TRUE,57,10+0,1804,1358,446,D00,3,Mate,White
TRUE,44,10+0,1359,2109,-750,B10,2,Mate,Black
TRUE,113,10+0,1361,1373,-12,C20,3,Mate,White
TRUE,66,10+0,1381,1731,-350,C00,3,Mate,Black
TRUE,102,10+0,1116,1376,-260,A00,1,Resign,Black
TRUE,2,10+0,1381,1651,-270,B20,2,Out of Time,Black
TRUE,64,10+0,1389,1561,-172,B10,2,Mate,Black
TRUE,37,10+0,1747,1392,355,C44,5,Resign,White
TRUE,64,10+0,1422,1173,249,B06,2,Mate,Black
TRUE,108,5+8,1631,1783,-152,D00,4,Mate,Black
TRUE,74,7+2,1791,1867,-76,A45,2,Out of Time,Black
TRUE,40,7+2,1636,1784,-148,D02,4,Mate,Black
TRUE,45,8+2,1699,1798,-99,B01,4,Resign,White
TRUE,108,8+2,1813,1683,130,D00,3,Mate,Black
TRUE,65,10+0,1884,1815,69,B00,6,Resign,White
TRUE,42,10+0,1675,1322,353,B02,3,Resign,White
TRUE,7,9+0,1476,1500,-24,C20,4,Mate,White
FALSE,51,10+0,1278,1058,220,B00,4,Resign,White
TRUE,13,8+3,1143,1097,46,C42,5,Resign,White
TRUE,41,10+0,1014,1287,-273,B01,2,Resign,White
FALSE,27,10+0,1206,1014,192,C46,6,Resign,White
TRUE,16,25+0,1071,1312,-241,B00,2,Resign,Black
TRUE,27,20+5,1424,1092,332,C21,4,Resign,White
TRUE,36,17+16,1127,1333,-206,C40,4,Resign,Black
TRUE,17,10+8,1785,1132,653,C50,5,Resign,White
FALSE,47,5+8,1500,1132,368,C55,7,Resign,White
TRUE,22,5+7,1144,1601,-457,C41,4,Resign,Black
TRUE,27,8+0,2066,1145,921,A02,2,Resign,White
TRUE,85,10+0,1505,1617,-112,C41,6,Resign,White
TRUE,37,10+5,1367,1505,-138,A15,4,Resign,Black
TRUE,38,10+0,1511,1680,-169,A52,7,Resign,Black
TRUE,43,15+10,1524,1518,6,C41,8,Resign,Black
TRUE,43,10+0,1549,1536,13,A20,2,Resign,White
TRUE,45,5+8,1525,1430,95,B32,7,Mate,White
TRUE,174,15+8,1460,1514,-54,B20,3,Mate,Black
TRUE,39,15+5,1498,1531,-33,B06,4,Resign,White
TRUE,63,10+3,1482,1525,-43,C42,5,Out of Time,White
TRUE,82,10+0,1464,1496,-32,C02,7,Resign,White
TRUE,52,10+5,1506,1610,-104,B01,6,Resign,Black
TRUE,15,5+10,1500,1516,-16,D00,5,Resign,White
TRUE,30,10+4,1414,1534,-120,B21,3,Resign,White
TRUE,25,15+5,1525,1377,148,B30,5,Resign,White
TRUE,3,10+2,1329,1547,-218,A40,1,Resign,White
TRUE,9,15+10,1541,1277,264,C40,4,Resign,White
FALSE,20,10+0,1290,1541,-251,C00,5,Resign,White
TRUE,76,15+0,1358,1532,-174,E00,4,Mate,Black
TRUE,22,15+0,1522,1364,158,C42,9,Resign,White
TRUE,50,10+8,1431,1510,-79,C00,5,Out of Time,Black
TRUE,17,10+8,1495,1440,55,C57,11,Resign,White
TRUE,43,8+0,1478,1513,-35,A45,3,Resign,White
TRUE,114,8+0,1514,1477,37,C40,4,Out of Time,Draw
FALSE,60,5+5,1500,1514,-14,C44,6,Resign,White
TRUE,56,10+0,1392,1501,-109,C20,5,Mate,Black
TRUE,106,10+0,1525,1370,155,B01,2,Out of Time,Black
TRUE,49,10+0,1346,1552,-206,C40,4,Mate,White
TRUE,51,10+5,1570,1569,1,C21,10,Resign,Black
FALSE,33,5+5,2621,1122,1499,B01,4,Resign,White
TRUE,34,10+0,1405,1420,-15,D00,2,Resign,Black
FALSE,21,10+0,1578,1420,158,A10,2,Resign,White
TRUE,51,10+5,1406,1496,-90,C20,3,Resign,White
TRUE,46,30+20,1309,1420,-111,C20,3,Resign,White
TRUE,30,9+1,1432,1397,35,A53,6,Resign,Black
TRUE,13,7+5,1441,1442,-1,C46,5,Resign,White
TRUE,18,12+12,1453,1432,21,C20,3,Resign,Black
TRUE,71,12+12,1420,1465,-45,B30,4,Resign,White
TRUE,21,5+5,1463,1476,-13,D00,5,Resign,White
TRUE,32,3+8,1438,1467,-29,C21,5,Mate,Black
TRUE,51,5+8,1458,1478,-20,D00,2,Resign,White
FALSE,146,15+5,1456,1478,-22,B30,4,Mate,Black
TRUE,111,15+0,1466,1503,-37,A21,3,Resign,White
TRUE,156,15+0,1435,1456,-21,A45,2,Out of Time,Black
FALSE,53,10+1,1426,1456,-30,B20,3,Resign,White
TRUE,35,8+5,1521,1443,78,B30,4,Resign,Black
TRUE,172,7+3,1372,1434,-62,C41,5,Out of Time,Black
TRUE,113,10+10,1423,1479,-56,A34,3,Mate,White
FALSE,43,15+15,2156,1621,535,A49,5,Resign,White
FALSE,81,25+15,2156,1511,645,D02,4,Resign,White
FALSE,62,15+15,1991,2156,-165,D60,13,Resign,Black
FALSE,52,15+15,1322,2156,-834,A15,2,Mate,Black
FALSE,2,15+15,2156,2476,-320,D00,2,Resign,Black
FALSE,58,15+15,2156,1725,431,D11,5,Resign,White
FALSE,62,20+15,2156,1959,197,D51,9,Resign,Black
FALSE,76,20+15,1359,2156,-797,D00,3,Resign,Black
FALSE,24,20+15,2156,1220,936,D06,3,Resign,White
TRUE,76,8+0,1889,1999,-110,C01,5,Resign,Black
TRUE,21,8+0,1903,1898,5,B00,2,Mate,White
TRUE,34,5+8,1955,1885,70,B07,4,Resign,Black
TRUE,39,6+3,1894,1938,-44,B00,5,Resign,Black
TRUE,104,5+8,1868,1884,-16,B50,4,Resign,Black
TRUE,19,11+8,1543,1006,537,B07,2,Resign,White
TRUE,23,10+5,1010,1530,-520,A00,1,Resign,Black
TRUE,37,12+8,1488,1015,473,A00,1,Mate,White
TRUE,48,12+0,1016,1429,-413,A00,1,Mate,Black
FALSE,29,10+0,1500,1016,484,A06,3,Mate,White
TRUE,14,5+5,1059,1224,-165,A00,2,Resign,Black
TRUE,51,10+0,2162,1278,884,B34,9,Resign,White
TRUE,30,10+0,1281,1684,-403,C40,6,Mate,Black
TRUE,29,10+0,1663,1284,379,D31,5,Resign,White
TRUE,44,10+0,1285,1869,-584,C10,6,Mate,Black
TRUE,60,10+0,1286,1972,-686,B32,8,Resign,Black
TRUE,99,10+0,1253,1917,-664,A00,5,Resign,White
TRUE,77,10+0,1869,1254,615,B21,3,Mate,White
TRUE,45,10+0,1257,1658,-401,C40,6,Resign,Black
TRUE,35,10+0,1789,1258,531,C02,5,Resign,White
TRUE,52,5+5,1263,1554,-291,C42,5,Mate,Black
TRUE,34,5+5,1483,1270,213,B21,3,Resign,White
TRUE,124,10+0,1543,1210,333,B36,8,Out of Time,Black
TRUE,16,10+0,1212,1743,-531,C50,6,Resign,Black
TRUE,63,10+0,1193,1360,-167,C42,5,Resign,White
FALSE,106,8+0,1564,1689,-125,C68,9,Resign,Black
FALSE,77,5+6,1689,1703,-14,B50,4,Out of Time,White
FALSE,105,5+8,1807,1689,118,C39,10,Resign,White
FALSE,81,15+0,1689,1500,189,C48,8,Mate,White
FALSE,97,10+0,1689,1790,-101,C46,6,Draw,Draw
FALSE,50,10+0,1689,1748,-59,C00,3,Resign,Black
FALSE,72,10+0,1720,1500,220,C00,3,Resign,White
FALSE,59,10+5,1653,1569,84,C33,6,Mate,White
FALSE,106,10+5,1569,1653,-84,C42,5,Mate,Black
TRUE,105,8+8,1685,1666,19,B01,4,Resign,White
TRUE,90,10+10,1688,1423,265,C20,2,Mate,Black
TRUE,57,15+0,1588,1706,-118,A21,3,Resign,White
TRUE,69,6+8,1699,1508,191,C20,2,Mate,White
TRUE,77,6+8,1491,1722,-231,C21,3,Resign,White
TRUE,35,8+3,1720,1245,475,B00,2,Out of Time,White
TRUE,119,15+0,1714,1479,235,B07,2,Mate,White
TRUE,70,15+0,1483,1708,-225,A04,2,Resign,Black
TRUE,30,10+1,1471,1702,-231,A40,2,Resign,Black
TRUE,70,10+1,1725,1451,274,C20,2,Out of Time,Black
TRUE,61,10+1,1431,1750,-319,A40,3,Out of Time,White
TRUE,63,10+0,1746,1403,343,C00,2,Mate,White
TRUE,72,10+5,1482,1741,-259,B01,4,Mate,Black
TRUE,79,15+0,1550,1763,-213,D10,5,Out of Time,White
TRUE,71,15+8,1758,1458,300,C20,2,Mate,White
TRUE,41,10+1,1591,1778,-187,C40,3,Resign,White
TRUE,3,10+0,1775,1379,396,A40,2,Resign,White
TRUE,116,10+0,1381,1772,-391,A00,1,Mate,Black
TRUE,113,10+0,1769,1383,386,A40,2,Mate,White
TRUE,64,10+0,1456,1765,-309,B01,4,Mate,Black
TRUE,71,5+5,1762,1361,401,D20,5,Resign,White
TRUE,52,8+0,1785,1489,296,E61,6,Mate,Black
TRUE,70,8+0,1387,1783,-396,D00,2,Mate,Black
TRUE,43,8+0,1778,1484,294,A40,2,Mate,White
TRUE,116,10+6,1543,1772,-229,B01,2,Mate,Black
TRUE,51,6+4,1770,1247,523,D10,6,Resign,White
TRUE,39,7+8,1767,1424,343,D10,5,Mate,White
FALSE,24,30+0,1500,1243,257,C00,2,Draw,Draw
FALSE,54,30+0,1243,1500,-257,A40,2,Mate,Black
FALSE,25,30+0,1500,1243,257,A45,2,Mate,White
TRUE,43,5+7,1805,1273,532,C41,4,Resign,White
TRUE,38,5+7,1277,1803,-526,A40,2,Resign,Black
TRUE,113,5+7,1800,1282,518,C41,4,Mate,White
TRUE,36,5+7,1287,1798,-511,C22,6,Mate,Black
FALSE,22,30+0,1500,1287,213,B02,4,Resign,Black
FALSE,65,180+180,1901,1287,614,B02,4,Mate,White
TRUE,33,5+5,1511,1309,202,C20,3,Mate,White
FALSE,47,30+15,1500,1500,0,D37,12,Resign,White
FALSE,30,10+5,1500,2282,-782,A65,11,Out of Time,Black
FALSE,26,5+60,1500,1500,0,B22,8,Resign,Black
FALSE,28,5+60,1500,1500,0,B33,10,Out of Time,Black
FALSE,27,5+60,1500,1500,0,B01,4,Out of Time,White
FALSE,45,5+60,1500,1500,0,C83,18,Resign,White
FALSE,1,60+60,2617,1500,1117,A04,1,Out of Time,White
FALSE,42,20+60,1500,2016,-516,B07,4,Resign,Black
FALSE,41,10+10,2272,1500,772,C51,10,Out of Time,White
FALSE,30,20+0,2473,1500,973,B01,4,Resign,White
FALSE,27,20+0,2401,1500,901,B01,4,Resign,White
FALSE,47,15+3,2326,1500,826,B01,4,Resign,White
TRUE,53,12+0,1433,1272,161,A40,2,Mate,White
TRUE,26,5+5,1500,1387,113,C21,3,Mate,Black
TRUE,41,10+0,1500,1260,240,A04,2,Mate,White
TRUE,77,10+0,1257,1414,-157,D20,6,Out of Time,White
TRUE,73,10+0,1398,1265,133,B20,2,Mate,White
TRUE,75,10+0,1253,1196,57,D20,6,Mate,White
TRUE,22,10+0,1194,1255,-61,B20,3,Draw,Draw
TRUE,43,10+0,1413,1263,150,B21,3,Mate,White
TRUE,49,10+0,1771,1265,506,B30,4,Mate,White
TRUE,71,10+0,1343,1276,67,B70,10,Mate,White
TRUE,56,10+0,1266,1556,-290,D00,2,Resign,Black
TRUE,17,10+0,1552,1270,282,B50,4,Resign,White
TRUE,150,10+5,1272,1785,-513,E90,9,Mate,Black
TRUE,81,10+0,1710,1274,436,C21,3,Mate,White
TRUE,96,15+0,1279,1528,-249,D20,4,Mate,Black
TRUE,17,10+0,1254,1560,-306,D20,4,Mate,White
TRUE,63,15+3,1468,1260,208,E20,5,Mate,White
TRUE,78,10+0,1263,1664,-401,D00,4,Mate,Black
TRUE,69,10+0,1662,1265,397,C42,5,Mate,White
TRUE,7,10+0,1659,1268,391,C23,3,Mate,White
TRUE,48,10+0,1274,1503,-229,C02,5,Mate,Black
TRUE,108,10+0,1698,1247,451,C20,3,Mate,Black
TRUE,72,10+2,1257,1325,-68,D06,8,Resign,Black
TRUE,26,5+5,1268,1341,-73,D02,4,Resign,Black
TRUE,61,5+5,1329,1279,50,D30,4,Mate,White
TRUE,69,6+5,1409,1289,120,C68,8,Mate,White
TRUE,55,6+5,1299,1400,-101,D02,3,Resign,Black
TRUE,44,15+0,1223,1286,-63,C50,6,Mate,Black
TRUE,20,10+0,1289,1686,-397,C00,5,Resign,Black
TRUE,46,10+0,1933,1499,434,C42,5,Resign,White
TRUE,53,10+0,2137,1939,198,C26,7,Resign,White
TRUE,22,10+0,1963,1380,583,B00,2,Resign,Black
TRUE,73,10+0,2242,1967,275,C77,9,Resign,White
TRUE,3,10+13,1515,1412,103,B00,2,Resign,White
TRUE,23,20+0,1721,1500,221,A01,1,Resign,White
TRUE,11,5+8,1500,1210,290,A01,1,Draw,Draw
TRUE,89,10+0,1746,1744,2,C46,5,Mate,White
TRUE,143,10+0,1734,1738,-4,B06,2,Mate,White
TRUE,120,10+0,1741,1871,-130,C11,7,Mate,Black
TRUE,42,10+0,1686,1731,-45,C64,6,Resign,Black
TRUE,89,10+0,1635,1723,-88,E11,8,Draw,Draw
TRUE,128,10+0,1553,1717,-164,C64,6,Resign,Black
TRUE,71,10+0,1708,1652,56,C01,5,Resign,White
TRUE,64,10+0,1648,1698,-50,C20,3,Out of Time,Black
TRUE,98,10+0,1698,1720,-22,C01,5,Draw,Draw
TRUE,119,10+0,1545,1714,-169,C53,9,Mate,White
TRUE,127,10+0,1702,1421,281,B01,4,Mate,White
TRUE,24,10+0,1679,1692,-13,C50,9,Resign,Black
TRUE,119,20+0,1795,1700,95,C45,8,Mate,White
TRUE,65,20+0,1702,1700,2,C21,5,Draw,Draw
TRUE,101,20+0,1686,1782,-96,B00,2,Resign,White
TRUE,55,10+0,1676,1661,15,C50,5,Resign,White
TRUE,97,10+0,1581,1690,-109,C54,11,Mate,White
TRUE,123,10+0,1679,1694,-15,C50,7,Out of Time,White
TRUE,47,10+0,1669,1636,33,B44,8,Resign,White
TRUE,164,10+0,1484,1663,-179,C20,3,Mate,Black
TRUE,17,10+0,1697,1673,24,A00,1,Resign,White
TRUE,137,10+0,1660,1685,-25,C20,3,Mate,White
TRUE,42,10+0,1696,1695,1,C00,3,Resign,Black
TRUE,77,10+0,1690,1533,157,B32,8,Resign,White
TRUE,66,10+0,1690,1701,-11,E33,8,Resign,White
TRUE,79,10+0,1734,1688,46,A46,5,Resign,Black
TRUE,66,10+0,1688,1745,-57,E20,6,Mate,Black
TRUE,43,10+0,1684,1700,-16,C64,6,Mate,White
TRUE,105,10+0,1645,1702,-57,C64,6,Draw,Draw
TRUE,58,20+0,1555,1673,-118,C01,4,Resign,Black
TRUE,65,20+0,1670,1352,318,C55,6,Mate,White
TRUE,75,20+0,1690,1679,11,C01,4,Mate,White
TRUE,80,20+0,1597,1670,-73,C54,13,Resign,Black
TRUE,61,20+0,1728,1441,287,A10,1,Resign,White
TRUE,62,20+0,1448,1705,-257,B12,5,Mate,Black
TRUE,154,20+0,1676,1457,219,A04,2,Resign,White
TRUE,120,20+0,1468,1633,-165,B10,3,Mate,Black
TRUE,188,10+0,1478,1668,-190,B11,4,Mate,Black
TRUE,117,10+0,1467,1686,-219,A04,2,Draw,Draw
TRUE,28,10+0,1710,1431,279,A00,1,Mate,Black
TRUE,26,10+0,1424,1708,-284,A00,1,Mate,Black
TRUE,40,10+0,1734,1384,350,B50,5,Resign,Black
TRUE,65,10+0,1390,1730,-340,A00,1,Resign,Black
TRUE,111,10+0,1742,1372,370,A00,2,Draw,Draw
TRUE,44,10+0,1377,1738,-361,A46,4,Mate,Black
TRUE,63,8+0,1734,1383,351,B01,2,Out of Time,White
TRUE,89,10+0,1690,1371,319,A10,1,Resign,White
TRUE,51,30+0,1380,1654,-274,D00,3,Resign,Black
TRUE,89,30+0,1759,1364,395,D20,5,Draw,Draw
FALSE,55,30+0,1364,1738,-374,C20,3,Resign,Black
FALSE,47,30+0,1738,1364,374,D06,4,Mate,White
FALSE,37,30+0,1364,1738,-374,B20,2,Resign,Black
FALSE,65,30+0,1738,1364,374,D06,3,Mate,White
FALSE,98,10+0,1364,1738,-374,B12,5,Out of Time,Black
TRUE,125,3+8,1348,1291,57,A80,2,Mate,White
TRUE,62,3+8,1302,1338,-36,C02,5,Out of Time,Black
FALSE,53,10+2,1174,1302,-128,A00,2,Out of Time,White
FALSE,40,25+0,1303,1654,-351,D00,2,Resign,Black
TRUE,41,10+2,998,1299,-301,B25,4,Resign,Black
TRUE,62,10+0,1110,1292,-182,A00,1,Mate,Black
TRUE,58,10+0,1220,1281,-61,B20,2,Resign,Black
TRUE,36,5+10,1226,1287,-61,B20,2,Resign,Black
TRUE,53,5+5,1273,1290,-17,C00,3,Out of Time,White
TRUE,39,25+3,1230,1563,-333,B01,2,Resign,White
TRUE,3,25+3,1560,1160,400,D06,3,Resign,White
TRUE,43,25+3,1445,1576,-131,D00,3,Resign,White
TRUE,64,25+3,1588,1574,14,A40,2,Resign,Black
TRUE,36,25+3,1375,1606,-231,A00,1,Resign,White
TRUE,54,25+3,1619,1595,24,A40,2,Resign,Black
TRUE,52,25+3,1627,1508,119,D07,6,Resign,Black
TRUE,23,25+3,1625,1257,368,A40,2,Mate,White
TRUE,48,30+5,1465,1618,-153,C02,5,Resign,Black
TRUE,52,20+3,1631,1593,38,A41,3,Out of Time,Black
TRUE,36,20+3,1482,1648,-166,C00,3,Resign,White
TRUE,49,20+3,1678,1658,20,C00,3,Resign,White
TRUE,18,20+3,1680,1048,632,E20,5,Mate,Black
TRUE,43,20+3,1691,1682,9,D20,5,Resign,Black
TRUE,31,20+3,1761,1700,61,C02,10,Resign,White
TRUE,60,20+3,1362,1697,-335,C10,6,Mate,Black
TRUE,116,20+3,1554,1689,-135,C00,2,Mate,Black
TRUE,11,20+3,1681,1571,110,D06,4,Resign,White
TRUE,53,20+3,1668,1697,-29,D06,4,Resign,White
TRUE,52,20+3,1151,1666,-515,C00,2,Mate,Black
TRUE,38,20+3,1678,1649,29,D10,5,Resign,Black
TRUE,53,20+3,1698,1241,457,D15,7,Resign,Black
TRUE,61,20+3,1726,1709,17,C02,9,Resign,White
TRUE,123,20+3,1700,1673,27,D20,5,Mate,White
TRUE,74,20+3,1514,1694,-180,A01,4,Mate,Black
TRUE,31,20+3,1689,1417,272,D31,6,Resign,White
TRUE,64,20+3,1658,1678,-20,C02,8,Mate,Black
TRUE,68,20+3,1314,1675,-361,C00,3,Resign,Black
TRUE,33,20+3,1670,1460,210,D31,5,Resign,White
TRUE,147,20+3,1662,1542,120,A43,2,Mate,White
TRUE,60,20+3,1689,1648,41,C00,2,Resign,Black
TRUE,23,20+3,1503,1664,-161,C00,5,Out of Time,White
TRUE,25,20+3,1654,1573,81,A85,5,Resign,White
TRUE,47,20+5,1643,1611,32,D44,11,Resign,White
TRUE,125,20+3,1677,1639,38,D00,2,Draw,Draw
TRUE,34,20+3,1654,1516,138,E20,5,Resign,Black
TRUE,79,20+3,1648,1665,-17,C02,9,Resign,White
TRUE,46,20+3,1652,1653,-1,C00,3,Mate,Black
TRUE,45,20+3,1631,1665,-34,C00,3,Resign,White
TRUE,37,20+3,1659,1470,189,A40,2,Resign,White
TRUE,33,20+3,1610,1672,-62,C00,3,Resign,White
TRUE,80,20+3,1615,1636,-21,A00,1,Resign,Black
TRUE,49,8+0,1857,1632,225,C30,4,Resign,White
TRUE,36,8+0,1640,1849,-209,B00,4,Mate,Black
TRUE,41,10+0,1850,1904,-54,C62,6,Resign,White
TRUE,35,10+0,1894,1865,29,C00,3,Resign,White
TRUE,76,10+0,1696,1854,-158,C00,3,Resign,Black
TRUE,7,10+0,1842,1703,139,B01,4,Resign,White
TRUE,119,10+0,1826,1772,54,C62,6,Mate,White
TRUE,95,10+0,1812,1691,121,C41,5,Mate,White
TRUE,77,15+0,1803,1574,229,C60,6,Mate,White
TRUE,143,15+0,1806,1823,-17,C01,5,Mate,White
TRUE,49,10+0,1783,1847,-64,A05,4,Out of Time,White
TRUE,45,20+0,1298,1347,-49,B15,5,Resign,Black
TRUE,15,10+5,1343,1061,282,B21,3,Resign,White
TRUE,95,10+3,1195,1002,193,C50,8,Resign,White
TRUE,60,10+3,1004,1453,-449,C30,4,Resign,Black
TRUE,25,10+3,1274,982,292,C42,4,Resign,Black
TRUE,116,10+3,1302,963,339,A00,1,Out of Time,Black
TRUE,111,10+5,1174,956,218,A03,2,Draw,Draw
TRUE,27,10+3,1055,965,90,C20,3,Resign,White
TRUE,69,30+0,1379,967,412,C00,3,Resign,White
TRUE,54,10+3,962,1133,-171,B07,4,Draw,Draw
TRUE,83,10+2,1240,958,282,D05,7,Mate,White
TRUE,55,25+0,945,964,-19,B00,5,Resign,White
TRUE,61,10+2,1176,950,226,B02,6,Resign,White
TRUE,53,8+0,1174,955,219,A40,2,Resign,White
TRUE,106,20+0,1126,950,176,C00,2,Draw,Draw
TRUE,32,10+0,960,1005,-45,C21,3,Mate,Black
TRUE,64,10+2,964,1249,-285,C21,3,Mate,Black
TRUE,23,10+0,1475,1177,298,C45,7,Resign,White
TRUE,113,10+0,1180,1091,89,C40,4,Draw,Draw
TRUE,69,10+0,1308,1190,118,C45,7,Mate,White
TRUE,26,10+0,1193,1594,-401,B50,6,Resign,Black
TRUE,89,10+0,1566,1196,370,C51,10,Mate,White
TRUE,35,10+0,1582,1199,383,C62,6,Resign,White
TRUE,75,10+0,1956,1574,382,B30,4,Mate,White
TRUE,71,10+3,1934,1518,416,C44,6,Resign,White
TRUE,104,5+10,1754,1824,-70,B01,6,Out of Time,Black
TRUE,56,15+15,1605,1521,84,C02,5,Resign,Black
TRUE,39,15+15,1594,1608,-14,B90,10,Resign,White
TRUE,72,15+15,1792,1600,192,C00,3,Resign,White
TRUE,136,15+15,1612,1561,51,C57,11,Mate,Black
TRUE,65,15+15,1604,1489,115,C02,7,Mate,White
TRUE,150,15+15,1615,1627,-12,C58,11,Mate,Black
FALSE,90,2+10,1498,1579,-81,A00,1,Mate,Black
TRUE,14,5+10,1178,1744,-566,A00,1,Resign,Black
TRUE,93,5+10,1099,1132,-33,A00,1,Resign,White
FALSE,23,5+8,1500,1099,401,D00,3,Out of Time,White
TRUE,7,20+3,1322,1142,180,C46,7,Resign,White
TRUE,32,5+10,1202,1347,-145,A06,3,Resign,Black
TRUE,12,30+8,1211,1804,-593,A06,3,Resign,Black
TRUE,57,5+10,1366,1500,-134,E00,1,Mate,White
FALSE,42,11+10,2197,2116,81,B10,4,Resign,Black
FALSE,70,11+10,2116,2197,-81,D02,3,Out of Time,Black
TRUE,65,15+15,2191,2041,150,C01,5,Out of Time,White
TRUE,62,15+15,2048,2184,-136,B21,12,Resign,Black
TRUE,44,10+15,2200,2015,185,B72,11,Mate,Black
TRUE,35,8+8,2195,1964,231,B33,8,Resign,White
TRUE,92,10+5,2182,2184,-2,D31,6,Resign,Black
TRUE,54,1+19,1952,2179,-227,D43,8,Resign,Black
TRUE,54,1+19,1957,2174,-217,D37,7,Resign,Black
TRUE,60,15+10,1964,2169,-205,B40,4,Mate,Black
TRUE,65,15+15,2258,2177,81,D55,11,Resign,White
TRUE,50,10+5,2014,2171,-157,B42,9,Resign,Black
FALSE,86,25+5,1354,1914,-560,A00,1,Resign,White
FALSE,54,40+60,2493,1914,579,E10,12,Resign,Black
TRUE,51,120+0,1896,1910,-14,C00,4,Mate,White
TRUE,64,15+0,1883,1877,6,D35,9,Resign,Black
TRUE,168,60+0,1885,2107,-222,C64,13,Mate,Black
TRUE,66,9+5,2021,1857,164,C01,5,Resign,Black
TRUE,52,15+7,1954,1831,123,D02,5,Mate,Black
TRUE,55,11+11,1803,1934,-131,B08,12,Resign,White
TRUE,51,30+9,1776,1888,-112,C01,7,Resign,White
TRUE,82,30+9,1903,1744,159,D55,11,Resign,Black
TRUE,37,13+0,1713,1848,-135,D02,3,Resign,White
TRUE,16,14+0,1689,1690,-1,C41,6,Resign,White
TRUE,48,14+0,1701,1662,39,C00,3,Resign,Black
TRUE,23,14+0,1629,1713,-84,C41,5,Mate,White
TRUE,36,14+0,1727,1590,137,C21,5,Resign,Black
TRUE,23,5+20,1559,1577,-18,D00,3,Mate,White
TRUE,42,180+0,1183,1552,-369,C45,10,Resign,Black
TRUE,31,60+5,1511,1602,-91,B07,3,Resign,White
TRUE,68,15+10,1620,1462,158,B00,3,Resign,Black
TRUE,151,60+0,1788,1473,315,A40,2,Mate,White
TRUE,39,60+0,1487,1729,-242,C50,9,Resign,Black
FALSE,60,20+5,1288,1487,-199,B00,5,Resign,White
FALSE,60,20+5,1487,1288,199,C40,4,Resign,Black
TRUE,68,180+0,1603,1429,174,B02,3,Mate,Black
TRUE,66,60+0,1431,1418,13,B02,2,Draw,Draw
TRUE,85,60+0,1403,1486,-83,B02,2,Mate,White
TRUE,82,15+0,1776,1383,393,B10,4,Mate,Black
TRUE,42,7+35,1402,1682,-280,C45,7,Resign,Black
TRUE,18,7+35,1677,1425,252,C50,5,Resign,White
TRUE,39,16+10,1231,1531,-300,B20,3,Resign,White
FALSE,129,15+5,1619,1531,88,B29,5,Mate,White
TRUE,112,25+0,1678,1395,283,B10,2,Mate,Black
TRUE,18,5+8,1459,1499,-40,C20,3,Resign,Black
TRUE,55,5+8,1409,1507,-98,A46,5,Mate,White
TRUE,101,5+8,1353,1406,-53,D00,2,Mate,White
TRUE,95,5+8,1284,1373,-89,D00,4,Resign,White
TRUE,63,5+8,1194,1449,-255,A46,5,Mate,White
TRUE,13,9+17,1376,1248,128,C40,4,Out of Time,White
TRUE,60,9+17,1340,1366,-26,D00,3,Mate,Black
TRUE,36,2+10,1500,1707,-207,A46,5,Out of Time,Black
TRUE,42,10+10,1269,1162,107,C41,4,Mate,Black
TRUE,58,10+10,1500,1258,242,D00,3,Mate,Black
TRUE,124,15+2,1020,1228,-208,A00,1,Draw,Draw
TRUE,16,40+10,1027,1478,-451,A00,1,Mate,Black
TRUE,43,10+0,1281,1047,234,A40,2,Resign,White
TRUE,14,10+0,1072,1276,-204,A00,2,Mate,Black
TRUE,39,15+2,1226,1112,114,B00,1,Mate,White
FALSE,40,30+10,1112,1239,-127,A03,2,Mate,Black
TRUE,7,7+3,1230,1170,60,B00,3,Mate,White
TRUE,38,7+3,1269,1219,50,A04,2,Mate,Black
TRUE,19,10+10,1396,1379,17,B00,3,Mate,White
TRUE,56,10+0,1560,1601,-41,C41,5,Resign,Black
TRUE,24,10+0,1570,1587,-17,C44,5,Resign,Black
TRUE,53,10+0,1581,1581,0,B21,3,Mate,White
TRUE,36,10+0,1590,1614,-24,C50,6,Resign,Black
TRUE,47,10+0,1595,1539,56,C46,7,Mate,White
TRUE,38,10+0,1494,1587,-93,D10,4,Mate,Black
TRUE,66,10+0,1504,1578,-74,B20,3,Mate,Black
TRUE,69,10+0,1589,1573,16,C44,5,Resign,Black
TRUE,89,10+0,1579,1565,14,B01,4,Mate,White
TRUE,78,10+0,1557,1569,-12,A00,4,Mate,Black
TRUE,46,10+0,1576,1683,-107,B01,4,Resign,Black
TRUE,42,10+0,1588,1554,34,C55,6,Mate,Black
TRUE,58,10+0,1564,1578,-14,B20,3,Resign,Black
TRUE,56,10+0,1588,1595,-7,C44,5,Resign,Black
TRUE,63,10+0,1578,1576,2,C53,7,Resign,White
TRUE,75,10+0,1561,1589,-28,A42,5,Out of Time,White
TRUE,27,10+0,1515,1602,-87,D00,3,Resign,White
TRUE,21,10+0,1604,1613,-9,B30,4,Resign,White
TRUE,71,10+0,1603,1609,-6,C51,8,Mate,White
TRUE,73,10+0,1614,1613,1,B21,3,Mate,White
TRUE,84,10+0,1630,1420,210,B07,3,Out of Time,Black
TRUE,62,10+0,1564,1621,-57,B50,4,Resign,Black
TRUE,41,10+0,1617,1343,274,C41,5,Resign,White
TRUE,25,10+0,1611,1443,168,C45,7,Mate,White
TRUE,86,10+0,1621,1650,-29,B56,10,Out of Time,Black
TRUE,100,10+0,1602,1611,-9,B54,6,Resign,Black
TRUE,56,10+0,1528,1603,-75,B30,4,Mate,Black
TRUE,23,10+0,1559,1615,-56,B20,3,Mate,White
TRUE,36,10+0,1626,1612,14,A04,2,Resign,Black
TRUE,92,10+0,1637,1630,7,C42,5,Out of Time,Black
TRUE,51,10+0,1738,1645,93,D00,2,Resign,White
TRUE,61,10+0,1640,1436,204,B00,2,Resign,White
TRUE,65,10+0,1755,1647,108,B54,6,Resign,White
TRUE,33,10+0,1365,1653,-288,D00,2,Resign,Black
TRUE,71,10+0,1645,1664,-19,B23,3,Resign,White
TRUE,49,10+0,1653,1684,-31,C44,5,Out of Time,White
TRUE,50,10+0,1641,1638,3,C45,7,Resign,Black
TRUE,24,10+0,1621,1738,-117,B90,10,Resign,White
TRUE,57,10+0,1620,1632,-12,A00,1,Resign,White
TRUE,23,10+0,1623,1566,57,C41,5,Resign,White
TRUE,66,10+0,1634,1619,15,C44,5,Resign,Black
TRUE,93,10+0,1640,1644,-4,D02,3,Resign,White
TRUE,83,10+0,1581,1657,-76,D00,9,Out of Time,White
FALSE,71,15+12,2006,1906,100,C41,8,Resign,White
TRUE,62,15+12,1906,2006,-100,C01,5,Mate,Black
TRUE,53,15+12,1931,1915,16,C61,6,Resign,White
TRUE,37,15+12,1927,1797,130,D08,4,Resign,Black
TRUE,32,25+5,1717,1640,77,C02,11,Mate,Black
TRUE,67,20+2,1500,1403,97,C49,8,Resign,White
FALSE,76,10+0,1916,1698,218,B00,2,Mate,Black
FALSE,68,10+0,1148,1916,-768,B23,3,Mate,Black
FALSE,61,10+0,1841,1916,-75,B76,14,Mate,White
FALSE,45,10+0,1916,1213,703,B72,11,Mate,White
FALSE,37,10+0,1916,1562,354,B06,2,Mate,White
FALSE,26,10+0,1429,1916,-487,B70,10,Resign,Black
FALSE,35,10+0,1916,843,1073,B08,8,Mate,White
FALSE,53,10+0,1808,1916,-108,A57,6,Resign,White
TRUE,76,7+2,1755,1672,83,E00,4,Resign,Black
TRUE,37,5+8,1661,1694,-33,B40,4,Resign,White
TRUE,39,10+0,1679,1565,114,C34,6,Out of Time,White
TRUE,49,10+0,1375,1671,-296,E61,4,Resign,Black
TRUE,60,8+0,1539,1654,-115,B30,4,Resign,Black
TRUE,18,5+5,1629,1629,0,A00,2,Resign,Black
TRUE,104,5+5,1722,1592,130,E61,4,Mate,Black
TRUE,30,5+5,1612,1714,-102,C35,6,Resign,Black
TRUE,51,5+5,1705,1635,70,B43,9,Mate,White
TRUE,110,5+5,1653,1633,20,E60,5,Draw,Draw
TRUE,59,5+8,1621,1673,-52,C57,10,Resign,White
TRUE,99,10+0,1514,1479,35,C44,4,Draw,Draw
TRUE,82,10+0,1489,1504,-15,C00,3,Mate,Black
TRUE,99,10+0,1480,1432,48,C41,6,Mate,White
TRUE,56,10+0,1489,1540,-51,C02,7,Mate,Black
TRUE,124,10+0,1510,1488,22,C54,11,Draw,Draw
TRUE,30,10+0,1593,1474,119,D06,4,Resign,Black
TRUE,72,10+0,1485,1470,15,B30,4,Mate,Black
TRUE,49,10+0,1470,1625,-155,B12,7,Resign,White
TRUE,50,10+0,1478,1560,-82,C42,9,Resign,Black
TRUE,54,10+0,1491,1425,66,B00,4,Resign,Black
TRUE,30,10+0,1341,1484,-143,C65,6,Resign,Black
TRUE,87,10+0,1547,1493,54,A45,3,Resign,White
TRUE,47,10+0,1482,1508,-26,C50,5,Resign,White
TRUE,61,10+0,1472,1450,22,B40,4,Out of Time,White
TRUE,57,10+0,1438,1484,-46,C48,7,Mate,White
TRUE,40,10+0,1497,1426,71,C41,6,Resign,Black
TRUE,23,10+0,1527,1507,20,A04,2,Resign,White
TRUE,16,10+0,1518,1516,2,C57,9,Mate,Black
TRUE,58,10+0,1529,1518,11,C42,5,Resign,Black
TRUE,56,10+0,1499,1519,-20,C65,6,Resign,Black
TRUE,23,10+0,1508,1509,-1,C41,4,Mate,White
TRUE,27,10+0,1516,1173,343,A30,2,Mate,White
TRUE,13,10+0,1550,1194,356,B00,2,Resign,White
TRUE,105,10+0,1481,1235,246,B07,2,Resign,White
TRUE,10,10+0,1303,1475,-172,A02,1,Mate,Black
TRUE,58,8+10,1345,1701,-356,A40,2,Mate,Black
TRUE,27,14+14,1500,1500,0,A41,2,Mate,White
TRUE,57,5+10,1718,1608,110,B10,4,Mate,White
TRUE,100,10+8,1608,1511,97,A00,2,Mate,Black
TRUE,73,5+10,1693,1591,102,A43,4,Resign,Black
TRUE,53,5+10,1580,1520,60,A01,5,Out of Time,White
TRUE,64,5+10,1530,1568,-38,B00,2,Out of Time,Black
TRUE,119,5+10,1480,1584,-104,B00,2,Mate,White
TRUE,38,5+10,1531,1569,-38,B00,4,Resign,Black
TRUE,106,5+10,1571,1554,17,A00,1,Mate,Black
TRUE,31,5+10,1544,1427,117,D00,2,Resign,White
TRUE,54,5+10,1434,1534,-100,C40,4,Resign,Black
TRUE,30,5+10,1517,1519,-2,B28,6,Mate,Black
TRUE,28,5+10,1549,1504,45,B11,4,Resign,Black
TRUE,52,5+10,1746,1479,267,B07,2,Resign,Black
TRUE,32,180+0,1640,1456,184,C23,4,Resign,Black
TRUE,117,5+10,1560,1467,93,B10,2,Mate,White
TRUE,44,5+10,1589,1445,144,C01,6,Resign,Black
TRUE,58,5+10,1445,1428,17,D20,4,Mate,Black
TRUE,34,5+10,1621,1403,218,D06,6,Resign,Black
TRUE,60,5+10,1407,1390,17,B12,7,Mate,Black
TRUE,46,5+10,1277,1378,-101,B07,4,Resign,Black
TRUE,58,5+10,1375,1361,14,A40,2,Resign,Black
TRUE,129,5+10,1690,1365,325,A10,2,Resign,White
TRUE,17,5+10,1252,1387,-135,A40,1,Resign,White
TRUE,3,5+10,1359,1401,-42,C30,3,Resign,White
TRUE,109,5+10,1384,1420,-36,C20,3,Resign,White
TRUE,76,5+10,1445,1210,235,A03,2,Mate,Black
TRUE,60,5+10,1466,1405,61,A02,1,Mate,Black
TRUE,78,5+10,1492,1646,-154,A20,3,Mate,Black
TRUE,98,5+10,1487,2008,-521,A02,1,Mate,Black
TRUE,62,5+10,1503,1569,-66,B07,3,Mate,Black
TRUE,96,5+10,1511,1363,148,A03,2,Draw,Draw
TRUE,39,5+10,1499,1315,184,A02,1,Resign,White
TRUE,73,5+10,1480,1389,91,C44,4,Resign,White
TRUE,49,5+10,1397,1459,-62,C65,6,Resign,Black
TRUE,152,5+10,1491,1383,108,C46,5,Resign,Black
TRUE,43,5+10,1474,1312,162,C00,3,Resign,White
TRUE,52,5+10,1477,2047,-570,D00,2,Mate,Black
TRUE,40,5+10,1490,1709,-219,C00,3,Resign,Black
TRUE,63,5+10,1462,1413,49,A03,2,Resign,White
TRUE,21,5+10,1435,1500,-65,B00,6,Mate,White
TRUE,59,5+10,1404,1357,47,A03,2,Resign,White
TRUE,46,5+10,1355,1409,-54,C67,8,Draw,Draw
TRUE,40,5+10,1444,1491,-47,A03,2,Mate,Black
TRUE,50,5+10,1104,1430,-326,D00,3,Mate,Black
TRUE,108,5+10,1441,1807,-366,A03,2,Mate,Black
TRUE,80,5+10,1715,1343,372,D07,6,Mate,Black
TRUE,51,30+30,1744,1174,570,A20,2,Mate,White
TRUE,42,30+30,1177,1510,-333,C20,2,Mate,Black
TRUE,131,45+45,1423,1182,241,C40,3,Mate,White
TRUE,86,45+45,1185,1542,-357,B10,2,Mate,Black
TRUE,47,45+45,1421,1190,231,D20,4,Mate,White
TRUE,59,30+30,1450,1195,255,B01,4,Mate,White
TRUE,159,15+0,1301,1204,97,B01,2,Mate,White
TRUE,62,7+8,1211,1354,-143,D02,3,Mate,Black
TRUE,14,10+0,1228,1812,-584,A00,1,Resign,Black
FALSE,34,30+0,1228,1500,-272,A00,1,Mate,Black
TRUE,11,5+8,1500,1210,290,A01,1,Draw,Draw
FALSE,26,10+0,1038,1523,-485,C40,3,Mate,Black
FALSE,61,10+0,1523,1038,485,C20,3,Mate,White
TRUE,60,15+0,1558,1764,-206,C20,3,Mate,Black
TRUE,69,10+12,1689,1630,59,A40,2,Mate,White
TRUE,11,9+2,1752,1740,12,B01,4,Resign,White
TRUE,41,15+3,1500,1594,-94,B01,2,Resign,White
TRUE,60,60+0,1423,1584,-161,D02,4,Mate,Black
TRUE,11,35+10,1764,1500,264,B00,2,Mate,White
TRUE,65,18+20,1445,1649,-204,C44,4,Resign,White
TRUE,25,20+20,1445,1649,-204,C23,3,Mate,White
TRUE,141,20+20,1445,1649,-204,C20,3,Mate,White
TRUE,93,20+20,1445,1649,-204,C20,3,Resign,White
FALSE,48,20+20,1445,1649,-204,A40,2,Mate,Black
FALSE,30,20+20,1445,1649,-204,C46,7,Mate,Black
FALSE,40,20+20,1445,1649,-204,B07,5,Resign,Black
TRUE,52,20+20,1649,1445,204,B10,2,Resign,Black
TRUE,27,20+20,1649,1445,204,C45,7,Mate,White
TRUE,121,30+30,1649,1445,204,B00,5,Resign,Black
FALSE,28,30+30,1445,1649,-204,C26,5,Resign,Black
TRUE,91,30+30,1649,1445,204,C21,10,Mate,White
TRUE,105,20+20,1445,1649,-204,C50,6,Resign,Black
TRUE,60,30+30,1649,1445,204,C44,4,Resign,Black
FALSE,123,30+30,1649,1445,204,C21,9,Resign,White
TRUE,80,20+20,1450,1649,-199,B00,5,Mate,Black
FALSE,99,8+8,1649,1440,209,C21,3,Out of Time,White
TRUE,128,20+20,1702,1649,53,C22,8,Mate,Black
FALSE,85,11+0,1683,1649,34,A40,4,Mate,White
TRUE,89,7+7,1649,1330,319,B07,4,Mate,White
TRUE,33,15+0,1627,1649,-22,C21,4,Resign,White
TRUE,95,20+20,1649,1447,202,B06,2,Mate,White
FALSE,2,15+0,1649,1703,-54,C20,2,Resign,Black
FALSE,3,15+0,1703,1649,54,C40,3,Resign,White
TRUE,42,8+8,1718,1649,69,C24,4,Resign,Black
TRUE,29,10+0,1649,1608,41,D11,5,Resign,Black
TRUE,43,10+5,1649,1888,-239,E60,5,Resign,White
TRUE,26,10+5,1901,1629,272,C50,8,Resign,Black
TRUE,60,10+5,1799,1611,188,C77,9,Mate,Black
TRUE,33,6+5,1594,1750,-156,A25,4,Mate,White
TRUE,46,6+5,1765,1577,188,B33,8,Resign,Black
FALSE,9,6+15,1670,1577,93,C34,6,Resign,White
FALSE,41,15+0,1677,1577,100,A03,2,Mate,White
TRUE,42,20+20,1455,1569,-114,C68,7,Mate,Black
TRUE,31,19+20,1549,1427,122,D02,4,Resign,White
TRUE,86,20+20,1564,1437,127,C21,3,Mate,Black
TRUE,80,20+20,1432,1568,-136,C46,5,Draw,Draw
TRUE,31,20+20,1560,1440,120,B00,5,Mate,White
TRUE,48,20+20,1449,1551,-102,C46,7,Mate,Black
TRUE,129,30+0,1560,1596,-36,C21,5,Resign,Black
TRUE,67,20+20,1542,1469,73,B00,5,Resign,White
TRUE,114,5+8,1655,1526,129,A01,4,Resign,Black
TRUE,66,15+0,1535,1579,-44,C21,9,Mate,Black
FALSE,67,15+3,1586,1500,86,C20,3,Resign,White
FALSE,30,17+1,1586,1452,134,C00,2,Resign,White
TRUE,2,25+1,1670,1345,325,A02,1,Resign,Black
TRUE,182,25+1,1500,1500,0,A00,1,Resign,Black
FALSE,149,11+1,1500,1500,0,B07,3,Draw,Draw
FALSE,42,10+8,1500,1500,0,C20,3,Mate,Black
TRUE,68,10+0,1538,1553,-15,C45,8,Resign,Black
TRUE,49,10+0,1528,1517,11,C44,5,Resign,White
FALSE,36,20+5,1528,1594,-66,B01,6,Resign,Black
FALSE,123,20+5,1528,1442,86,C45,8,Mate,White
FALSE,50,20+5,1528,1790,-262,B43,9,Resign,White
TRUE,58,15+0,1473,1518,-45,C20,3,Resign,Black
FALSE,8,20+20,1518,1760,-242,C47,8,Resign,White
FALSE,10,20+20,1518,1545,-27,C00,3,Resign,White
FALSE,8,20+20,1518,1368,150,C40,5,Resign,White
FALSE,126,10+5,1518,1438,80,C44,5,Draw,Draw
FALSE,10,20+25,1518,1760,-242,C45,8,Draw,Draw
FALSE,8,20+25,1518,1875,-357,C02,8,Draw,Draw
FALSE,10,20+5,1518,1500,18,C45,10,Draw,Draw
FALSE,29,20+5,1518,1760,-242,C45,8,Resign,Black
FALSE,5,20+60,1500,1518,-18,C60,5,Resign,White
TRUE,24,10+0,1471,1509,-38,C50,6,Resign,Black
TRUE,74,10+0,1518,1603,-85,C41,8,Out of Time,Black
TRUE,99,10+0,1746,1523,223,C68,7,Mate,White
TRUE,86,10+0,1532,1597,-65,C45,7,Resign,Black
TRUE,89,10+0,1359,1532,-173,C20,3,Mate,White
FALSE,49,30+30,1541,2460,-919,B13,5,Resign,Black
TRUE,50,10+5,1557,1409,148,C44,5,Resign,Black
TRUE,39,10+2,1549,1439,110,B00,5,Resign,White
TRUE,47,25+10,1689,1556,133,C45,8,Resign,White
TRUE,71,25+10,1577,1567,10,C45,8,Resign,White
FALSE,43,5+8,1659,1489,170,B00,3,Mate,White
FALSE,45,5+8,1383,1489,-106,C46,6,Mate,White
TRUE,133,8+5,1643,1924,-281,B44,9,Resign,White
TRUE,34,15+10,1596,1573,23,C78,9,Resign,White
TRUE,39,10+15,1522,1627,-105,E70,7,Resign,White
TRUE,39,30+0,1461,1434,27,C00,4,Resign,White
FALSE,32,30+150,1500,1461,39,B00,2,Mate,Black
FALSE,31,20+0,1500,1500,0,A13,4,Mate,White
TRUE,80,45+0,1500,1519,-19,B00,2,Mate,Black
TRUE,23,15+5,1698,1612,86,B00,2,Resign,White
TRUE,39,25+5,1500,1327,173,A02,1,Mate,White
FALSE,114,5+5,1236,1304,-68,C46,5,Resign,Black
TRUE,110,5+8,1500,1288,212,C64,6,Resign,Black
FALSE,87,15+10,1576,1288,288,C50,9,Resign,White
TRUE,67,10+0,1333,1302,31,C50,6,Resign,White
TRUE,84,10+0,1335,1318,17,C44,4,Resign,White
TRUE,34,10+0,1336,1324,12,C44,5,Resign,Black
TRUE,67,15+0,1326,1141,185,C44,5,Resign,White
TRUE,64,10+5,1052,1318,-266,A20,2,Mate,Black
FALSE,27,14+8,1318,1181,137,C44,6,Resign,White
TRUE,27,10+5,1309,1101,208,B90,11,Mate,White
TRUE,28,15+5,1161,1297,-136,C64,6,Mate,Black
FALSE,58,15+0,1500,1297,203,C20,3,Resign,Black
TRUE,39,10+0,1297,2027,-730,B01,4,Resign,Black
TRUE,131,10+10,1365,1313,52,A40,3,Resign,White
TRUE,31,15+0,1291,1295,-4,C43,6,Mate,White
TRUE,27,10+10,1581,1298,283,C20,3,Resign,White
TRUE,34,15+15,1434,1265,169,C50,8,Mate,Black
TRUE,43,15+0,1324,1284,40,C61,6,Mate,White
TRUE,13,15+0,1252,1360,-108,C50,5,Mate,White
TRUE,62,15+0,1333,1272,61,C46,5,Resign,White
TRUE,55,15+0,1235,1376,-141,C57,9,Mate,White
TRUE,99,15+8,1191,1269,-78,C25,4,Mate,White
TRUE,44,15+8,1241,1200,41,C42,5,Resign,White
TRUE,112,15+0,1026,1224,-198,C27,3,Resign,Black
TRUE,46,15+5,1029,1204,-175,C20,3,Mate,Black
TRUE,21,15+5,1179,1050,129,C40,4,Mate,White
TRUE,62,15+5,1077,1146,-69,C46,5,Mate,Black
TRUE,32,15+5,982,1115,-133,A40,2,Mate,Black
TRUE,54,15+0,1005,1072,-67,C20,3,Mate,Black
TRUE,93,15+0,1011,1015,-4,C40,4,Mate,White
TRUE,56,15+0,1026,916,110,C20,3,Mate,Black
TRUE,52,15+0,992,1017,-25,A40,2,Resign,Black
TRUE,109,10+0,1483,1222,261,D00,3,Mate,White
TRUE,55,10+0,1573,1566,7,A40,2,Mate,White
TRUE,37,10+0,1561,1567,-6,C02,9,Resign,White
TRUE,46,10+0,1533,1550,-17,C51,8,Resign,Black
TRUE,35,10+0,1538,1545,-7,C30,4,Resign,White
TRUE,34,10+0,1385,1531,-146,B20,2,Mate,Black
TRUE,41,10+0,1508,2203,-695,D14,12,Mate,White
TRUE,51,10+0,1498,1780,-282,C53,7,Out of Time,White
FALSE,46,6+4,1857,1498,359,B80,10,Resign,Black
TRUE,65,5+5,1570,1507,63,C45,8,Resign,White
TRUE,61,5+5,1547,1518,29,C48,7,Mate,White
TRUE,72,5+5,1527,1611,-84,B72,11,Resign,Black
FALSE,61,7+5,1406,1527,-121,D35,7,Mate,White
TRUE,24,5+5,1344,1521,-177,C20,4,Resign,Black
TRUE,113,5+5,1514,1350,164,C40,3,Mate,White
TRUE,28,5+5,1520,1717,-197,C46,5,Resign,Black
TRUE,33,5+5,1538,1531,7,C50,5,Resign,White
TRUE,58,5+5,1542,1557,-15,C40,4,Mate,Black
TRUE,88,5+5,1454,1532,-78,C20,3,Resign,Black
TRUE,82,5+5,1654,1515,139,C50,9,Resign,Black
TRUE,46,5+5,1537,1504,33,C47,7,Resign,White
TRUE,23,10+0,1984,1505,479,C28,7,Resign,White
TRUE,49,10+0,1356,1498,-142,C20,5,Resign,Black
TRUE,56,10+0,1499,1995,-496,B32,8,Resign,Black
TRUE,144,5+5,1512,1447,65,C00,3,Mate,Black
TRUE,65,5+5,1578,1521,57,D20,5,Mate,White
TRUE,69,10+0,1506,1605,-99,C41,4,Out of Time,White
FALSE,57,20+1,1757,1040,717,B01,4,Mate,White
FALSE,19,20+1,1757,1022,735,C40,4,Resign,White
FALSE,63,20+1,1757,1932,-175,C55,7,Resign,Black
FALSE,103,25+3,1757,1809,-52,B30,4,Mate,White
FALSE,45,25+3,1962,1757,205,B72,11,Resign,White
TRUE,89,25+3,1741,1849,-108,B50,4,Resign,White
TRUE,106,25+3,1731,1854,-123,C47,8,Resign,Black
FALSE,130,25+3,1922,1731,191,B50,5,Resign,Black
FALSE,70,25+3,1731,1832,-101,B00,2,Resign,Black
FALSE,49,25+3,1731,1829,-98,D00,3,Resign,White
FALSE,63,25+3,1989,1731,258,B52,6,Resign,Black
FALSE,82,25+3,1731,1811,-80,C41,5,Resign,White
FALSE,53,25+3,1859,1731,128,D40,9,Resign,White
FALSE,82,25+3,1731,1866,-135,B10,2,Resign,Black
FALSE,41,25+3,1944,1731,213,D00,3,Resign,White
FALSE,34,25+3,1731,1839,-108,B01,4,Resign,Black
FALSE,68,25+3,1881,1731,150,D32,10,Resign,Black
FALSE,31,35+3,1806,1731,75,C00,2,Resign,White
FALSE,53,35+3,1731,1803,-72,C46,6,Out of Time,White
TRUE,45,35+3,1713,1885,-172,C02,11,Resign,White
FALSE,57,35+3,1856,1718,138,C02,7,Resign,Black
TRUE,71,15+10,1701,1821,-120,C47,7,Out of Time,White
FALSE,89,35+3,1947,1701,246,D32,8,Mate,White
FALSE,37,35+3,1701,1897,-196,C46,6,Resign,White
FALSE,53,35+3,1859,1701,158,C02,6,Draw,Draw
FALSE,37,35+3,1701,1919,-218,B11,6,Resign,White
FALSE,28,35+3,1858,1701,157,C01,7,Resign,Black
FALSE,61,35+3,1701,1956,-255,A16,7,Resign,White
FALSE,81,35+3,1868,1701,167,C00,3,Draw,Draw
FALSE,26,35+3,1701,1812,-111,C47,8,Mate,Black
FALSE,23,35+3,1822,1701,121,C00,3,Out of Time,White
FALSE,27,35+3,1833,1701,132,A03,2,Resign,White
FALSE,73,35+3,1701,1910,-209,C47,8,Resign,White
FALSE,89,35+3,1897,1701,196,C18,11,Resign,White
FALSE,78,30+3,1701,1807,-106,A40,2,Resign,Black
FALSE,47,30+3,1841,1701,140,C02,11,Draw,Draw
FALSE,75,30+3,1832,1701,131,C07,6,Mate,White
TRUE,57,10+0,1510,1412,98,C63,6,Mate,White
TRUE,30,10+0,1479,1399,80,C34,6,Resign,Black
TRUE,36,10+0,1409,1439,-30,D02,4,Mate,Black
TRUE,18,10+0,1426,1159,267,D21,6,Resign,Black
TRUE,128,10+0,1428,1437,-9,B30,4,Resign,White
TRUE,54,10+0,1449,1416,33,D06,8,Resign,Black
TRUE,58,10+0,1497,1437,60,B30,4,Resign,Black
TRUE,113,15+15,1507,1445,62,B30,4,Mate,White
TRUE,90,15+15,1390,1435,-45,A40,2,Out of Time,Black
TRUE,58,15+15,1451,1294,157,C00,3,Mate,Black
TRUE,45,15+15,1451,1450,1,B20,2,Resign,White
TRUE,79,15+15,1449,1485,-36,D07,6,Draw,Draw
TRUE,35,15+15,1362,1463,-101,B30,4,Mate,White
TRUE,31,10+0,1488,1438,50,A06,3,Resign,Black
TRUE,67,15+15,1574,1497,77,B32,5,Resign,White
TRUE,40,15+15,1506,1565,-59,C45,8,Mate,Black
TRUE,83,10+0,1394,1521,-127,B30,4,Mate,White
TRUE,48,15+15,1531,1539,-8,A04,2,Mate,Black
TRUE,129,15+15,1531,1543,-12,D06,4,Mate,White
TRUE,20,15+15,1253,1539,-286,B20,2,Resign,Black
TRUE,67,15+15,1673,1546,127,B25,4,Resign,White
TRUE,46,15+15,1553,1677,-124,D02,3,Resign,Black
TRUE,118,15+15,1557,1849,-292,D37,7,Mate,Black
TRUE,114,8+0,1934,1949,-15,C69,9,Mate,Black
TRUE,107,8+0,1949,2077,-128,B00,6,Out of Time,White
TRUE,38,10+0,1949,1863,86,C14,13,Resign,White
TRUE,57,10+0,1776,1949,-173,C48,7,Draw,Draw
TRUE,111,10+8,1949,1845,104,C55,7,Resign,White
TRUE,20,10+8,1845,1949,-104,C35,6,Resign,Black
TRUE,154,15+8,2057,1949,108,C01,5,Resign,Black
FALSE,96,15+8,2057,1949,108,C69,9,Resign,Black
TRUE,90,15+8,1949,2057,-108,C53,9,Draw,Draw
TRUE,80,6+4,2033,1949,84,D10,6,Resign,Black
FALSE,2,8+0,2021,1949,72,C20,2,Resign,Black
TRUE,119,5+8,1949,1714,235,B92,11,Resign,White
TRUE,184,6+4,2276,1949,327,B30,5,Mate,Black
TRUE,38,17+8,1874,1949,-75,C44,8,Mate,Black
TRUE,64,17+8,1883,1817,66,C59,17,Mate,Black
TRUE,113,5+5,1707,1881,-174,C69,10,Draw,Draw
TRUE,41,5+5,1500,1772,-272,C53,9,Mate,White
TRUE,65,5+8,1392,1067,325,C21,3,Mate,White
TRUE,25,8+5,1342,1075,267,C23,3,Resign,White
TRUE,56,10+0,1077,1631,-554,D00,4,Mate,Black
TRUE,150,10+0,1057,1595,-538,D00,4,Draw,Draw
TRUE,9,10+0,1286,1067,219,A40,3,Mate,White
TRUE,40,10+0,1068,1822,-754,A45,2,Mate,Black
TRUE,97,10+0,1428,1073,355,A00,4,Mate,White
TRUE,98,10+0,1291,1037,254,A40,3,Out of Time,Black
TRUE,43,10+0,1612,1039,573,B00,2,Mate,White
TRUE,162,10+0,1006,1228,-222,D05,6,Mate,Black
TRUE,23,30+0,1553,1008,545,C41,4,Resign,White
TRUE,132,5+8,1015,1301,-286,D00,3,Mate,Black
TRUE,89,5+8,1297,1024,273,B00,2,Mate,White
TRUE,31,5+8,1738,1025,713,C40,4,Mate,White
TRUE,35,2+10,1130,1044,86,C42,5,Resign,White
TRUE,27,30+0,1047,1492,-445,B00,2,Resign,Black
TRUE,50,10+0,1335,1329,6,A45,4,Resign,Black
TRUE,83,10+0,1321,1826,-505,D01,4,Mate,White
FALSE,57,10+0,1826,1321,505,D00,7,Mate,White
FALSE,45,20+20,1364,1422,-58,C41,4,Draw,Draw
FALSE,53,20+20,1422,1364,58,C40,4,Mate,White
TRUE,71,20+5,999,1375,-376,C61,6,Mate,White
FALSE,74,5+10,1241,1430,-189,B01,2,Mate,Black
FALSE,77,5+10,1430,1241,189,A40,2,Resign,White
TRUE,55,10+1,1259,1324,-65,C30,4,Mate,White
TRUE,57,13+0,1182,1459,-277,D07,5,Resign,White
TRUE,27,5+8,1428,1110,318,C10,6,Resign,White
TRUE,32,15+0,1286,1318,-32,D04,5,Resign,Black
TRUE,102,5+8,1574,1303,271,C27,3,Mate,Black
TRUE,69,5+8,1500,1022,478,B01,2,Mate,White
TRUE,75,13+0,1314,1196,118,A40,2,Mate,White
TRUE,94,10+0,996,1191,-195,C00,3,Out of Time,Black
TRUE,45,10+0,1185,1002,183,C20,3,Mate,White
TRUE,70,10+0,1009,1179,-170,C00,3,Mate,Black
TRUE,56,9+0,1187,1265,-78,B00,2,Mate,Black
TRUE,95,9+0,1107,1201,-94,C00,3,Out of Time,White
TRUE,60,9+0,1307,1187,120,C01,4,Out of Time,Black
TRUE,50,9+0,1194,1299,-105,A00,1,Mate,Black
TRUE,79,12+0,1287,1203,84,C00,3,Out of Time,White
TRUE,82,17+0,1047,1202,-155,C00,3,Mate,Black
FALSE,69,9+0,1047,1202,-155,B00,2,Mate,White
FALSE,60,9+0,1047,1202,-155,C00,3,Resign,Black
TRUE,130,15+0,1217,1041,176,D04,6,Mate,Black
TRUE,66,15+0,1253,1205,48,C11,7,Mate,Black
TRUE,82,10+0,1212,1359,-147,A00,1,Mate,Black
TRUE,24,10+0,1194,1201,-7,C00,2,Resign,Black
TRUE,69,10+0,1356,1208,148,C00,3,Resign,White
TRUE,62,9+0,1214,1359,-145,D00,3,Resign,Black
TRUE,57,9+0,1352,1222,130,B00,4,Resign,White
TRUE,15,9+0,1206,1368,-162,D00,3,Resign,White
TRUE,65,9+0,1306,1214,92,C00,3,Out of Time,White
TRUE,42,9+0,1223,1297,-74,A40,4,Resign,Black
TRUE,35,9+0,1212,1175,37,A46,3,Out of Time,White
TRUE,30,9+0,1218,1393,-175,A00,1,Resign,Black
TRUE,56,9+0,1386,1224,162,A40,2,Resign,White
TRUE,49,9+0,1315,1239,76,C00,2,Resign,White
TRUE,35,9+0,1264,1249,15,C00,3,Mate,White
TRUE,60,9+0,1257,1343,-86,D00,3,Mate,Black
TRUE,96,9+0,1264,1242,22,A00,1,Mate,Black
TRUE,33,9+0,1352,1272,80,A40,2,Resign,White
TRUE,22,9+0,1281,1342,-61,D00,2,Resign,Black
TRUE,82,9+0,1331,1267,64,C01,4,Out of Time,Black
TRUE,18,9+0,1380,1251,129,C00,3,Resign,Black
TRUE,14,9+0,1023,1246,-223,C00,3,Resign,Black
TRUE,123,9+0,1240,1047,193,D00,3,Out of Time,White
TRUE,81,9+0,1233,1251,-18,B07,2,Resign,White
TRUE,80,9+0,1446,1237,209,C00,3,Mate,Black
TRUE,56,9+0,1243,1357,-114,A80,2,Mate,Black
TRUE,42,9+0,1305,1229,76,C00,3,Resign,Black
TRUE,69,9+0,1215,1316,-101,A40,2,Out of Time,White
TRUE,69,9+0,1281,1224,57,C00,3,Mate,White
TRUE,63,9+0,1209,1337,-128,A00,1,Out of Time,White
TRUE,57,9+0,1297,1217,80,C00,3,Mate,White
TRUE,65,9+0,1202,1375,-173,D01,7,Mate,White
TRUE,39,9+0,1330,1208,122,C01,4,Mate,White
TRUE,62,9+0,1217,1282,-65,A45,3,Resign,Black
FALSE,27,20+5,1832,1500,332,B07,3,Out of Time,White
FALSE,32,30+30,1500,2210,-710,A00,1,Mate,Black
TRUE,95,10+0,2002,2056,-54,D02,5,Resign,White
TRUE,51,10+0,1997,1778,219,D02,3,Mate,White
TRUE,86,10+0,1988,1931,57,D02,5,Resign,White
TRUE,33,10+0,1916,2001,-85,C23,3,Mate,White
TRUE,81,8+2,2194,2007,187,C44,7,Resign,White
TRUE,72,8+2,2013,2188,-175,A48,5,Resign,Black
TRUE,100,10+30,2010,2036,-26,D02,3,Resign,White
TRUE,29,8+0,2035,1492,543,D02,3,Mate,White
TRUE,80,8+0,2046,2057,-11,A40,2,Resign,Black
TRUE,53,8+0,2046,2057,-11,D01,6,Resign,White
TRUE,69,8+0,1994,2048,-54,D20,4,Resign,Black
TRUE,135,5+8,2047,1268,779,A46,5,Resign,White
TRUE,88,5+8,2055,2155,-100,D02,4,Resign,Black
TRUE,72,5+6,2050,2044,6,C60,6,Out of Time,Black
TRUE,67,5+5,2034,2002,32,A43,2,Resign,White
TRUE,136,10+0,2046,2011,35,A40,2,Out of Time,Black
TRUE,221,15+10,2111,2044,67,C50,6,Draw,Draw
TRUE,48,15+10,2054,2089,-35,A46,4,Resign,Black
TRUE,33,15+10,2063,2065,-2,B01,4,Resign,White
TRUE,62,10+5,1906,2058,-152,C53,7,Mate,Black
TRUE,33,15+0,2050,1950,100,A46,5,Resign,White
TRUE,168,15+0,2003,2040,-37,C60,6,Out of Time,Black
TRUE,103,15+0,2040,2066,-26,A48,5,Draw,Draw
TRUE,44,8+0,2328,2031,297,C50,6,Resign,White
TRUE,40,8+0,2035,2324,-289,A48,5,Resign,Black
TRUE,156,15+10,2005,2024,-19,C45,7,Resign,Black
TRUE,126,15+10,2025,2004,21,D02,5,Draw,Draw
TRUE,89,10+0,2036,2054,-18,D02,5,Resign,Black
TRUE,15,10+0,2044,2047,-3,C53,7,Resign,White
TRUE,168,10+0,2143,2032,111,B01,4,Out of Time,Black
TRUE,48,8+2,2046,1950,96,A48,5,Resign,Black
TRUE,141,10+0,2038,1934,104,A46,4,Resign,White
TRUE,125,40+15,2151,2046,105,D20,5,Resign,White
FALSE,79,10+0,2294,2046,248,B01,4,Resign,White
FALSE,36,10+0,2046,2294,-248,D02,3,Resign,Black
TRUE,55,10+1,2120,2055,65,B01,4,Resign,White
TRUE,129,15+0,2070,1968,102,D02,5,Resign,Black
TRUE,130,15+0,2081,2082,-1,A40,1,Resign,Black
TRUE,32,10+0,1407,1430,-23,C20,3,Resign,Black
TRUE,117,10+0,1418,1419,-1,C50,5,Mate,White
FALSE,46,5+8,1500,1418,82,C20,3,Resign,Black
FALSE,5,15+0,1500,1418,82,A00,1,Out of Time,White
FALSE,38,5+5,1418,1465,-47,C55,6,Resign,Black
TRUE,56,15+0,949,1416,-467,C44,6,Mate,Black
TRUE,103,1+10,1402,1481,-79,C50,7,Resign,White
TRUE,83,1+10,1471,1412,59,D00,3,Mate,White
FALSE,38,15+0,1412,1500,-88,B23,4,Mate,Black
TRUE,52,15+5,1430,1250,180,B00,2,Resign,Black
TRUE,69,10+0,1360,1440,-80,C44,4,Resign,White
FALSE,57,30+0,1440,1968,-528,B25,4,Mate,White
TRUE,27,5+8,1435,1216,219,B02,4,Mate,White
TRUE,9,6+5,1430,1187,243,C57,7,Resign,White
TRUE,147,20+10,990,1452,-462,C46,7,Resign,White
TRUE,42,8+8,1104,1449,-345,C46,7,Mate,Black
TRUE,61,30+0,1441,1316,125,C00,3,Mate,White
TRUE,45,15+0,1424,1373,51,C41,5,Mate,White
FALSE,102,30+0,1424,2110,-686,C50,9,Mate,Black
FALSE,47,30+0,1424,1508,-84,C00,3,Resign,White
TRUE,49,15+0,1415,1319,96,B02,4,Out of Time,White
TRUE,28,20+15,1408,1255,153,C00,3,Resign,White
TRUE,43,20+15,1262,1401,-139,C42,5,Resign,Black
FALSE,20,30+0,1401,1979,-578,B25,4,Resign,White
TRUE,23,2+15,1392,1284,108,C57,10,Mate,White
FALSE,47,8+0,1392,1500,-108,B01,4,Mate,White
TRUE,39,10+0,1739,1395,344,C57,11,Resign,White
TRUE,17,10+0,2043,1396,647,D06,4,Resign,White
TRUE,35,20+2,1385,1362,23,C41,5,Mate,White
FALSE,35,20+0,1500,1385,115,D00,3,Resign,White
FALSE,33,60+0,1526,1385,141,D01,4,Resign,White
FALSE,29,20+0,1500,1385,115,C20,3,Resign,White
TRUE,61,10+0,1377,1255,122,C42,5,Mate,White
FALSE,23,10+0,1377,1804,-427,C55,6,Mate,White
FALSE,49,8+2,1377,1073,304,B01,4,Mate,White
FALSE,68,10+0,1377,1343,34,B32,8,Mate,Black
FALSE,61,10+0,1343,1377,-34,C44,5,Resign,White
FALSE,50,20+20,1635,1377,258,D00,3,Out of Time,Black
TRUE,88,5+15,1764,1590,174,B50,4,Mate,Black
TRUE,70,5+8,1770,1952,-182,C22,6,Mate,Black
TRUE,26,15+10,1938,1777,161,B32,5,Resign,White
TRUE,55,10+0,1887,1785,102,C00,4,Mate,White
TRUE,131,10+10,1966,1797,169,C00,4,Mate,White
TRUE,30,8+5,1804,1938,-134,B20,2,Resign,Black
TRUE,79,10+0,1848,1814,34,A41,2,Mate,White
TRUE,53,10+0,1806,1673,133,C00,3,Mate,White
TRUE,47,5+8,1824,1817,7,B06,2,Mate,White
TRUE,142,5+8,1829,1812,17,C41,4,Mate,Black
TRUE,31,5+8,1800,1842,-42,C00,4,Mate,White
TRUE,33,5+8,1831,1810,21,C20,3,Mate,White
TRUE,42,20+0,1927,1840,87,A00,1,Resign,White
TRUE,66,5+8,1870,1826,44,A40,2,Resign,Black
TRUE,147,11+0,1810,1933,-123,C41,4,Mate,White
TRUE,85,10+3,2049,1815,234,C00,3,Mate,White
TRUE,31,12+5,1926,1823,103,C00,4,Resign,White
TRUE,38,10+0,2278,1800,478,A40,2,Resign,Black
TRUE,150,15+0,1823,2012,-189,C41,4,Mate,Black
TRUE,72,15+0,1846,1839,7,B01,2,Mate,Black
TRUE,90,25+5,1594,1855,-261,C00,4,Out of Time,Black
TRUE,62,13+0,1500,1621,-121,C62,6,Mate,Black
TRUE,46,10+0,1645,1748,-103,B23,3,Mate,Black
TRUE,51,10+0,1542,1659,-117,A25,4,Out of Time,White
TRUE,32,10+0,1746,1645,101,D20,4,Resign,Black
TRUE,62,10+0,1655,1673,-18,C00,3,Mate,Black
TRUE,120,16+0,1667,1659,8,C40,4,Out of Time,Black
TRUE,49,15+0,1654,1693,-39,B30,4,Mate,White
TRUE,77,10+0,1748,1671,77,C48,9,Out of Time,White
FALSE,35,13+0,1671,1500,171,C40,4,Mate,White
FALSE,14,13+0,1671,1500,171,C40,3,Resign,Black
TRUE,11,17+0,1681,1738,-57,B23,3,Resign,White
TRUE,91,15+0,1731,1691,40,C24,4,Resign,White
TRUE,62,15+0,1707,1678,29,C44,5,Mate,Black
TRUE,25,15+0,1663,1790,-127,B25,4,Mate,White
TRUE,47,10+2,1705,1674,31,D06,4,Out of Time,White
TRUE,58,10+3,1717,1460,257,B00,2,Resign,Black
TRUE,55,8+0,1712,1499,213,B01,4,Resign,White
TRUE,38,15+5,1730,1473,257,C57,8,Mate,Black
TRUE,43,15+0,1704,1731,-27,C79,10,Resign,White
TRUE,50,10+0,1801,1717,84,C55,6,Resign,Black
FALSE,57,14+0,1714,1718,-4,C55,6,Out of Time,White
TRUE,69,15+0,1803,1723,80,D00,2,Out of Time,White
TRUE,90,10+0,1732,1785,-53,B02,4,Mate,Black
TRUE,173,15+0,1719,1758,-39,C62,6,Mate,White
TRUE,43,15+0,1748,1730,18,C36,6,Resign,White
TRUE,66,15+0,1741,1743,-2,B23,4,Mate,Black
TRUE,103,15+0,1264,1763,-499,D20,4,Mate,White
TRUE,40,10+5,1232,1761,-529,D01,4,Resign,Black
TRUE,90,15+0,1742,1750,-8,C66,8,Resign,Black
TRUE,107,15+0,1747,1424,323,C40,3,Mate,White
TRUE,34,15+0,1735,1763,-28,B07,2,Resign,White
TRUE,126,14+6,1755,1722,33,D02,4,Resign,Black
TRUE,108,14+0,1757,1709,48,D00,3,Out of Time,Black
TRUE,100,14+0,1720,1748,-28,B01,4,Mate,Black
TRUE,64,10+5,1773,1706,67,D02,5,Mate,Black
TRUE,66,10+0,1717,1709,8,B40,4,Out of Time,Black
TRUE,45,10+0,2247,1718,529,C55,6,Resign,White
FALSE,5,10+5,2055,2036,19,A04,2,Resign,Black
FALSE,92,15+0,2295,2055,240,B00,2,Resign,Black
FALSE,98,10+30,2055,2441,-386,D70,6,Resign,White
FALSE,20,10+5,1450,1626,-176,A00,1,Resign,Black
TRUE,27,15+0,1436,1525,-89,C23,3,Draw,Draw
TRUE,81,5+8,1673,1464,209,C21,3,Mate,White
TRUE,28,5+8,1536,1353,183,C55,6,Resign,Black
TRUE,64,5+8,1240,1272,-32,C20,4,Resign,Black
TRUE,74,10+0,1303,1613,-310,C46,7,Resign,Black
TRUE,61,10+0,1479,1407,72,A45,5,Mate,White
TRUE,105,5+5,1551,1500,51,A43,4,Resign,White
FALSE,79,10+0,1874,1824,50,C41,6,Draw,Draw
FALSE,45,10+0,1824,1874,-50,B40,6,Mate,White
FALSE,103,10+0,1783,1874,-91,A04,3,Out of Time,White
FALSE,63,25+0,1754,1874,-120,B40,4,Resign,White
FALSE,86,25+0,1874,1754,120,B00,2,Draw,Draw
FALSE,35,25+0,1915,1874,41,E32,7,Resign,White
FALSE,85,15+0,1874,1882,-8,B07,3,Resign,White
TRUE,144,10+0,1604,1869,-265,B20,3,Out of Time,Black
FALSE,17,25+0,1848,1869,-21,B40,4,Resign,White
FALSE,27,10+0,1869,1964,-95,C84,10,Resign,White
FALSE,142,25+0,1669,1869,-200,A46,3,Draw,Draw
FALSE,25,25+0,1869,1652,217,B34,9,Resign,White
FALSE,95,25+0,1664,1869,-205,B40,8,Resign,White
FALSE,44,25+0,1628,1869,-241,A04,2,Resign,Black
FALSE,40,25+0,1869,1628,241,B01,4,Resign,Black
FALSE,9,25+0,1628,1869,-241,A45,3,Resign,White
FALSE,104,10+0,1359,1258,101,C41,5,Out of Time,Draw
TRUE,56,20+40,1371,1326,45,B32,8,Resign,Black
TRUE,31,20+40,1346,1386,-40,C47,8,Mate,White
TRUE,66,20+40,1334,1341,-7,C02,7,Resign,White
TRUE,15,20+40,1321,1393,-72,B32,7,Mate,White
TRUE,77,20+40,1310,1303,7,C40,3,Mate,White
TRUE,36,20+40,1321,1283,38,C43,6,Resign,Black
TRUE,112,20+40,1334,1253,81,C44,5,Mate,Black
TRUE,6,20+40,1141,1328,-187,C44,5,Resign,Black
TRUE,32,20+40,1321,1167,154,C00,3,Resign,White
TRUE,37,20+40,1307,1381,-74,C44,5,Mate,White
TRUE,46,20+40,1315,1390,-75,C45,7,Resign,Black
TRUE,76,20+40,1302,1349,-47,B27,4,Resign,White
TRUE,83,20+40,1292,1250,42,B00,2,Resign,White
TRUE,100,20+0,1289,1372,-83,C41,5,Draw,Draw
TRUE,45,10+0,1290,1760,-470,B21,3,Resign,Black
TRUE,23,10+0,1316,1301,15,C48,9,Resign,White
TRUE,24,10+0,1303,1705,-402,C45,8,Resign,Black
TRUE,48,10+0,1386,1288,98,C50,9,Resign,Black
TRUE,23,10+0,1730,1290,440,C70,8,Resign,White
TRUE,46,30+10,1299,1356,-57,B01,2,Resign,Black
TRUE,48,30+10,1312,1152,160,C47,7,Resign,Black
TRUE,57,30+10,1303,1294,9,C00,3,Resign,White
TRUE,50,30+10,1314,1295,19,C45,7,Resign,Black
TRUE,46,30+10,1313,1383,-70,C44,5,Mate,Black
TRUE,11,30+10,1301,1394,-93,C47,7,Resign,White
TRUE,45,30+10,1283,1107,176,B27,4,Resign,White
TRUE,16,30+10,1276,1132,144,C00,5,Resign,White
TRUE,61,30+10,1255,1233,22,C40,3,Resign,White
TRUE,38,30+10,1268,1202,66,C47,7,Resign,Black
TRUE,50,30+10,1280,1214,66,B70,10,Resign,Black
TRUE,56,30+10,1269,1338,-69,C44,5,Resign,White
TRUE,80,30+10,1278,1316,-38,C00,3,Resign,Black
TRUE,54,30+10,1266,1307,-41,B07,2,Resign,White
TRUE,54,30+10,1278,1220,58,B02,2,Resign,Black
FALSE,9,10+10,1278,1135,143,B01,2,Resign,Black
TRUE,39,30+10,1266,1295,-29,C45,7,Resign,White
TRUE,45,30+10,1257,1192,65,C47,8,Mate,White
TRUE,25,30+10,1249,1147,102,C46,7,Mate,White
TRUE,66,30+10,1261,1186,75,C47,8,Resign,Black
FALSE,80,15+20,1500,2154,-654,B10,2,Mate,Black
FALSE,43,10+2,1673,1839,-166,B90,11,Resign,White
FALSE,54,10+2,1839,1673,166,C89,16,Out of Time,Black
FALSE,35,10+2,1673,1839,-166,B90,11,Resign,White
FALSE,50,10+2,1839,1673,166,C78,11,Resign,Black
FALSE,23,10+2,1673,1839,-166,B90,11,Resign,White
FALSE,50,10+2,1839,1673,166,E47,9,Resign,Black
TRUE,9,15+0,2181,2327,-146,C10,6,Resign,White
TRUE,115,15+8,2322,2472,-150,A00,5,Draw,Draw
TRUE,69,12+0,2315,2128,187,A00,1,Resign,White
TRUE,77,5+8,2309,2091,218,A00,1,Resign,White
TRUE,102,5+5,2075,2303,-228,D30,4,Mate,Black
FALSE,87,14+10,2303,1286,1017,B00,2,Mate,White
TRUE,130,5+8,2130,2296,-166,C65,8,Resign,Black
TRUE,140,12+3,2293,2282,11,C48,8,Resign,Black
FALSE,90,13+14,1371,2282,-911,A00,1,Mate,Black
TRUE,131,10+0,2273,2138,135,A00,1,Mate,White
TRUE,63,8+5,2267,2022,245,A00,1,Mate,White
TRUE,70,12+1,1433,2267,-834,B01,2,Resign,Black
FALSE,58,5+8,1371,2267,-896,A00,1,Mate,Black
TRUE,122,5+5,1540,2266,-726,D00,2,Mate,Black
TRUE,80,10+0,1301,2266,-965,B01,2,Mate,Black
FALSE,34,5+8,2277,1371,906,B07,3,Out of Time,Black
TRUE,151,10+0,2312,2277,35,D02,4,Out of Time,White
TRUE,58,5+5,2201,2266,-65,C62,6,Resign,Black
TRUE,47,15+0,2258,2123,135,A00,1,Resign,White
TRUE,51,10+2,2250,2119,131,A00,1,Mate,White
TRUE,74,10+2,2126,2240,-114,D03,5,Resign,Black
TRUE,69,9+1,2235,2258,-23,C57,11,Draw,Draw
TRUE,61,15+15,2246,2204,42,A00,1,Resign,White
FALSE,38,5+5,1351,1378,-27,C46,6,Mate,Black
FALSE,38,10+2,1351,1360,-9,C46,5,Mate,Black
FALSE,56,15+8,1060,1351,-291,C42,4,Resign,Black
TRUE,104,8+0,1519,1444,75,B00,4,Out of Time,Black
TRUE,55,8+0,1508,1511,-3,C00,3,Resign,White
TRUE,69,12+0,1568,1517,51,B21,3,Resign,White
TRUE,41,15+5,1594,1526,68,D06,4,Resign,White
TRUE,63,5+5,1609,1534,75,B23,3,Resign,White
TRUE,68,5+8,1526,1445,81,C48,7,Resign,White
TRUE,161,15+0,1513,1601,-88,C64,7,Mate,White
TRUE,40,5+8,1527,1400,127,C45,8,Resign,Black
TRUE,35,15+0,1613,1535,78,D15,7,Resign,White
TRUE,102,7+5,1548,1465,83,C00,3,Resign,Black
TRUE,108,5+5,1507,1529,-22,B86,11,Mate,Black
TRUE,43,10+3,1660,1536,124,B90,10,Resign,White
TRUE,51,15+0,1548,1503,45,C40,3,Resign,Black
TRUE,90,7+2,1566,1536,30,B90,10,Resign,Black
TRUE,50,8+3,1546,1595,-49,C45,7,Resign,Black
TRUE,75,9+9,1532,1640,-108,C44,5,Out of Time,White
TRUE,32,8+4,1458,1524,-66,B20,3,Resign,Black
TRUE,62,10+5,1497,1514,-17,B90,11,Mate,Black
TRUE,60,30+0,1530,1502,28,D02,5,Resign,Black
TRUE,50,10+6,1512,1548,-36,B00,4,Resign,Black
TRUE,56,2+10,1522,1518,4,B46,10,Mate,Black
TRUE,82,8+0,1535,1484,51,C44,5,Out of Time,Black
TRUE,79,6+3,1520,1524,-4,B20,3,Resign,Black
TRUE,49,8+7,1562,1534,28,C50,6,Mate,White
TRUE,70,15+15,1547,1490,57,D15,7,Mate,Black
TRUE,51,15+0,1612,1556,56,B00,3,Resign,White
TRUE,60,10+0,1568,1534,34,C45,7,Resign,Black
TRUE,88,10+0,1544,1558,-14,B11,4,Mate,Black
TRUE,83,10+0,1547,1555,-8,C44,5,Mate,White
TRUE,58,15+10,1758,1530,228,B50,4,Mate,Black
TRUE,26,5+8,1540,1556,-16,C45,7,Resign,Black
TRUE,83,11+0,1554,1456,98,B00,2,Resign,Black
TRUE,98,8+0,1599,1545,54,B00,3,Resign,Black
TRUE,70,10+10,1555,1570,-15,B54,5,Resign,Black
TRUE,36,5+8,1563,1654,-91,C44,5,Resign,Black
TRUE,50,15+0,1577,1483,94,C21,6,Resign,Black
TRUE,86,5+5,1524,1567,-43,B20,3,Out of Time,Black
TRUE,74,10+5,1484,1558,-74,B92,11,Out of Time,Black
TRUE,35,11+5,1546,1601,-55,C02,9,Resign,White
TRUE,65,7+7,1537,1460,77,C42,5,Mate,White
TRUE,71,5+5,1541,1548,-7,B20,3,Resign,White
TRUE,68,15+0,1562,1480,82,C44,5,Resign,Black
TRUE,69,15+0,1471,1576,-105,B20,3,Mate,White
TRUE,80,10+5,1316,1572,-256,B20,2,Resign,Black
TRUE,50,3+15,1585,1502,83,C45,8,Resign,Black
TRUE,53,5+5,1516,1598,-82,B21,3,Resign,White
TRUE,92,5+8,1460,1591,-131,A45,2,Mate,Black
FALSE,76,20+0,1629,1731,-102,B10,3,Resign,Black
FALSE,30,8+4,1500,1629,-129,C45,8,Resign,Black
FALSE,35,10+0,1629,1500,129,C42,8,Resign,White
TRUE,29,10+5,1854,1799,55,B20,3,Resign,Black
FALSE,56,15+0,1891,1854,37,C31,5,Draw,Draw
TRUE,67,5+5,1903,1864,39,C44,5,Resign,White
TRUE,52,15+0,1811,1854,-43,A00,1,Resign,Black
TRUE,73,15+0,1847,1707,140,C41,5,Resign,White
TRUE,60,15+15,1622,1842,-220,C02,10,Resign,Black
FALSE,31,7+8,1374,1500,-126,A00,1,Resign,White
TRUE,77,10+0,1956,1715,241,D00,3,Resign,White
TRUE,53,10+0,1707,1596,111,A40,1,Resign,White
TRUE,59,10+0,1730,1718,12,B54,6,Mate,White
TRUE,130,10+0,1710,2053,-343,E32,7,Draw,Draw
TRUE,142,10+0,1726,1582,144,A40,2,Mate,Black
TRUE,109,10+0,1713,1738,-25,B23,3,Resign,White
TRUE,58,10+0,1431,1735,-304,B50,4,Resign,Black
TRUE,68,10+0,1739,1986,-247,E61,9,Resign,Black
TRUE,44,10+0,1853,1748,105,A13,2,Resign,White
TRUE,68,7+2,1758,1745,13,E20,6,Resign,Black
TRUE,77,10+0,1977,1763,214,D20,4,Mate,White
TRUE,86,10+0,1767,2050,-283,A52,6,Resign,Black
TRUE,56,10+0,1712,1757,-45,B54,6,Mate,Black
TRUE,61,10+0,1741,1874,-133,A40,1,Resign,White
TRUE,81,10+0,1978,1746,232,D20,5,Mate,White
TRUE,60,10+0,1741,1901,-160,E20,6,Mate,Black
TRUE,61,10+0,1729,1726,3,A50,4,Resign,White
TRUE,56,10+0,1738,1717,21,B50,5,Resign,Black
TRUE,55,10+0,1712,1463,249,D06,4,Resign,White
FALSE,32,10+2,1174,1712,-538,B22,3,Mate,Black
FALSE,70,180+25,1500,1076,424,A00,1,Mate,Black
FALSE,36,180+25,1076,1500,-424,A00,1,Mate,Black
FALSE,11,180+25,1500,1076,424,A00,1,Mate,White
TRUE,37,8+0,1115,1219,-104,A00,1,Resign,Black
FALSE,60,8+0,1774,1500,274,A80,3,Mate,Black
FALSE,40,8+0,1500,1774,-274,C26,4,Resign,Black
FALSE,36,8+0,1500,1774,-274,A50,4,Resign,Black
FALSE,67,8+0,1774,1500,274,B50,4,Mate,White
FALSE,124,10+0,1774,1785,-11,B40,6,Out of Time,Black
FALSE,66,10+0,1683,1774,-91,C24,4,Resign,Black
FALSE,43,10+0,1774,1683,91,C46,5,Draw,Draw
FALSE,128,10+0,1683,1774,-91,C23,4,Resign,Black
FALSE,72,10+0,1500,1774,-274,A40,1,Out of Time,Black
TRUE,42,20+0,1500,1769,-269,C20,3,Out of Time,Black
TRUE,73,20+0,1764,1544,220,C46,6,Mate,White
TRUE,32,20+0,1224,1763,-539,C23,4,Mate,Black
TRUE,21,20+0,1756,1569,187,C40,4,Mate,White
TRUE,57,20+0,1753,1441,312,C00,3,Mate,White
TRUE,59,20+0,1745,1598,147,C46,5,Mate,White
TRUE,11,20+0,1727,1711,16,B00,6,Resign,White
TRUE,145,20+0,1599,1744,-145,C20,3,Mate,White
TRUE,17,20+0,1742,1321,421,C55,6,Mate,White
TRUE,30,20+0,1529,1736,-207,A40,3,Resign,Black
TRUE,90,20+0,1577,1730,-153,D02,3,Mate,Black
TRUE,59,20+0,1728,1290,438,B07,3,Mate,White
TRUE,54,15+0,1742,1576,166,C40,4,Resign,Black
TRUE,30,10+0,1484,1738,-254,C21,5,Resign,Black
TRUE,54,10+0,1449,1729,-280,C44,5,Resign,Black
TRUE,15,10+0,1725,1480,245,B01,6,Resign,White
TRUE,20,10+0,1485,1720,-235,C20,3,Resign,Black
TRUE,51,10+0,1714,1489,225,B01,6,Resign,White
TRUE,115,10+0,1579,1731,-152,C50,9,Resign,White
TRUE,80,10+0,1749,1559,190,B00,2,Resign,Black
TRUE,81,10+0,1583,1767,-184,C44,6,Out of Time,White
TRUE,41,10+0,1764,1404,360,C46,8,Resign,White
TRUE,42,10+0,1484,1760,-276,C50,7,Mate,Black
TRUE,55,10+0,1779,1496,283,B01,4,Resign,Black
TRUE,17,10+0,1278,1801,-523,C55,6,Resign,White
FALSE,31,10+0,1139,1801,-662,C50,8,Resign,White
FALSE,73,10+0,1801,1500,301,C41,5,Out of Time,White
FALSE,14,10+0,1500,1801,-301,C44,5,Resign,White
FALSE,23,10+0,1801,1500,301,C40,4,Mate,White
FALSE,99,10+0,1421,1801,-380,C44,5,Out of Time,White
FALSE,87,10+0,1429,1801,-372,A00,1,Out of Time,White
TRUE,3,5+8,1292,1339,-47,D00,3,Draw,Draw
TRUE,109,5+8,1329,1303,26,B01,4,Mate,White
TRUE,44,10+0,1449,1337,112,D02,3,Resign,White
TRUE,57,6+4,1628,1341,287,C22,8,Mate,White
TRUE,15,8+0,1500,1346,154,C55,6,Mate,White
TRUE,53,5+10,1193,1362,-169,C22,8,Resign,White
TRUE,26,10+0,1251,1354,-103,D00,2,Resign,Black
TRUE,106,5+8,1407,1333,74,A40,2,Resign,Black
TRUE,75,6+4,1463,1341,122,C62,6,Mate,White
TRUE,83,15+10,1327,1425,-98,B10,5,Mate,White
TRUE,53,8+2,1544,1332,212,A40,2,Resign,White
TRUE,44,10+0,1341,1409,-68,B20,3,Mate,Black
TRUE,90,8+0,1313,1330,-17,A40,1,Out of Time,Black
TRUE,58,10+7,1337,1532,-195,B00,3,Mate,Black
TRUE,91,5+8,1525,1343,182,C40,4,Mate,White
TRUE,22,10+5,1350,1501,-151,C42,5,Mate,Black
TRUE,41,8+5,1211,1366,-155,C40,4,Mate,White
TRUE,54,10+5,1394,1353,41,C55,7,Resign,Black
TRUE,130,10+10,1364,1373,-9,B20,3,Resign,Black
TRUE,26,10+15,1340,1353,-13,C20,3,Resign,Black
TRUE,42,10+3,1184,1346,-162,C40,4,Resign,Black
TRUE,79,5+10,1354,1483,-129,C25,5,Resign,Black
TRUE,97,5+10,1476,1362,114,C20,3,Mate,White
TRUE,76,5+10,1370,1606,-236,B01,6,Resign,Black
TRUE,125,15+0,1385,1277,108,C00,3,Resign,Black
TRUE,122,10+5,1392,1542,-150,C55,6,Mate,Black
TRUE,86,15+3,1299,1371,-72,C20,3,Out of Time,Black
TRUE,24,15+3,1386,1285,101,C50,5,Resign,Black
TRUE,189,8+8,1545,1393,152,D00,2,Resign,White
TRUE,14,6+4,1654,1397,257,C40,4,Resign,White
FALSE,11,10+0,1500,1397,103,B07,4,Resign,Black
TRUE,46,5+5,1404,1554,-150,C55,6,Mate,Black
TRUE,63,15+0,1393,1427,-34,C01,5,Mate,White
TRUE,69,7+9,1582,1399,183,C20,4,Mate,White
TRUE,114,5+8,1407,1555,-148,C00,3,Resign,Black
TRUE,74,5+8,1571,1389,182,C62,6,Resign,Black
TRUE,48,9+0,1144,1384,-240,C55,6,Mate,Black
TRUE,15,7+9,1576,1390,186,C24,4,Mate,White
TRUE,63,10+0,1565,1397,168,C30,4,Resign,White
TRUE,18,7+7,1400,1712,-312,C41,6,Resign,Black
TRUE,17,7+7,1709,1404,305,C41,5,Mate,White
TRUE,35,10+0,1985,1405,580,C24,4,Mate,White
TRUE,53,5+15,1389,1525,-136,B00,2,Resign,White
TRUE,112,8+9,1394,1610,-216,B01,6,Resign,Black
TRUE,60,8+0,1399,1638,-239,B00,5,Resign,Black
TRUE,166,10+0,2267,1500,767,C12,9,Mate,Black
TRUE,62,10+0,1671,2266,-595,C55,7,Resign,Black
TRUE,67,10+0,2261,1940,321,B95,12,Resign,White
TRUE,56,8+0,1787,2258,-471,C28,7,Resign,Black
TRUE,56,10+0,1563,2258,-695,C46,7,Resign,Black
TRUE,67,10+0,2255,1806,449,D02,11,Resign,White
TRUE,34,10+0,2207,2239,-32,C33,5,Resign,Black
TRUE,42,10+0,1778,2236,-458,C20,3,Resign,Black
TRUE,35,3+8,2230,1942,288,C45,11,Out of Time,White
TRUE,72,3+8,1526,2229,-703,C69,9,Resign,Black
TRUE,27,3+8,2228,1526,702,B21,3,Resign,White
TRUE,36,10+0,2254,2117,137,A40,3,Out of Time,Black
TRUE,68,3+8,1802,2251,-449,C24,4,Resign,Black
TRUE,86,10+0,1857,2247,-390,B21,3,Mate,Black
TRUE,89,10+0,2241,1923,318,A04,2,Mate,White
TRUE,16,10+0,1575,2240,-665,C01,5,Mate,Black
TRUE,57,10+0,2227,2107,120,D74,13,Resign,White
TRUE,28,10+0,1940,2220,-280,D00,3,Resign,Black
TRUE,85,10+0,2213,1900,313,B01,8,Resign,White
TRUE,89,10+0,2211,1731,480,B30,5,Out of Time,White
TRUE,57,10+0,2208,1748,460,D02,4,Mate,White
TRUE,74,10+0,1651,2206,-555,A00,1,Out of Time,Black
TRUE,37,10+0,2203,1718,485,A35,6,Resign,White
TRUE,48,10+0,1418,2203,-785,D04,5,Mate,Black
TRUE,101,10+0,1684,2239,-555,C00,2,Out of Time,White
TRUE,54,10+0,1228,1305,-77,B20,2,Resign,Black
TRUE,44,10+0,1235,1444,-209,C20,3,Mate,Black
TRUE,26,10+0,1324,1215,109,D00,3,Resign,Black
TRUE,33,10+0,1490,1220,270,C21,3,Mate,White
TRUE,74,10+0,1350,1198,152,A06,3,Resign,Black
TRUE,40,10+0,1204,1447,-243,B20,2,Resign,Black
TRUE,29,10+0,1682,1206,476,B01,4,Resign,White
TRUE,73,10+0,1211,1541,-330,B20,2,Resign,Black
TRUE,85,10+0,1215,1546,-331,B20,2,Resign,Black
TRUE,61,10+0,1442,1221,221,A07,3,Mate,White
TRUE,38,10+0,1223,1681,-458,B20,2,Mate,Black
TRUE,75,10+0,1589,1227,362,B00,5,Resign,White
TRUE,37,15+0,1211,1264,-53,B21,3,Mate,White
TRUE,81,5+8,1256,1164,92,B01,4,Mate,White
TRUE,34,7+7,1266,1254,12,B01,2,Resign,Black
TRUE,44,9+5,1279,1207,72,D00,3,Mate,Black
TRUE,69,10+0,1069,1295,-226,A40,2,Mate,White
TRUE,28,15+5,1305,1293,12,C57,8,Resign,Black
TRUE,26,5+8,1189,1298,-109,D04,5,Resign,Black
TRUE,51,5+8,1289,1199,90,C41,4,Resign,White
TRUE,13,8+0,1900,1695,205,C23,4,Resign,White
TRUE,30,8+0,1745,1683,62,A43,3,Resign,Black
TRUE,115,8+0,1752,1744,8,A00,1,Draw,Draw
TRUE,48,8+0,1740,1812,-72,A00,1,Resign,White
TRUE,85,8+0,1735,1749,-14,C00,4,Mate,White
TRUE,82,20+0,2139,1557,582,C50,8,Out of Time,Black
TRUE,95,30+0,1509,1573,-64,C62,6,Draw,Draw
TRUE,157,10+0,1692,1678,14,C45,8,Mate,White
TRUE,30,15+0,1490,1500,-10,C42,5,Resign,Black
TRUE,100,10+0,1621,1487,134,B01,6,Out of Time,Black
TRUE,66,10+0,1498,1503,-5,D00,3,Mate,Black
TRUE,45,10+0,1495,1509,-14,B01,6,Resign,White
TRUE,99,10+0,1499,1468,31,C23,3,Out of Time,White
TRUE,76,10+0,1493,1488,5,D50,7,Mate,Black
TRUE,32,10+0,1498,1533,-35,B20,3,Resign,Black
TRUE,11,10+0,1498,1509,-11,B01,2,Resign,White
TRUE,28,10+0,1522,1456,66,C20,4,Mate,Black
TRUE,18,10+0,1533,1543,-10,B01,6,Resign,Black
TRUE,112,10+0,1527,1357,170,C24,4,Resign,White
TRUE,20,10+0,1500,1520,-20,D00,3,Resign,Black
TRUE,47,15+15,1441,1533,-92,B01,6,Mate,White
TRUE,61,10+0,1459,1547,-88,B01,2,Out of Time,White
TRUE,42,10+0,1389,1540,-151,B01,6,Resign,Black
TRUE,67,10+0,1533,1398,135,C26,5,Resign,White
TRUE,4,10+0,1425,1525,-100,D00,3,Resign,Black
TRUE,48,10+0,1515,1503,12,C20,4,Resign,White
TRUE,96,10+0,1528,1458,70,C24,4,Resign,Black
TRUE,96,10+0,1540,1516,24,B01,6,Out of Time,Black
TRUE,71,10+0,1633,1524,109,B01,2,Out of Time,White
TRUE,28,10+0,1529,1729,-200,C23,3,Resign,Black
TRUE,107,10+0,1520,1468,52,D00,3,Out of Time,White
TRUE,40,10+0,1519,1671,-152,B20,3,Resign,Black
TRUE,58,10+0,1526,1640,-114,B11,4,Mate,Black
TRUE,83,20+0,1738,1633,105,B02,5,Resign,White
TRUE,99,15+0,1500,1897,-397,B07,4,Draw,Draw
TRUE,76,12+10,1222,1234,-12,C50,5,Mate,Black
TRUE,79,8+5,1273,1016,257,D07,4,Mate,White
TRUE,38,10+10,1028,1212,-184,C00,3,Mate,Black
TRUE,32,10+1,1033,1415,-382,B01,2,Mate,Black
TRUE,108,10+0,1037,1541,-504,B01,4,Mate,Black
TRUE,39,10+0,1500,1041,459,A40,4,Mate,White
TRUE,119,7+2,1245,1079,166,A00,1,Mate,White
FALSE,113,10+0,1079,1500,-421,C40,4,Out of Time,White
TRUE,82,10+0,1075,1120,-45,C00,2,Draw,Draw
TRUE,23,10+8,1101,1114,-13,C41,5,Resign,Black
TRUE,95,10+0,1310,1117,193,D00,4,Mate,White
TRUE,11,8+0,1071,1191,-120,C41,5,Resign,White
TRUE,55,10+0,1031,1063,-32,C40,3,Mate,White
TRUE,63,10+0,1199,1054,145,A34,3,Mate,White
TRUE,52,10+0,1089,1152,-63,C55,6,Mate,Black
TRUE,31,7+7,1456,1467,-11,B01,2,Resign,White
TRUE,58,5+8,1478,1488,-10,A03,2,Mate,Black
TRUE,57,7+7,1469,1445,24,A00,1,Resign,White
TRUE,99,10+0,1425,1481,-56,B07,2,Mate,White
TRUE,93,5+15,1687,1487,200,A00,1,Resign,White
TRUE,77,5+10,1496,1543,-47,A00,1,Resign,Black
TRUE,57,7+5,1521,1507,14,B07,2,Out of Time,White
TRUE,53,7+7,1445,1497,-52,C00,4,Resign,Black
TRUE,77,7+7,1487,1457,30,A34,3,Resign,White
TRUE,125,10+8,1545,1497,48,A41,3,Resign,White
TRUE,99,5+8,1485,1519,-34,C20,3,Mate,White
TRUE,110,12+12,1590,1471,119,B00,2,Mate,Black
TRUE,68,7+7,1458,1509,-51,A00,1,Resign,White
TRUE,35,10+0,1885,1460,425,A40,2,Mate,White
TRUE,54,7+7,1473,1381,92,B22,3,Mate,Black
TRUE,128,7+7,1711,1456,255,B00,2,Resign,Black
TRUE,40,7+7,1411,1446,-35,B00,2,Resign,Black
TRUE,68,2+20,1457,1466,-9,D02,3,Mate,Black
TRUE,33,15+5,1537,1464,73,B54,6,Out of Time,White
TRUE,105,12+11,1450,1551,-101,A40,2,Resign,White
TRUE,58,7+7,1453,1796,-343,A06,3,Mate,Black
FALSE,4,10+0,1565,1453,112,B00,2,Resign,White
TRUE,129,5+15,1437,1645,-208,A00,1,Resign,White
TRUE,113,7+7,1623,1442,181,C00,3,Resign,White
TRUE,95,7+7,1372,1456,-84,B06,2,Resign,White
TRUE,74,7+7,1467,1430,37,B07,4,Mate,Black
TRUE,57,5+8,1455,1511,-56,A03,2,Out of Time,White
TRUE,63,7+7,1987,1456,531,B00,2,Mate,White
TRUE,45,45+15,1546,1464,82,C42,6,Mate,White
TRUE,127,10+5,1507,1473,34,B00,2,Mate,White
TRUE,116,7+7,1480,1607,-127,A03,2,Resign,Black
TRUE,48,5+30,1498,1469,29,A04,2,Resign,Black
TRUE,86,7+7,1476,1601,-125,C44,4,Resign,Black
TRUE,32,8+8,1422,1467,-45,A06,3,Resign,Black
TRUE,94,5+8,1477,1484,-7,A00,1,Mate,Black
TRUE,41,3+10,1649,1483,166,A01,3,Mate,White
TRUE,66,30+15,1440,1474,-34,C40,4,Mate,Black
TRUE,69,5+8,1548,1482,66,B00,3,Mate,White
TRUE,93,5+8,1470,1538,-68,D02,4,Out of Time,White
TRUE,70,5+8,1481,1464,17,B06,2,Out of Time,Black
TRUE,121,7+7,1415,1493,-78,A40,1,Resign,White
TRUE,93,10+12,1655,1499,156,C44,5,Out of Time,White
TRUE,89,10+0,1487,1547,-60,D00,2,Mate,White
TRUE,45,7+7,1493,1498,-5,B20,3,Mate,White
TRUE,58,7+7,1471,1488,-17,B00,2,Mate,Black
TRUE,62,10+15,1495,1608,-113,A00,1,Mate,Black
TRUE,70,7+7,1503,1591,-88,C20,3,Resign,Black
TRUE,143,7+7,1494,1453,41,D06,4,Resign,White
TRUE,99,7+7,1619,1501,118,B07,3,Out of Time,White
TRUE,73,15+15,1564,1510,54,B00,2,Resign,White
TRUE,47,15+0,1841,1940,-99,B32,10,Resign,Black
TRUE,33,15+0,1930,1850,80,B32,10,Resign,White
TRUE,72,8+0,1895,1919,-24,B30,4,Resign,Black
FALSE,117,10+0,1919,1502,417,C01,4,Resign,White
TRUE,64,13+0,1961,1930,31,E10,6,Resign,White
TRUE,58,13+0,1942,1951,-9,B01,6,Resign,Black
TRUE,65,15+0,1948,2159,-211,C13,12,Resign,Black
TRUE,38,7+5,1936,1930,6,C11,7,Resign,White
TRUE,38,7+5,1919,1949,-30,A49,4,Resign,White
TRUE,62,10+0,1883,1939,-56,B21,5,Mate,Black
TRUE,35,10+0,1935,1631,304,C45,7,Resign,White
TRUE,36,10+0,1697,1955,-258,B25,4,Resign,White
TRUE,156,10+0,1971,1858,113,C10,8,Out of Time,Black
TRUE,30,10+0,1838,1962,-124,B30,4,Resign,Black
TRUE,76,10+0,1885,1952,-67,A45,2,Resign,Black
TRUE,46,10+0,1821,1970,-149,B31,6,Resign,White
TRUE,62,10+0,1985,1921,64,C41,8,Resign,Black
TRUE,53,10+0,1982,1644,338,C41,5,Mate,White
TRUE,25,10+0,1698,1977,-279,B32,8,Resign,Black
TRUE,43,10+0,1974,1653,321,B15,7,Resign,White
TRUE,67,7+2,1972,1483,489,C40,4,Resign,White
TRUE,110,20+0,1952,1960,-8,E61,6,Resign,Black
TRUE,62,10+0,1689,1981,-292,A57,6,Resign,White
TRUE,62,10+0,1998,1880,118,C18,11,Resign,Black
TRUE,66,10+0,1953,1986,-33,B32,10,Mate,Black
TRUE,142,10+0,1986,1993,-7,C13,12,Draw,Draw
TRUE,19,10+0,1979,1786,193,C18,12,Resign,White
TRUE,120,10+0,1988,1730,258,B78,19,Draw,Draw
TRUE,21,10+0,1906,2004,-98,B30,4,Resign,White
TRUE,78,10+0,1614,2002,-388,B20,3,Resign,Black
TRUE,31,10+0,1999,1590,409,C44,7,Resign,White
TRUE,58,10+0,1824,1992,-168,B20,3,Mate,Black
TRUE,13,10+0,1991,1374,617,C45,8,Resign,White
TRUE,67,10+0,2009,2004,5,B30,4,Resign,White
TRUE,56,10+0,1160,2001,-841,B25,4,Mate,Black
TRUE,85,10+0,1993,1860,133,C00,4,Mate,White
TRUE,81,10+0,2089,2003,86,B32,10,Out of Time,White
FALSE,69,5+5,1387,1397,-10,C28,7,Resign,White
TRUE,64,10+0,1566,2254,-688,D43,8,Mate,Black
TRUE,31,10+0,1524,1160,364,C68,9,Resign,White
FALSE,87,5+8,1524,1500,24,C00,3,Resign,White
FALSE,42,5+8,1500,1524,-24,C44,5,Out of Time,Black
TRUE,66,8+0,1595,1483,112,D00,3,Mate,Black
TRUE,114,8+0,1603,1727,-124,A45,2,Mate,Black
TRUE,80,8+0,1589,1635,-46,A46,5,Resign,White
TRUE,115,5+8,1759,1608,151,A40,2,Mate,White
TRUE,149,2+10,2014,1610,404,C41,6,Mate,White
TRUE,56,2+10,1612,2011,-399,D00,5,Mate,Black
TRUE,54,5+5,1615,1965,-350,D12,8,Mate,Black
TRUE,20,2+10,1617,2028,-411,D00,3,Mate,Black
TRUE,126,8+0,1620,1986,-366,A43,2,Out of Time,Black
TRUE,55,5+8,2108,1623,485,C41,5,Mate,White
TRUE,38,8+0,1640,1567,73,D00,4,Mate,Black
TRUE,103,8+0,1635,1436,199,A41,2,Mate,White
TRUE,72,20+0,1112,1073,39,A46,3,Mate,Black
TRUE,83,20+0,1056,1165,-109,C68,9,Mate,White
TRUE,70,13+13,1201,1275,-74,A00,1,Out of Time,Black
TRUE,101,13+13,1263,1251,12,C20,3,Mate,White
TRUE,111,10+3,1287,1205,82,C40,4,Mate,White
TRUE,48,12+8,1313,1330,-17,C46,6,Mate,Black
TRUE,119,18+0,1465,1500,-35,A40,2,Mate,White
FALSE,106,10+8,1500,1500,0,C23,3,Mate,Black
FALSE,67,10+8,1500,1500,0,B01,4,Mate,White
FALSE,57,10+8,1500,1500,0,B01,3,Mate,White
FALSE,59,10+8,1500,1500,0,C00,3,Mate,White
FALSE,79,10+8,1500,1500,0,B20,3,Resign,White
FALSE,46,10+8,1500,1500,0,A00,1,Mate,Black
FALSE,59,10+8,1500,1500,0,C30,4,Mate,White
TRUE,52,15+10,1309,1305,4,B01,2,Draw,Draw
TRUE,107,15+0,1293,1317,-24,B01,6,Mate,White
TRUE,75,10+5,2007,2184,-177,A42,5,Resign,Black
TRUE,27,15+10,1834,2181,-347,B21,3,Resign,Black
TRUE,50,10+5,1902,2176,-274,B20,3,Mate,Black
TRUE,104,10+0,1425,1174,251,C44,4,Mate,Black
TRUE,11,10+0,1402,1191,211,C61,6,Mate,White
TRUE,21,10+0,1310,1267,43,C42,5,Mate,White
TRUE,55,7+25,1224,1133,91,C00,3,Resign,White
TRUE,45,10+0,1415,1259,156,B00,5,Mate,White
FALSE,79,10+0,1259,1425,-166,C47,8,Resign,White
FALSE,61,15+10,1953,1703,250,E77,8,Resign,White
TRUE,87,16+8,1302,1724,-422,A00,5,Resign,White
TRUE,15,60+7,1720,1383,337,C41,5,Mate,White
TRUE,49,45+0,1716,1309,407,C41,5,Resign,White
TRUE,14,180+0,1224,1148,76,B01,2,Draw,Draw
TRUE,62,180+0,1178,1172,6,C20,3,Mate,Black
TRUE,25,180+0,1093,1195,-102,C21,5,Mate,White
TRUE,34,180+0,1143,1237,-94,C21,3,Resign,Black
TRUE,40,180+0,1053,1060,-7,C11,6,Mate,Black
TRUE,44,180+0,1151,1200,-49,B07,4,Resign,Black
TRUE,28,180+0,1291,1320,-29,D00,3,Resign,Black
FALSE,26,180+0,1317,1291,26,B00,5,Resign,White
FALSE,13,180+0,1493,1291,202,C20,3,Resign,Black
FALSE,47,30+0,1333,1291,42,A45,2,Mate,White
FALSE,119,30+0,1291,1500,-209,B06,2,Draw,Draw
FALSE,35,30+0,1615,1291,324,C60,5,Resign,White
TRUE,8,5+10,1500,1017,483,D00,3,Draw,Draw
FALSE,108,60+0,1574,1500,74,A28,7,Resign,Black
FALSE,57,60+0,1500,1574,-74,B21,3,Resign,White
TRUE,60,15+15,1405,1511,-106,A00,1,Mate,Black
TRUE,42,20+0,1523,1477,46,A43,2,Resign,Black
TRUE,46,11+4,1514,1512,2,D06,4,Resign,Black
TRUE,41,20+0,1496,1546,-50,C21,4,Mate,White
TRUE,24,5+8,1433,1509,-76,A40,2,Resign,White
TRUE,47,10+3,1509,1520,-11,D02,5,Resign,White
TRUE,83,10+0,1515,1301,214,D00,3,Resign,White
TRUE,14,10+2,1396,1507,-111,B20,3,Resign,Black
TRUE,63,10+1,1519,1482,37,D00,3,Resign,Black
TRUE,57,30+10,1531,1521,10,A43,2,Resign,Black
TRUE,57,10+0,1522,1434,88,C10,6,Mate,White
TRUE,29,15+30,1222,1519,-297,A00,1,Resign,Black
TRUE,43,5+8,1461,1532,-71,B32,6,Resign,White
TRUE,48,10+0,1268,1528,-260,B30,4,Mate,Black
TRUE,86,20+0,1540,1505,35,A43,2,Resign,Black
TRUE,99,20+8,1531,1475,56,A45,2,Resign,White
TRUE,57,30+0,1513,1542,-29,D00,4,Resign,White
TRUE,62,15+0,1483,1533,-50,C45,7,Resign,Black
FALSE,80,11+0,1502,1533,-31,C47,8,Mate,Black
TRUE,123,10+0,1489,1545,-56,C44,5,Mate,White
TRUE,43,15+0,1560,1430,130,C01,4,Resign,Black
TRUE,74,15+10,1550,1571,-21,B32,6,Resign,White
TRUE,53,10+5,1562,1503,59,C10,5,Resign,White
TRUE,43,10+8,1576,1352,224,D00,3,Resign,Black
FALSE,59,8+0,1432,1576,-144,B20,3,Mate,White
TRUE,59,10+1,1570,1370,200,B07,7,Mate,White
TRUE,72,10+0,1546,1560,-14,A00,1,Resign,Black
TRUE,77,10+0,1555,1361,194,D00,3,Resign,White
FALSE,66,20+0,1459,1555,-96,A10,2,Mate,Black
TRUE,31,8+0,1496,1568,-72,B50,4,Out of Time,White
TRUE,70,25+0,1527,1558,-31,B21,3,Resign,Black
TRUE,80,10+1,1570,1538,32,A41,2,Mate,Black
TRUE,132,10+0,1583,1496,87,D00,3,Mate,Black
TRUE,43,5+8,1574,1510,64,A80,4,Mate,White
TRUE,40,5+8,1520,1565,-45,B21,3,Mate,Black
TRUE,47,5+8,1554,1530,24,A80,4,Mate,White
TRUE,7,5+8,1549,1344,205,A40,2,Out of Time,White
TRUE,12,5+8,1500,1543,-43,B20,3,Resign,Black
TRUE,70,20+0,1537,1532,5,B30,4,Resign,Black
TRUE,62,8+0,1470,1545,-75,B22,3,Resign,White
TRUE,64,10+0,1556,1550,6,D00,3,Resign,Black
TRUE,62,20+0,1493,1546,-53,A04,2,Mate,Black
TRUE,28,25+0,1519,1536,-17,D04,5,Resign,Black
TRUE,59,10+0,1518,1823,-305,D00,6,Mate,White
TRUE,81,10+0,1529,1528,1,C41,5,Resign,White
TRUE,52,6+10,1539,1533,6,D00,6,Mate,Black
TRUE,81,10+0,1724,1561,163,C48,7,Resign,White
TRUE,11,10+5,1293,1048,245,C42,8,Resign,White
TRUE,9,12+3,1422,1065,357,C20,3,Resign,White
TRUE,7,8+10,1861,1066,795,B01,4,Resign,White
TRUE,32,10+0,1075,1524,-449,A00,1,Mate,Black
TRUE,6,10+0,1102,1323,-221,A00,1,Resign,Black
TRUE,57,10+0,1282,1161,121,A00,1,Mate,White
TRUE,42,10+0,1244,1273,-29,A00,1,Mate,Black
TRUE,47,10+0,1482,1311,171,C00,3,Mate,White
FALSE,25,5+20,1500,1311,189,C40,3,Mate,White
TRUE,152,10+0,1708,1726,-18,B30,5,Mate,Black
TRUE,51,10+0,1759,1737,22,B30,4,Mate,White
TRUE,93,10+0,1725,1742,-17,D10,5,Out of Time,White
TRUE,51,15+0,1484,1743,-259,D01,7,Resign,White
TRUE,49,10+0,1750,1684,66,D37,7,Resign,Black
TRUE,17,10+0,1576,1767,-191,B30,5,Mate,White
TRUE,89,10+0,1771,1588,183,D20,4,Resign,Black
TRUE,75,10+2,1791,1484,307,D15,7,Resign,Black
TRUE,121,10+0,1803,1778,25,D37,9,Resign,Black
TRUE,45,10+0,1805,1815,-10,D08,7,Mate,White
TRUE,44,10+0,1838,1818,20,D10,6,Resign,Black
TRUE,64,10+0,1829,1843,-14,E24,9,Mate,Black
TRUE,116,10+0,1832,1752,80,B06,2,Draw,Draw
TRUE,126,10+0,1616,1826,-210,B20,3,Mate,Black
TRUE,61,10+0,1820,1621,199,D15,7,Resign,White
TRUE,72,10+0,1627,1814,-187,B20,3,Mate,Black
TRUE,41,10+2,1833,1609,224,C80,10,Resign,Black
TRUE,10,10+0,1862,1827,35,B30,5,Resign,Black
TRUE,121,10+0,1817,1839,-22,B30,5,Resign,White
TRUE,45,10+0,1838,1877,-39,E20,8,Draw,Draw
TRUE,88,10+0,1860,1496,364,C67,8,Mate,Black
TRUE,88,10+0,1499,1857,-358,A00,4,Mate,Black
TRUE,93,10+0,1854,1502,352,D15,7,Resign,White
TRUE,58,10+0,1505,1851,-346,B20,3,Resign,Black
TRUE,35,10+0,1860,1863,-3,B30,5,Resign,White
TRUE,60,10+0,1516,1860,-344,B20,3,Mate,Black
TRUE,34,10+0,1857,1519,338,D15,7,Resign,White
TRUE,101,10+0,1854,1523,331,C65,6,Mate,White
TRUE,88,10+0,1526,1850,-324,A01,2,Mate,Black
TRUE,54,10+0,1862,1843,19,E90,11,Resign,Black
TRUE,173,10+0,1954,1859,95,D00,4,Draw,Draw
TRUE,104,10+0,1816,1872,-56,B20,3,Resign,White
TRUE,178,10+0,1872,1876,-4,D43,8,Draw,Draw
TRUE,72,10+0,1830,1861,-31,A11,2,Resign,Black
TRUE,84,10+0,1509,1859,-350,B30,4,Resign,Black
TRUE,71,10+0,1856,1517,339,C60,5,Resign,White
TRUE,71,10+0,1853,1525,328,A06,3,Mate,White
TRUE,49,10+0,1850,1528,322,D11,6,Mate,White
TRUE,50,10+0,1860,1886,-26,A52,7,Mate,Black
TRUE,30,10+0,1871,1865,6,D91,9,Resign,Black
TRUE,69,10+0,1868,1519,349,D43,8,Mate,White
TRUE,142,10+0,1522,1865,-343,B20,3,Out of Time,Black
TRUE,102,10+0,1852,1855,-3,D08,4,Resign,Black
TRUE,58,5+5,1536,1796,-260,C50,5,Resign,Black
TRUE,39,10+0,2162,1538,624,B07,6,Resign,White
TRUE,61,10+0,1509,1482,27,C57,8,Resign,White
TRUE,39,10+0,1467,1563,-96,B09,7,Resign,White
TRUE,118,10+0,1474,1839,-365,C50,5,Resign,Black
TRUE,24,15+0,1327,1450,-123,C55,6,Resign,Black
TRUE,14,15+0,1338,1356,-18,C20,3,Resign,Black
TRUE,20,15+0,1355,1450,-95,C01,5,Resign,Black
TRUE,11,15+0,1147,1355,-208,C20,3,Resign,Black
TRUE,12,15+0,1341,1421,-80,C20,3,Resign,White
TRUE,111,15+0,1458,1373,85,C65,6,Resign,White
TRUE,36,15+0,1360,1388,-28,C20,3,Resign,White
TRUE,41,15+0,1401,1346,55,C44,5,Resign,Black
TRUE,26,15+0,1353,1542,-189,B01,6,Resign,Black
TRUE,29,15+0,1333,1586,-253,C00,3,Mate,White
TRUE,49,15+0,1753,1335,418,A10,2,Out of Time,White
TRUE,38,15+0,1337,1720,-383,C20,3,Mate,Black
TRUE,23,15+0,1718,1340,378,C34,6,Resign,White
TRUE,46,15+0,1347,1677,-330,C20,4,Mate,Black
TRUE,55,15+0,1391,1345,46,C42,6,Resign,Black
TRUE,100,15+0,1351,1674,-323,C20,3,Mate,Black
TRUE,63,15+0,1524,1358,166,C50,8,Resign,White
TRUE,46,15+0,1362,1650,-288,C20,3,Mate,Black
TRUE,49,15+0,1646,1365,281,C24,4,Resign,White
TRUE,47,15+0,1456,1369,87,C61,6,Resign,Black
TRUE,35,15+0,1378,1447,-69,C20,3,Resign,Black
TRUE,23,15+0,1461,1364,97,C65,6,Resign,Black
TRUE,4,15+0,1141,1358,-217,D00,3,Resign,Black
TRUE,7,15+0,1353,1148,205,C20,3,Resign,White
TRUE,26,15+7,1429,1333,96,C55,11,Resign,Black
TRUE,47,15+7,1323,1281,42,B57,8,Mate,White
TRUE,26,15+7,1334,1345,-11,B02,4,Out of Time,Black
TRUE,22,15+7,1360,1332,28,A00,1,Mate,Black
TRUE,70,15+7,1332,1372,-40,C20,3,Mate,Black
TRUE,52,15+7,1363,1623,-260,C01,5,Resign,Black
FALSE,44,20+60,2367,1760,607,A45,2,Resign,White
TRUE,104,10+0,1446,1436,10,B07,7,Resign,Black
TRUE,67,10+0,1424,1421,3,C50,5,Resign,Black
TRUE,43,2+10,1270,1277,-7,B07,3,Mate,White
TRUE,37,45+1,1597,1500,97,A40,2,Resign,Black
FALSE,47,8+0,1598,1500,98,C42,8,Out of Time,White
TRUE,34,15+0,1159,1745,-586,B01,4,Out of Time,Black
TRUE,26,15+0,1744,1163,581,C65,6,Resign,White
TRUE,56,10+0,1305,1497,-192,C34,6,Out of Time,Black
TRUE,42,7+7,1385,1740,-355,B00,2,Mate,Black
TRUE,33,15+0,1786,1817,-31,B46,10,Resign,Black
FALSE,46,10+0,1494,1817,-323,E10,5,Mate,Black
FALSE,17,10+0,1817,1494,323,D20,7,Mate,White
FALSE,44,10+0,1494,1817,-323,E00,5,Mate,Black
TRUE,98,10+0,2227,2271,-44,C77,9,Resign,Black
TRUE,112,10+0,2273,2225,48,B50,4,Draw,Draw
TRUE,63,10+0,2277,2235,42,D45,10,Resign,White
TRUE,100,10+0,2245,2264,-19,C00,4,Resign,Black
TRUE,61,10+0,2279,2255,24,B76,17,Resign,White
TRUE,77,10+0,2242,2305,-63,B25,11,Resign,White
TRUE,93,10+0,2263,2253,10,B52,6,Resign,White
TRUE,68,10+0,2252,2295,-43,B23,3,Draw,Draw
TRUE,164,10+0,2239,2241,-2,B76,17,Mate,Black
TRUE,71,10+0,2232,2252,-20,B72,11,Resign,White
TRUE,55,10+0,2241,2244,-3,B03,9,Resign,White
TRUE,90,10+0,2231,2230,1,B72,11,Resign,Black
TRUE,52,10+0,2239,2321,-82,B23,6,Resign,Black
TRUE,39,30+0,1758,1387,371,B23,5,Mate,White
TRUE,80,30+0,1389,1755,-366,C70,8,Mate,Black
TRUE,69,15+0,1330,1403,-73,B20,3,Mate,White
TRUE,34,15+0,1412,1492,-80,B50,4,Resign,Black
TRUE,56,15+0,1426,1357,69,C40,3,Resign,Black
TRUE,107,8+0,1462,1437,25,B80,10,Resign,White
TRUE,42,30+0,1449,1463,-14,C44,6,Resign,Black
TRUE,79,20+0,1548,1458,90,B20,3,Mate,White
FALSE,49,15+0,1458,1459,-1,C62,6,Mate,White
TRUE,77,30+0,1526,1443,83,D00,3,Resign,Black
TRUE,56,8+0,1428,1510,-82,B06,6,Resign,White
FALSE,38,10+0,1500,1428,72,A00,1,Resign,Black
TRUE,84,10+0,1432,1700,-268,B30,5,Resign,Black
TRUE,87,10+0,1629,1439,190,D01,4,Resign,White
TRUE,103,10+0,1879,1441,438,B21,3,Resign,White
TRUE,95,10+0,1422,1635,-213,C70,8,Out of Time,White
TRUE,89,30+0,1412,1344,68,B06,4,Mate,White
TRUE,39,10+0,2003,1413,590,D02,4,Resign,White
TRUE,47,10+0,1407,1222,185,C61,6,Resign,White
FALSE,19,10+0,1348,1407,-59,B20,3,Resign,Black
FALSE,81,20+0,1407,1347,60,C78,9,Resign,Black
FALSE,44,10+0,1492,1407,85,D00,3,Resign,White
FALSE,32,15+0,1500,1407,93,A00,1,Resign,Black
FALSE,37,10+0,1500,1407,93,D02,4,Resign,White
TRUE,69,15+0,1413,1419,-6,D45,9,Mate,White
FALSE,79,30+0,1419,1500,-81,C67,8,Resign,Black
TRUE,109,15+0,1417,1463,-46,C65,8,Draw,Draw
TRUE,53,10+0,1421,1430,-9,B40,5,Resign,White
TRUE,38,10+0,1417,1417,0,B20,2,Mate,Black
TRUE,32,10+0,1422,1706,-284,B00,2,Resign,Black
TRUE,71,10+0,1864,1398,466,B21,3,Resign,Black
TRUE,31,10+0,1443,1410,33,B21,3,Mate,White
TRUE,92,10+0,1411,1916,-505,D02,4,Resign,Black
TRUE,60,10+0,1412,1398,14,B23,4,Resign,Black
TRUE,83,10+0,1409,1468,-59,C41,4,Resign,Black
TRUE,103,10+0,1739,1412,327,D43,8,Resign,White
TRUE,51,10+0,1439,1390,49,B43,9,Resign,Black
FALSE,34,20+0,1500,1500,0,A00,2,Out of Time,Black
FALSE,4,10+2,1500,1829,-329,A02,2,Mate,Black
FALSE,18,8+1,1500,1500,0,A00,1,Resign,Black
TRUE,20,30+0,1679,1640,39,C00,2,Out of Time,Black
TRUE,42,10+0,1769,1624,145,D00,3,Resign,Black
TRUE,151,20+11,1632,1621,11,A53,4,Draw,Draw
TRUE,126,10+3,1568,1622,-54,A10,2,Resign,Black
TRUE,51,5+12,1755,1630,125,C02,9,Resign,White
TRUE,67,10+60,1615,1731,-116,D20,5,Resign,White
TRUE,46,5+8,1781,1598,183,C00,3,Resign,Black
TRUE,30,10+5,1625,1668,-43,D11,5,Resign,Black
TRUE,123,10+30,1980,1627,353,C00,3,Resign,White
TRUE,76,10+0,1555,1618,-63,C11,7,Resign,Black
TRUE,44,10+0,1614,1318,296,A43,2,Resign,White
TRUE,112,10+0,1587,1604,-17,C00,3,Mate,Black
TRUE,60,10+10,1608,1875,-267,A40,2,Out of Time,Black
TRUE,18,10+0,1347,1604,-257,C02,6,Resign,Black
TRUE,49,10+0,1520,1595,-75,C00,3,Resign,Black
TRUE,69,15+15,1614,1607,7,D02,8,Resign,White
TRUE,66,10+10,1589,1604,-15,D00,3,Resign,Black
TRUE,50,15+15,1616,1802,-186,D30,4,Mate,Black
TRUE,46,15+15,1474,1609,-135,C02,7,Resign,Black
TRUE,60,15+15,1621,1566,55,D10,4,Resign,Black
TRUE,52,10+0,1631,1665,-34,D06,4,Resign,Black
TRUE,52,10+0,1545,1622,-77,C02,9,Mate,Black
TRUE,51,10+0,1636,1633,3,C02,6,Mate,White
TRUE,27,5+5,1631,1284,347,D06,4,Resign,White
TRUE,32,20+1,1743,1616,127,C00,3,Resign,Black
TRUE,39,20+1,1600,1761,-161,D20,5,Resign,White
TRUE,49,10+0,1629,1611,18,C02,9,Resign,White
TRUE,158,10+0,1675,1597,78,D15,7,Mate,Black
TRUE,51,10+0,1590,1461,129,A41,2,Resign,White
TRUE,94,10+0,1316,1586,-270,C00,3,Resign,Black
TRUE,102,10+0,1555,1569,-14,D30,6,Mate,Black
TRUE,135,20+15,1555,1454,101,D20,5,Mate,White
TRUE,55,10+0,1548,1567,-19,C02,9,Mate,White
TRUE,55,30+2,1555,1576,-21,D20,5,Resign,White
TRUE,95,5+9,1562,1715,-153,A54,6,Resign,Black
TRUE,69,10+0,1812,1575,237,C01,5,Resign,White
TRUE,31,10+0,1306,1409,-103,D00,3,Mate,White
TRUE,34,10+0,1411,1953,-542,C22,7,Mate,Black
FALSE,57,10+0,1764,1411,353,C44,5,Mate,White
TRUE,57,10+0,1908,1414,494,D00,3,Resign,White
TRUE,57,10+0,1657,1384,273,D00,4,Mate,White
TRUE,114,10+0,1570,1440,130,D30,4,Resign,White
TRUE,27,10+0,1405,1437,-32,D00,3,Resign,White
TRUE,39,10+0,1670,1485,185,D37,7,Resign,White
TRUE,26,10+0,1487,2097,-610,D01,4,Resign,Black
TRUE,55,10+0,1461,1388,73,A34,3,Mate,White
FALSE,35,150+8,1500,1505,-5,C48,8,Resign,White
FALSE,4,150+8,1505,1500,5,D01,4,Draw,Draw
FALSE,26,30+30,1496,1505,-9,B02,4,Resign,White
TRUE,33,10+0,1581,1545,36,D06,4,Resign,White
TRUE,139,10+0,1714,1577,137,D06,4,Mate,White
TRUE,67,15+15,1039,1070,-31,C00,3,Resign,White
TRUE,118,10+6,1077,1299,-222,A00,1,Mate,Black
TRUE,67,180+180,970,1065,-95,C00,2,Resign,Black
TRUE,104,7+3,1962,2091,-129,C02,9,Resign,Black
TRUE,73,5+5,1884,1870,14,B21,5,Out of Time,White
TRUE,85,15+0,1686,2166,-480,E42,9,Resign,White
TRUE,14,5+180,1774,1648,126,C10,8,Draw,Draw
TRUE,81,8+0,1348,1272,76,C46,7,Out of Time,White
TRUE,45,8+0,1257,1362,-105,C48,8,Mate,White
TRUE,33,15+0,1352,1352,0,C42,5,Mate,White
TRUE,103,10+0,1546,1357,189,C65,6,Resign,White
TRUE,59,10+0,1357,1369,-12,C68,7,Resign,Black
TRUE,30,5+5,1371,1270,101,C40,4,Mate,Black
TRUE,27,5+5,1279,1363,-84,B00,5,Resign,Black
TRUE,83,10+0,1354,1289,65,B13,5,Resign,White
TRUE,76,10+0,1319,1343,-24,D00,3,Mate,Black
FALSE,50,10+0,1500,1500,0,B20,3,Resign,Black
FALSE,53,10+0,1500,1500,0,C44,5,Resign,White
TRUE,60,5+8,1948,1864,84,B12,5,Resign,White
TRUE,23,5+8,1292,1947,-655,D30,4,Resign,Black
TRUE,23,5+8,1941,1687,254,B02,6,Out of Time,White
TRUE,89,5+8,1938,1500,438,C53,7,Mate,White
TRUE,59,5+8,1925,1839,86,B07,3,Mate,White
TRUE,92,5+8,1853,1912,-59,B21,12,Resign,Black
TRUE,37,5+8,1898,1852,46,B45,9,Resign,White
TRUE,62,5+8,1432,1895,-463,B21,3,Mate,Black
TRUE,75,5+8,1916,1911,5,D00,2,Resign,White
TRUE,24,5+8,1932,1839,93,B88,12,Resign,Black
TRUE,17,5+8,1925,1698,227,B01,4,Resign,White
TRUE,66,5+8,1703,1916,-213,B51,5,Resign,Black
TRUE,29,5+8,1916,1072,844,C00,3,Mate,White
TRUE,63,5+8,1913,1463,450,B00,2,Mate,White
TRUE,74,5+8,1465,1910,-445,B20,2,Resign,Black
TRUE,54,5+8,1941,1605,336,C00,3,Resign,Black
TRUE,22,5+8,1608,1936,-328,A00,3,Resign,Black
TRUE,82,5+8,1576,1931,-355,B56,10,Resign,Black
TRUE,53,5+8,1927,1565,362,C00,4,Resign,White
TRUE,84,10+0,1528,1519,9,D06,4,Resign,Black
TRUE,96,10+0,1531,1430,101,A43,3,Draw,Draw
TRUE,36,10+0,1669,1538,131,A00,1,Resign,White
TRUE,45,10+0,1545,1658,-113,A40,2,Resign,Black
TRUE,32,10+0,1607,1554,53,B20,3,Resign,White
TRUE,12,10+0,1564,1598,-34,D02,4,Resign,Black
TRUE,43,10+0,1527,1565,-38,B21,12,Draw,Draw
TRUE,100,10+0,1635,1574,61,B20,3,Resign,White
TRUE,61,10+0,1425,1589,-164,B20,2,Resign,White
TRUE,84,10+0,1589,1606,-17,D06,4,Draw,Draw
TRUE,102,10+0,1570,1600,-30,B90,11,Resign,White
TRUE,62,10+0,1600,1636,-36,D11,5,Mate,Black
TRUE,111,10+0,1783,1595,188,D02,3,Draw,Draw
TRUE,89,10+0,1583,1622,-39,D06,4,Mate,White
TRUE,37,10+0,1370,1600,-230,B50,4,Resign,White
TRUE,49,10+0,1593,1503,90,A84,3,Resign,White
TRUE,38,10+0,1573,1604,-31,D30,4,Resign,White
TRUE,19,10+0,1596,1502,94,D20,5,Out of Time,White
TRUE,33,10+0,1500,1605,-105,B50,4,Resign,White
TRUE,112,10+0,1635,1593,42,D00,3,Out of Time,Black
TRUE,12,10+0,1625,1603,22,D00,3,Resign,White
TRUE,54,10+0,1610,1750,-140,E76,13,Resign,Black
TRUE,53,10+0,1606,1620,-14,B92,11,Resign,White
TRUE,71,10+0,1610,1606,4,D08,10,Mate,White
TRUE,73,10+0,1599,1609,-10,D08,10,Resign,White
TRUE,56,10+0,1616,1588,28,D37,7,Resign,Black
TRUE,50,10+0,1577,1594,-17,E38,8,Resign,White
TRUE,92,10+0,1712,1563,149,B20,3,Out of Time,Black
TRUE,41,10+0,1552,1567,-15,D35,7,Resign,White
TRUE,57,10+0,1540,1579,-39,D30,4,Resign,White
TRUE,64,10+0,1528,1530,-2,B20,3,Mate,Black
TRUE,41,10+0,1504,1541,-37,D50,7,Resign,White
TRUE,56,10+0,1552,1530,22,A10,2,Resign,Black
TRUE,50,10+0,1543,1456,87,D08,4,Out of Time,Black
TRUE,55,10+0,1528,1708,-180,A53,4,Resign,White
TRUE,33,10+0,1532,1538,-6,D30,4,Resign,White
TRUE,41,10+0,1491,1541,-50,B20,2,Resign,White
TRUE,56,10+0,1453,1533,-80,B20,3,Resign,Black
TRUE,65,10+0,1527,1381,146,D11,5,Resign,White
TRUE,38,10+0,1535,1602,-67,E76,9,Resign,Black
TRUE,154,10+0,1554,1535,19,B90,11,Draw,Draw
TRUE,8,10+0,1576,1636,-60,A00,5,Resign,Black
TRUE,8,10+0,1593,1348,245,A21,3,Mate,Black
TRUE,70,9+0,1606,1531,75,A01,3,Mate,Black
TRUE,72,8+0,1615,1678,-63,A01,2,Mate,Black
TRUE,59,8+0,1675,1624,51,B01,6,Resign,White
TRUE,88,8+0,1635,1625,10,A01,5,Mate,Black
TRUE,77,8+0,1625,1619,6,A01,2,Out of Time,White
TRUE,87,8+0,1612,1680,-68,A01,3,Mate,White
TRUE,38,8+0,1620,1709,-89,A01,2,Mate,Black
TRUE,50,10+2,1637,1408,229,A01,5,Mate,Black
TRUE,40,5+8,1636,1614,22,A01,2,Resign,Black
TRUE,30,10+5,1620,1817,-197,A21,4,Resign,Black
TRUE,63,8+0,1588,1632,-44,D30,4,Mate,White
TRUE,71,5+5,1619,1644,-25,D02,4,Mate,White
TRUE,125,8+5,1653,1716,-63,A21,3,Resign,Black
TRUE,21,5+8,1783,1660,123,D10,5,Resign,White
TRUE,79,5+8,1806,1667,139,B01,6,Mate,White
FALSE,39,5+5,1667,1352,315,A10,4,Resign,White
TRUE,88,10+0,1751,1744,7,A45,2,Mate,Black
TRUE,55,10+0,1711,1757,-46,A60,6,Resign,White
TRUE,88,10+0,1768,1743,25,C00,3,Resign,Black
TRUE,75,10+0,1766,1852,-86,B44,9,Draw,Draw
TRUE,67,15+0,1581,1798,-217,D07,5,Resign,White
TRUE,19,8+0,1572,1454,118,A41,2,Resign,White
TRUE,44,10+0,1606,1571,35,D02,4,Out of Time,Black
TRUE,53,10+0,1563,1462,101,D31,5,Resign,White
TRUE,24,10+0,1468,1553,-85,D30,4,Resign,Black
TRUE,90,10+0,1562,1651,-89,D37,7,Resign,Black
TRUE,14,10+0,1570,1705,-135,D07,6,Resign,Black
TRUE,13,15+0,913,1058,-145,C44,4,Resign,Black
TRUE,39,17+0,1154,920,234,B00,2,Resign,White
TRUE,40,6+6,1417,921,496,A00,2,Resign,White
TRUE,58,20+0,930,1099,-169,C00,2,Resign,Black
TRUE,19,10+8,1208,936,272,B06,2,Resign,White
TRUE,21,20+0,944,1151,-207,C47,7,Resign,Black
TRUE,14,5+8,948,1271,-323,C46,6,Resign,Black
TRUE,45,15+15,951,1367,-416,C50,7,Resign,Black
TRUE,24,13+5,1200,958,242,B20,3,Resign,White
TRUE,3,15+0,815,982,-167,C40,3,Resign,White
TRUE,27,5+8,999,967,32,C40,4,Resign,Black
TRUE,7,15+0,1470,1001,469,B20,3,Mate,White
TRUE,49,15+0,967,1491,-524,C46,5,Mate,White
TRUE,23,15+0,1490,969,521,B20,2,Resign,White
TRUE,28,7+8,976,1226,-250,C34,6,Resign,Black
TRUE,9,15+8,1240,982,258,B20,3,Mate,White
TRUE,37,15+0,1421,985,436,B27,4,Resign,White
FALSE,48,30+5,985,1172,-187,B01,2,Mate,Black
FALSE,25,30+5,1172,985,187,A40,2,Mate,White
TRUE,20,15+5,1299,991,308,C20,3,Resign,White
TRUE,69,10+2,967,1078,-111,C00,3,Resign,White
TRUE,53,180+0,1427,970,457,C57,7,Resign,White
TRUE,62,10+0,1289,1732,-443,C00,3,Mate,Black
TRUE,55,10+0,1940,1738,202,C00,3,Resign,White
TRUE,102,10+0,1927,1718,209,C00,3,Mate,Black
TRUE,57,10+0,1706,1700,6,D20,5,Resign,White
TRUE,41,10+0,1696,1623,73,E20,5,Out of Time,White
TRUE,41,10+0,1906,1702,204,C00,3,Mate,White
TRUE,123,10+0,1694,1545,149,A41,3,Resign,White
TRUE,73,10+0,1685,1579,106,D08,4,Out of Time,White
TRUE,45,10+0,1957,1688,269,D31,6,Resign,White
TRUE,75,10+0,1922,1693,229,C10,8,Resign,White
TRUE,77,10+0,1692,1219,473,D10,4,Mate,White
TRUE,123,10+0,1840,1699,141,C01,7,Resign,White
TRUE,88,10+0,1720,1383,337,A41,6,Out of Time,Black
TRUE,75,10+0,1716,1732,-16,C01,5,Resign,White
TRUE,36,10+0,1754,1263,491,A40,2,Out of Time,Black
TRUE,45,10+0,2021,1759,262,C01,5,Resign,White
TRUE,97,10+0,1740,1920,-180,E50,10,Mate,White
TRUE,85,10+0,1695,1754,-59,C10,8,Resign,White
TRUE,41,10+0,1735,1929,-194,E50,10,Resign,White
TRUE,22,10+0,1615,1727,-112,C00,3,Resign,Black
TRUE,48,10+0,1731,1978,-247,E56,14,Resign,Black
TRUE,61,10+0,1905,1738,167,C01,5,Resign,White
TRUE,74,10+0,1731,1560,171,D06,4,Resign,White
TRUE,41,10+0,1721,1661,60,E61,6,Resign,White
TRUE,101,10+0,1912,1713,199,C00,3,Resign,White
TRUE,99,10+0,1898,1719,179,C02,11,Resign,White
TRUE,50,10+0,1724,1958,-234,E56,14,Resign,Black
TRUE,44,10+0,1599,1716,-117,A40,2,Resign,Black
TRUE,59,10+0,1707,1586,121,A50,3,Out of Time,White
TRUE,72,10+0,1725,1457,268,A56,4,Resign,Black
TRUE,97,10+0,1717,1985,-268,E61,4,Draw,Draw
TRUE,37,10+0,1757,1728,29,D30,4,Resign,White
TRUE,95,10+0,1724,1438,286,D30,4,Out of Time,White
TRUE,50,10+0,1728,2027,-299,A40,4,Resign,Black
TRUE,49,10+0,1841,1737,104,C10,8,Resign,White
TRUE,40,10+0,1748,1764,-16,D08,7,Mate,Black
TRUE,73,10+0,1321,1771,-450,C00,5,Mate,White
TRUE,39,10+0,1770,1249,521,D20,5,Mate,White
TRUE,60,10+0,1334,1768,-434,C02,7,Mate,Black
TRUE,108,10+0,1426,1764,-338,C00,3,Mate,Black
TRUE,39,10+0,1761,1415,346,D94,9,Resign,White
TRUE,24,7+3,1387,1546,-159,C50,5,Resign,White
TRUE,27,7+3,1542,1284,258,C00,3,Mate,White
TRUE,80,7+3,1346,1536,-190,A00,1,Mate,Black
TRUE,33,7+3,1529,1500,29,A40,2,Mate,White
FALSE,21,20+5,1981,1109,872,C30,3,Out of Time,White
TRUE,71,12+10,1451,1135,316,C41,5,Mate,White
TRUE,64,30+5,1143,1718,-575,A00,1,Mate,Black
TRUE,17,20+0,1233,1257,-24,B00,2,Mate,White
FALSE,67,20+180,1470,1257,213,D00,4,Resign,Black
TRUE,10,10+15,1414,1159,255,B06,4,Draw,Draw
TRUE,76,8+8,1500,1250,250,A00,1,Mate,Black
TRUE,57,15+0,1073,1242,-169,C68,8,Resign,White
FALSE,43,15+5,2334,1346,988,B00,3,Mate,White
FALSE,76,25+0,1364,1500,-136,B21,3,Resign,White
FALSE,76,5+8,1500,1500,0,C46,6,Mate,Black
FALSE,118,20+60,1500,1500,0,B08,8,Mate,Black
TRUE,137,180+180,1337,1662,-325,A00,1,Resign,White
TRUE,59,180+180,1500,1500,0,C20,3,Mate,White
FALSE,8,20+30,2077,1629,448,D35,7,Resign,White
TRUE,115,10+0,1304,1287,17,D00,3,Out of Time,Draw
TRUE,96,10+0,1317,1246,71,C20,3,Mate,Black
TRUE,66,10+0,1277,1307,-30,C41,5,Mate,Black
TRUE,123,10+0,1296,1315,-19,C20,3,Mate,White
TRUE,89,10+0,1267,1307,-40,C41,5,Mate,White
FALSE,74,10+0,1344,1294,50,B20,2,Mate,Black
TRUE,60,8+0,1307,1218,89,A00,1,Out of Time,Black
TRUE,57,8+0,1295,1304,-9,A00,1,Out of Time,White
TRUE,61,8+0,1327,1305,22,A01,1,Out of Time,White
TRUE,64,10+0,1235,1296,-61,A00,1,Out of Time,Black
TRUE,119,10+0,1449,1331,118,B01,4,Mate,White
TRUE,69,5+8,1557,1466,91,C20,4,Mate,White
TRUE,69,15+0,1849,1903,-54,A01,2,Resign,White
TRUE,25,15+0,1816,1820,-4,A01,4,Resign,White
TRUE,62,15+1,1801,1778,23,B23,3,Resign,Black
TRUE,45,15+0,1734,1784,-50,A01,2,Resign,White
TRUE,49,15+0,1696,1652,44,A01,2,Resign,White
TRUE,36,15+0,1640,1692,-52,A01,1,Resign,White
TRUE,89,15+0,1581,1601,-20,C20,3,Resign,White
TRUE,45,15+0,1539,1500,39,A27,5,Mate,White
TRUE,57,15+0,1421,1696,-275,C20,3,Resign,White
TRUE,79,15+0,1317,1423,-106,B23,3,Resign,White
TRUE,56,15+0,1369,1542,-173,A16,4,Resign,Black
TRUE,22,15+0,1465,1533,-68,B88,12,Resign,Black
TRUE,143,10+0,1500,1429,71,C41,5,Draw,Draw
TRUE,114,10+0,1715,1726,-11,A46,5,Resign,Black
TRUE,110,5+6,1679,1705,-26,C45,7,Resign,Black
TRUE,125,15+0,1692,1730,-38,B12,5,Resign,White
TRUE,115,15+0,1817,1688,129,C42,7,Draw,Draw
TRUE,31,15+0,1662,1701,-39,D30,4,Resign,White
TRUE,80,10+0,1711,1759,-48,B06,2,Mate,Black
TRUE,7,10+0,1858,1718,140,B30,4,Resign,White
TRUE,88,10+0,1605,1710,-105,E00,5,Mate,Black
TRUE,70,10+0,1716,1886,-170,B13,5,Resign,Black
TRUE,34,10+0,1252,1714,-462,D00,3,Mate,Black
TRUE,78,10+0,1703,1703,0,A00,1,Resign,Black
TRUE,99,10+0,1700,1715,-15,D85,13,Resign,White
TRUE,143,10+0,1705,1655,50,C78,10,Mate,White
TRUE,74,10+0,1712,1848,-136,B30,4,Resign,Black
TRUE,64,10+0,1652,1702,-50,A15,2,Resign,Black
TRUE,139,10+0,1701,1621,80,C70,8,Mate,White
TRUE,53,15+0,1359,1342,17,C57,8,Resign,White
TRUE,55,12+0,1640,1346,294,C46,7,Resign,White
TRUE,66,10+0,1360,1330,30,C48,7,Resign,Black
TRUE,40,10+0,1374,1351,23,C40,4,Resign,Black
TRUE,50,13+0,1362,1312,50,C00,3,Resign,White
TRUE,56,13+0,1323,1350,-27,A40,3,Mate,Black
TRUE,74,10+0,1320,1336,-16,C50,9,Out of Time,Black
FALSE,86,10+0,1336,1292,44,C46,5,Resign,Black
TRUE,55,10+0,1354,1252,102,C49,8,Resign,Black
TRUE,31,15+0,1361,1555,-194,B40,5,Resign,Black
TRUE,5,10+0,1357,1471,-114,A06,3,Draw,Draw
FALSE,31,15+0,1423,1357,66,D00,3,Resign,White
TRUE,63,20+0,1343,1326,17,C48,9,Resign,White
TRUE,61,10+0,1330,1278,52,C41,4,Mate,White
TRUE,75,15+0,1425,1342,83,C45,8,Resign,White
TRUE,60,30+0,1364,1192,172,C20,2,Resign,Black
TRUE,54,30+0,1199,1355,-156,C46,6,Resign,Black
TRUE,101,15+0,1314,1295,19,C40,6,Mate,White
TRUE,45,12+0,1276,1333,-57,C44,4,Resign,White
TRUE,90,12+0,1351,1332,19,C46,5,Mate,Black
TRUE,49,12+0,1342,1145,197,C40,4,Out of Time,White
TRUE,58,12+0,1322,1340,-18,C46,5,Resign,White
TRUE,121,10+0,1107,1332,-225,C49,8,Draw,Draw
TRUE,31,10+0,2109,1659,450,D11,5,Resign,White
TRUE,118,10+0,2057,2093,-36,B01,4,Resign,Black
TRUE,70,10+0,1839,2085,-246,B01,2,Resign,Black
TRUE,27,10+0,2084,1517,567,E06,9,Mate,White
TRUE,76,10+0,2054,2066,-12,B01,4,Resign,Black
TRUE,12,10+0,2093,1932,161,D02,8,Resign,Black
FALSE,38,10+15,2093,1711,382,A15,3,Resign,Black
FALSE,101,10+15,2093,1806,287,D43,8,Resign,White
TRUE,98,10+0,1743,2088,-345,A00,3,Mate,Black
TRUE,39,10+0,2084,1721,363,E91,11,Resign,White
FALSE,2,15+0,1500,1382,118,D00,2,Out of Time,Black
FALSE,26,15+0,1172,1500,-328,D00,3,Out of Time,Black
TRUE,52,30+0,1561,1496,65,C01,9,Resign,Black
TRUE,37,60+0,1614,1571,43,C45,7,Mate,White
TRUE,108,20+0,1445,1564,-119,A04,2,Mate,Black
TRUE,55,20+0,1556,1453,103,B22,3,Mate,White
TRUE,86,15+0,1567,1550,17,C01,9,Resign,Black
TRUE,33,15+0,1671,1575,96,C50,7,Resign,White
TRUE,70,15+15,1584,1669,-85,C11,7,Resign,Black
TRUE,41,15+15,1580,1283,297,B01,8,Resign,White
FALSE,50,15+15,1580,1958,-378,C50,6,Draw,Draw
FALSE,32,15+15,1710,1580,130,A01,2,Mate,Black
TRUE,52,15+15,1500,1589,-89,C68,8,Resign,White
TRUE,84,30+0,1580,1578,2,D15,8,Mate,Black
TRUE,41,10+5,1693,1586,107,C20,2,Mate,White
TRUE,29,15+10,1584,1648,-64,C55,7,Draw,Draw
TRUE,40,15+15,1575,1545,30,C50,5,Resign,White
TRUE,65,15+15,1587,1568,19,C44,6,Resign,Black
TRUE,72,15+5,1514,1578,-64,D00,2,Mate,Black
TRUE,31,10+10,1545,1590,-45,D00,2,Resign,White
TRUE,50,15+15,1581,1596,-15,C65,8,Resign,Black
TRUE,23,15+15,1562,1605,-43,C44,8,Mate,White
TRUE,46,15+15,1389,1555,-166,A40,3,Resign,Black
FALSE,40,15+5,1555,1256,299,C55,6,Mate,Black
FALSE,29,15+5,1256,1555,-299,C57,8,Resign,White
FALSE,33,15+5,1555,1256,299,C41,5,Mate,White
TRUE,45,15+15,1545,1550,-5,B12,5,Out of Time,White
TRUE,116,15+15,1622,1531,91,D10,5,Mate,Black
FALSE,30,15+15,1514,1524,-10,C53,8,Resign,Black
FALSE,56,15+15,1524,2243,-719,B12,5,Resign,Black
FALSE,24,15+15,1320,1524,-204,C55,8,Resign,Black
FALSE,60,15+15,1524,1565,-41,C50,8,Resign,White
FALSE,67,15+15,1524,1422,102,C42,5,Mate,White
FALSE,47,15+15,1523,1524,-1,C68,8,Resign,White
TRUE,30,15+10,1567,1518,49,C50,6,Resign,Black
TRUE,35,20+5,1470,1531,-61,C44,9,Mate,White
TRUE,120,20+5,1538,1652,-114,C41,5,Out of Time,Black
TRUE,47,25+0,1505,1542,-37,C54,13,Resign,Black
TRUE,91,10+0,1479,1344,135,C00,2,Mate,White
TRUE,41,10+0,1329,1494,-165,A00,1,Mate,White
TRUE,70,10+0,1505,1510,-5,B01,4,Resign,Black
TRUE,70,10+0,1478,1495,-17,A43,2,Resign,Black
TRUE,74,10+0,1504,1531,-27,C24,4,Resign,Black
TRUE,35,10+0,1511,1526,-15,C20,3,Mate,White
TRUE,82,10+0,1519,1410,109,B20,3,Resign,White
TRUE,41,10+0,1526,1529,-3,C34,5,Resign,White
TRUE,51,10+0,1519,1495,24,C00,2,Mate,White
TRUE,64,10+0,1406,1512,-106,C51,10,Out of Time,Black
TRUE,123,10+0,1501,1496,5,C24,4,Mate,White
TRUE,66,10+0,1480,1491,-11,C20,3,Mate,Black
TRUE,20,10+0,1418,1482,-64,C20,4,Mate,Black
TRUE,79,10+0,1470,1521,-51,C41,6,Resign,White
TRUE,58,10+0,1376,1462,-86,C46,5,Mate,Black
TRUE,59,10+0,1453,1385,68,C24,4,Resign,White
TRUE,126,10+0,1447,1485,-38,C23,3,Resign,Black
TRUE,30,10+0,1324,1440,-116,C44,9,Resign,Black
TRUE,44,10+0,1418,1432,-14,C62,6,Mate,Black
TRUE,31,10+0,1434,1357,77,C23,3,Out of Time,White
TRUE,33,10+0,1444,1475,-31,B07,2,Resign,Black
TRUE,102,10+0,1465,1432,33,C44,5,Mate,Black
TRUE,29,10+0,1373,1445,-72,C62,6,Resign,White
TRUE,109,10+0,1434,1442,-8,C23,3,Mate,White
FALSE,27,10+0,1521,1434,87,C51,17,Resign,White
TRUE,28,10+0,1461,1444,17,C02,5,Resign,White
TRUE,38,10+0,1480,1462,18,C50,6,Resign,White
TRUE,52,10+0,1472,1468,4,C23,3,Mate,Black
TRUE,83,10+0,1462,1465,-3,B20,3,Resign,White
TRUE,161,10+0,1459,1462,-3,A01,2,Draw,Draw
TRUE,67,10+0,1449,1529,-80,C41,5,Mate,White
TRUE,57,10+0,1460,1460,0,C45,7,Mate,White
TRUE,73,10+0,1501,1481,20,C20,4,Mate,White
TRUE,31,10+0,1508,1469,39,C51,8,Resign,Black
TRUE,46,10+0,1460,1402,58,C24,4,Resign,White
TRUE,77,10+0,1450,1442,8,C40,4,Resign,White
TRUE,11,10+0,1439,1454,-15,B06,2,Mate,White
TRUE,30,10+0,1401,1429,-28,C23,3,Resign,Black
TRUE,53,10+0,1413,1333,80,C24,4,Resign,White
TRUE,84,10+2,2118,1817,301,C13,8,Resign,Black
TRUE,171,15+0,2118,2197,-79,C67,10,Mate,White
TRUE,39,15+0,2118,2004,114,B23,4,Resign,White
TRUE,96,7+10,2078,2077,1,C18,13,Resign,Black
TRUE,29,15+0,2040,1969,71,C69,10,Resign,White
TRUE,41,15+0,2032,1585,447,C65,7,Mate,White
TRUE,77,15+0,1938,1862,76,C41,7,Resign,White
TRUE,31,15+0,1862,1871,-9,C41,7,Mate,White
TRUE,140,15+0,1697,1794,-97,D34,16,Resign,Black
TRUE,15,15+0,1655,1709,-54,B07,5,Resign,White
TRUE,23,15+0,1500,1451,49,B01,4,Mate,White
FALSE,21,5+8,1500,1500,0,B02,3,Resign,White
FALSE,44,5+5,1671,1500,171,E00,4,Resign,Black
FALSE,111,5+5,1671,1567,104,B06,2,Resign,Black
FALSE,30,5+5,1710,1671,39,A00,1,Resign,White
FALSE,39,5+5,1610,1671,-61,B10,5,Resign,Black
FALSE,52,5+5,1671,1743,-72,C34,6,Resign,Black
FALSE,15,5+5,1671,1398,273,C50,6,Resign,White
FALSE,23,5+5,1398,1671,-273,B13,5,Resign,White
FALSE,64,10+15,1671,2014,-343,B50,4,Resign,Black
FALSE,59,5+5,1794,1671,123,A22,6,Resign,White
FALSE,45,5+5,1771,1671,100,D80,6,Mate,White
TRUE,131,5+5,1648,1682,-34,B00,3,Resign,White
TRUE,136,5+5,1692,1735,-43,B30,4,Resign,Black
TRUE,13,5+5,1688,1421,267,B27,3,Resign,White
TRUE,60,5+5,1705,1676,29,D04,5,Resign,Black
TRUE,34,5+5,1396,1672,-276,B18,8,Mate,Black
TRUE,43,7+7,1667,1456,211,B54,5,Resign,White
TRUE,46,5+5,1684,1435,249,B01,4,Resign,Black
TRUE,40,15+0,1549,1676,-127,B12,5,Mate,Black
TRUE,37,30+30,1687,1668,19,B07,5,Resign,Black
TRUE,72,25+0,1698,1680,18,C51,10,Resign,Black
FALSE,55,15+8,1698,1470,228,B06,4,Mate,White
FALSE,50,15+8,1470,1698,-228,B20,3,Mate,Black
TRUE,87,5+5,1689,1616,73,B84,12,Resign,White
TRUE,32,30+0,1673,1678,-5,B86,11,Resign,Black
TRUE,53,5+20,1670,1588,82,C50,6,Resign,White
TRUE,109,5+5,1791,1677,114,B10,2,Resign,White
TRUE,143,5+5,1639,1663,-24,A45,2,Draw,Draw
TRUE,37,5+5,1650,1720,-70,B00,5,Mate,White
TRUE,27,5+5,1790,1657,133,C50,6,Resign,White
TRUE,41,5+5,1646,1640,6,B01,6,Resign,White
TRUE,43,8+0,1856,1651,205,B50,4,Resign,White
TRUE,73,15+10,1655,1662,-7,B75,13,Resign,White
TRUE,53,5+5,1646,1673,-27,B52,6,Resign,White
TRUE,73,5+5,1662,1656,6,C41,8,Resign,White
FALSE,67,5+5,1516,1506,10,C41,5,Mate,White
TRUE,38,5+5,1489,1501,-12,B01,4,Resign,Black
FALSE,26,5+5,1188,1501,-313,A10,2,Mate,Black
TRUE,62,12+2,1999,1929,70,A00,2,Resign,Black
TRUE,48,10+0,1901,1718,183,A46,5,Resign,Black
TRUE,34,10+0,1587,1500,87,B21,3,Mate,Black
TRUE,26,90+5,1891,1500,391,B50,4,Resign,Black
TRUE,72,15+0,1829,1707,122,A40,2,Resign,Black
TRUE,93,15+0,1736,1832,-96,C00,3,Draw,Draw
TRUE,62,15+0,1847,1712,135,A45,2,Resign,Black
TRUE,82,15+0,1834,1835,-1,C02,7,Resign,Black
TRUE,129,15+0,1825,1769,56,A41,2,Mate,White
TRUE,96,15+0,1864,1823,41,C10,10,Draw,Draw
TRUE,145,15+0,1964,1818,146,C10,10,Out of Time,Draw
TRUE,78,15+0,1834,1723,111,A40,2,Out of Time,Black
TRUE,36,15+0,1727,1825,-98,C00,3,Resign,Black
TRUE,36,15+0,1701,1816,-115,D55,13,Resign,Black
TRUE,35,15+0,1807,1690,117,A40,4,Out of Time,White
TRUE,112,15+0,1650,1800,-150,C00,3,Resign,Black
TRUE,29,15+0,1791,1683,108,A43,2,Resign,White
TRUE,28,15+0,1705,1781,-76,C00,4,Resign,Black
TRUE,66,15+0,1697,1770,-73,C02,10,Resign,Black
TRUE,73,15+0,1770,1774,-4,D93,11,Draw,Draw
TRUE,106,15+0,1811,1755,56,A04,2,Resign,Black
TRUE,30,30+0,1768,1754,14,C60,5,Resign,Black
TRUE,33,30+0,1678,1785,-107,C01,5,Resign,White
TRUE,32,15+0,1798,1764,34,C44,7,Resign,Black
TRUE,65,30+0,1759,1814,-55,D12,8,Resign,White
TRUE,52,10+0,1827,1829,-2,D20,5,Resign,Black
TRUE,71,30+0,1799,1843,-44,C14,13,Resign,White
TRUE,52,10+0,1848,2122,-274,B41,8,Resign,Black
TRUE,13,30+0,1849,1826,23,B03,5,Draw,Draw
TRUE,30,10+0,1994,2023,-29,C45,9,Out of Time,Black
TRUE,43,10+0,2011,2004,7,A43,5,Mate,White
TRUE,119,10+0,1895,2028,-133,C25,4,Out of Time,White
TRUE,36,10+0,1989,2016,-27,D35,6,Resign,Black
TRUE,89,10+0,2177,2024,153,C46,5,Mate,White
TRUE,58,10+0,2009,2058,-49,C01,7,Resign,White
TRUE,21,10+0,2003,1774,229,C23,4,Resign,White
TRUE,116,10+0,1984,1990,-6,A45,2,Out of Time,Black
TRUE,136,25+0,1910,1979,-69,C65,8,Out of Time,Black
FALSE,126,5+5,2173,1979,194,D02,4,Resign,Black
TRUE,16,10+0,1811,1753,58,A52,7,Mate,Black
TRUE,44,10+0,1824,1798,26,D30,6,Resign,Black
TRUE,32,10+0,1834,1896,-62,A06,3,Resign,Black
TRUE,50,10+0,1495,1831,-336,C68,8,Resign,Black
TRUE,30,10+0,1840,1914,-74,D43,8,Resign,Black
TRUE,55,10+0,1874,1851,23,C44,6,Resign,White
TRUE,74,10+0,1889,1837,52,B21,3,Mate,Black
TRUE,98,12+0,1305,1402,-97,C30,3,Mate,Black
FALSE,150,15+0,1500,1402,98,C00,2,Mate,Black
TRUE,86,10+0,1406,1823,-417,E90,9,Out of Time,Black
TRUE,29,10+0,1379,1421,-42,D31,5,Mate,White
TRUE,83,10+8,1366,1171,195,A41,4,Mate,White
FALSE,68,10+5,1366,1500,-134,A40,2,Resign,Black
TRUE,38,10+0,1368,1918,-550,D85,13,Mate,Black
TRUE,36,10+0,1689,1273,416,C58,11,Resign,Black
TRUE,75,10+0,1721,1249,472,C78,9,Draw,Draw
TRUE,39,5+15,1114,1286,-172,B20,3,Resign,White
TRUE,41,7+2,1585,1295,290,D30,4,Out of Time,White
TRUE,35,20+5,1638,1303,335,D01,4,Mate,White
TRUE,80,10+0,1311,1623,-312,C11,7,Out of Time,Black
TRUE,52,10+0,1302,1278,24,B00,3,Out of Time,Black
TRUE,57,10+0,1432,1298,134,A00,1,Mate,White
TRUE,24,10+0,1300,1912,-612,D01,4,Resign,Black
TRUE,55,5+8,2012,2074,-62,C46,7,Resign,White
TRUE,118,20+0,2017,2232,-215,B20,2,Mate,Black
TRUE,54,15+5,2027,2079,-52,C58,11,Resign,Black
TRUE,67,25+0,2018,1923,95,C45,8,Resign,White
TRUE,50,25+0,1915,2009,-94,C11,7,Resign,Black
TRUE,91,10+0,2003,1808,195,B00,5,Resign,White
TRUE,62,15+0,2063,1500,563,C65,6,Resign,Black
FALSE,27,30+30,1681,1500,181,C41,5,Resign,White
FALSE,110,30+30,1500,1493,7,B20,3,Mate,Black
FALSE,116,15+0,1500,1723,-223,B10,3,Mate,Black
FALSE,75,15+0,1723,1500,223,B07,2,Resign,White
FALSE,80,15+0,1500,1723,-223,A02,1,Mate,Black
FALSE,100,20+3,1500,1723,-223,B21,3,Mate,Black
FALSE,81,20+3,1723,1500,223,C00,3,Mate,White
FALSE,98,20+3,1500,1723,-223,A43,2,Mate,Black
FALSE,98,20+3,1500,1723,-223,B20,3,Resign,Black
FALSE,63,20+3,1723,1500,223,B00,2,Mate,White
FALSE,115,20+3,1723,1500,223,B01,4,Mate,White
TRUE,46,20+0,1534,1415,119,C46,7,Resign,Black
TRUE,56,8+8,1433,1597,-164,C40,3,Resign,Black
TRUE,102,5+8,1462,1715,-253,A50,4,Resign,Black
TRUE,43,8+0,1561,1493,68,C02,7,Resign,White
TRUE,16,15+0,1550,1532,18,B07,4,Resign,White
TRUE,99,5+5,1745,1556,189,C50,9,Resign,White
TRUE,76,5+8,1623,1487,136,C42,4,Mate,Black
TRUE,15,5+5,1485,1557,-72,B20,2,Resign,White
TRUE,54,9+10,1638,1574,64,C55,8,Resign,Black
TRUE,89,10+8,1532,1773,-241,D50,8,Resign,White
TRUE,25,10+8,1720,1538,182,C50,6,Mate,White
TRUE,58,10+6,1247,1702,-455,C53,9,Resign,Black
TRUE,37,60+10,1635,1432,203,C00,3,Mate,White
TRUE,45,5+8,1500,1404,96,B36,8,Resign,White
FALSE,27,30+4,1500,1730,-230,C20,3,Resign,Black
FALSE,91,9+6,1542,1500,42,B01,4,Mate,White
FALSE,3,20+0,1047,1500,-453,B23,3,Resign,White
TRUE,29,10+0,1293,1234,59,D02,4,Resign,White
TRUE,31,20+0,1367,1346,21,C40,4,Resign,White
TRUE,27,20+0,1543,1500,43,B00,2,Resign,White
TRUE,59,10+0,1354,1347,7,C40,5,Mate,White
TRUE,58,10+0,1094,1334,-240,C41,6,Mate,Black
TRUE,86,10+0,1370,1327,43,C41,4,Resign,Black
TRUE,49,8+0,1399,1273,126,A40,3,Resign,White
TRUE,54,5+8,1278,1488,-210,C00,3,Mate,Black
TRUE,67,45+8,1267,1233,34,B00,5,Mate,White
FALSE,33,5+5,1500,1267,233,C50,5,Mate,White
TRUE,53,15+0,1287,1278,9,B00,3,Mate,White
TRUE,91,10+0,1263,1343,-80,C21,3,Mate,White
TRUE,30,10+8,1271,1349,-78,B00,2,Resign,Black
TRUE,57,10+10,1460,1277,183,C20,3,Mate,White
TRUE,66,10+5,1292,1330,-38,B32,5,Resign,Black
FALSE,78,10+5,1292,1500,-208,C41,6,Resign,Black
TRUE,62,5+8,1303,1319,-16,B20,2,Resign,Black
TRUE,75,5+8,1307,1314,-7,A00,2,Resign,White
TRUE,75,5+8,1301,1318,-17,B29,4,Mate,White
FALSE,56,17+90,1301,1385,-84,C60,5,Mate,Black
TRUE,66,15+0,1978,1916,62,C11,7,Resign,Black
TRUE,80,15+0,1977,2241,-264,B28,6,Resign,Black
TRUE,31,15+0,2064,1986,78,B20,5,Resign,White
TRUE,45,15+0,1935,1999,-64,A01,5,Resign,White
TRUE,35,15+0,1997,1631,366,C00,4,Resign,White
TRUE,37,15+0,1842,2013,-171,B30,4,Resign,White
TRUE,45,15+0,2011,1602,409,C41,8,Mate,White
TRUE,60,15+0,1734,2007,-273,B25,4,Resign,Black
TRUE,51,30+0,1998,1891,107,B32,8,Resign,White
TRUE,80,15+0,1688,1995,-307,B30,4,Resign,Black
TRUE,58,10+0,2011,1828,183,C45,7,Resign,Black
TRUE,91,10+0,2006,1757,249,C18,12,Mate,White
TRUE,50,10+0,2052,1992,60,B22,12,Resign,Black
TRUE,55,10+0,1979,2008,-29,B47,10,Resign,White
TRUE,47,10+0,1977,1564,413,C44,5,Resign,White
TRUE,124,15+0,1712,1973,-261,D37,12,Resign,Black
TRUE,35,15+0,1962,1935,27,C45,8,Mate,White
TRUE,145,15+10,1936,1938,-2,B01,10,Mate,White
TRUE,118,15+0,1953,1770,183,B06,6,Resign,Black
TRUE,58,15+0,1775,1946,-171,D00,3,Resign,Black
TRUE,39,15+0,1939,1781,158,C44,5,Resign,White
TRUE,196,15+0,1954,1850,104,B00,3,Mate,Black
TRUE,126,15+0,1858,1944,-86,B34,9,Out of Time,Black
TRUE,104,15+0,1542,1954,-412,B30,4,Draw,Draw
TRUE,37,15+0,1952,1507,445,B06,2,Resign,White
TRUE,62,15+0,1801,1945,-144,A01,5,Resign,Black
TRUE,27,15+0,1932,1948,-16,B33,11,Resign,White
TRUE,56,10+0,1509,1930,-421,A15,2,Mate,Black
TRUE,84,10+0,1939,2008,-69,B92,11,Resign,Black
TRUE,109,10+0,1728,1933,-205,D01,4,Resign,Black
TRUE,51,10+0,1928,1688,240,C18,10,Resign,White
TRUE,42,10+0,1663,1924,-261,B30,4,Resign,Black
TRUE,29,10+0,1913,1874,39,B08,8,Resign,White
TRUE,53,10+0,1912,1339,573,C40,3,Mate,White
TRUE,78,10+0,1480,1910,-430,D03,5,Resign,Black
TRUE,106,5+5,1905,1898,7,B30,5,Resign,Black
TRUE,66,5+5,1907,1886,21,B30,5,Resign,Black
TRUE,73,5+5,1872,1919,-47,C47,8,Resign,White
TRUE,61,5+5,1858,1932,-74,B02,4,Resign,White
TRUE,76,15+0,1515,1855,-340,A00,1,Resign,Black
TRUE,79,15+0,1852,1518,334,C00,3,Resign,White
FALSE,25,10+1,1788,1626,162,A46,5,Out of Time,White
TRUE,104,10+0,1804,1869,-65,C28,7,Out of Time,Black
TRUE,69,10+0,1802,1367,435,B00,5,Mate,White
TRUE,69,10+0,1973,1808,165,A20,2,Out of Time,White
TRUE,33,10+0,1803,1562,241,C24,4,Resign,White
TRUE,30,10+0,1431,1800,-369,A00,1,Mate,Black
TRUE,103,10+0,1384,1821,-437,A00,1,Out of Time,White
TRUE,96,8+0,1847,1762,85,B00,2,Out of Time,Black
TRUE,32,8+0,1732,1839,-107,C62,6,Resign,Black
TRUE,66,11+0,1591,1834,-243,C20,3,Resign,Black
TRUE,109,11+0,1896,1843,53,C34,6,Out of Time,White
TRUE,118,11+0,1620,1838,-218,C41,4,Mate,Black
TRUE,101,11+0,1832,1626,206,C55,7,Mate,White
TRUE,82,11+0,1631,1826,-195,C41,7,Mate,Black
TRUE,93,11+0,1819,1637,182,C24,4,Mate,White
TRUE,52,11+0,1607,1813,-206,C55,6,Mate,Black
TRUE,54,11+0,1359,1806,-447,A00,1,Mate,Black
TRUE,150,11+0,1513,1802,-289,D00,3,Out of Time,Black
TRUE,107,11+0,1798,1517,281,C20,4,Mate,White
TRUE,63,8+0,1796,1388,408,C23,3,Mate,White
TRUE,91,8+0,1788,1665,123,B20,3,Out of Time,White
TRUE,70,10+0,1954,1771,183,C25,4,Resign,Black
TRUE,151,10+0,1759,1767,-8,C24,4,Mate,White
TRUE,131,8+0,1913,1754,159,A28,7,Draw,Draw
TRUE,55,10+0,1517,1772,-255,C55,6,Resign,White
TRUE,81,10+0,2150,1774,376,C41,5,Mate,White
TRUE,50,10+0,1641,1766,-125,C10,6,Mate,Black
TRUE,39,10+0,1758,1649,109,C50,8,Mate,White
TRUE,66,10+0,1754,1746,8,C00,3,Resign,Black
TRUE,77,10+0,1737,1674,63,C50,5,Mate,White
TRUE,68,10+0,1750,1660,90,C50,5,Mate,Black
TRUE,98,10+0,1476,1746,-270,C25,4,Mate,Black
TRUE,75,10+0,1733,1783,-50,C20,4,Resign,White
TRUE,83,10+0,1688,1745,-57,C20,3,Out of Time,White
TRUE,41,10+0,1737,1637,100,C24,4,Resign,White
FALSE,25,10+10,1953,1500,453,C60,5,Resign,White
FALSE,57,2+15,1856,1953,-97,B52,9,Resign,White
FALSE,45,8+8,1836,1953,-117,B20,3,Resign,White
TRUE,156,15+8,1372,1953,-581,B90,10,Resign,Black
TRUE,40,14+12,1895,1953,-58,C69,10,Out of Time,Black
TRUE,41,14+12,1887,1905,-18,E90,9,Resign,White
TRUE,38,15+30,1621,1855,-234,C50,6,Resign,Black
TRUE,35,15+10,1823,1554,269,D30,6,Mate,White
TRUE,40,15+10,1569,1775,-206,E20,6,Resign,Black
TRUE,64,15+8,1540,1703,-163,C88,13,Resign,Black
TRUE,47,15+8,1500,1549,-49,B01,8,Resign,White
FALSE,79,30+6,946,1069,-123,C40,3,Mate,White
FALSE,3,10+0,1102,1069,33,B01,2,Out of Time,White
FALSE,49,15+8,1500,1500,0,B07,2,Mate,White
FALSE,70,12+0,1200,1200,0,C23,4,Resign,Black
FALSE,87,11+8,1200,1200,0,D00,3,Resign,White
TRUE,14,10+3,1209,1160,49,C20,3,Mate,Black
TRUE,31,5+5,1424,1280,144,A00,1,Mate,White
TRUE,22,5+5,1500,1415,85,C00,2,Mate,Black
TRUE,37,7+10,1379,1431,-52,C25,4,Resign,White
TRUE,73,5+15,1724,1500,224,C44,5,Resign,White
TRUE,7,5+8,1286,1225,61,A00,1,Resign,White
TRUE,42,8+0,1797,2199,-402,A00,1,Mate,Black
TRUE,64,8+0,1799,2196,-397,A00,1,Mate,Black
TRUE,56,8+0,1750,2195,-445,B20,2,Resign,Black
TRUE,57,10+0,2191,1884,307,B20,2,Resign,White
TRUE,38,10+0,1887,2187,-300,B43,9,Resign,Black
TRUE,65,10+0,2184,1891,293,B20,2,Resign,White
TRUE,88,8+0,2167,2172,-5,A45,3,Mate,Black
TRUE,54,10+0,1321,1946,-625,C46,6,Mate,Black
TRUE,126,10+0,1718,1941,-223,A45,2,Out of Time,Black
TRUE,115,10+0,1932,1831,101,E60,5,Out of Time,White
TRUE,114,10+0,1233,1932,-699,E00,4,Mate,Black
TRUE,94,10+0,1945,1901,44,E60,5,Resign,Black
TRUE,82,10+0,1951,2109,-158,E17,11,Resign,Black
TRUE,69,25+0,1938,1985,-47,E15,8,Resign,White
FALSE,41,10+1,1938,1527,411,E94,14,Resign,White
TRUE,65,5+10,1865,1953,-88,A45,2,Resign,White
TRUE,113,5+10,1956,1862,94,D52,11,Draw,Draw
TRUE,94,15+10,1828,1948,-120,D00,10,Out of Time,Black
TRUE,38,15+10,1964,1813,151,A57,7,Resign,Black
TRUE,30,15+10,1955,1890,65,D43,8,Resign,White
TRUE,169,10+0,1784,1972,-188,B57,8,Mate,White
TRUE,126,10+0,1929,2106,-177,A27,5,Out of Time,Black
TRUE,114,8+0,1965,2077,-112,C53,7,Out of Time,Black
TRUE,45,8+0,2043,1981,62,B13,5,Resign,White
TRUE,65,8+0,1966,2056,-90,A85,5,Resign,White
TRUE,47,15+5,1334,1428,-94,E00,4,Resign,White
TRUE,41,15+10,1603,1339,264,B40,4,Mate,White
TRUE,37,10+5,1719,1341,378,B54,5,Resign,White
TRUE,105,6+4,1519,1348,171,B29,5,Resign,White
TRUE,29,5+5,1667,1361,306,B21,3,Resign,White
TRUE,105,10+5,1668,1365,303,B00,3,Resign,White
TRUE,94,10+5,1518,1345,173,B07,6,Resign,Black
TRUE,98,20+20,1349,1653,-304,C00,3,Resign,Black
TRUE,70,5+8,1065,1344,-279,B11,4,Resign,Black
TRUE,61,10+5,1627,1321,306,B12,5,Resign,Black
TRUE,104,5+8,1325,1617,-292,D30,4,Resign,Black
TRUE,51,10+5,1694,1329,365,C46,7,Resign,White
TRUE,60,15+5,1334,1572,-238,D35,6,Resign,Black
TRUE,56,5+6,1336,1786,-450,D31,6,Out of Time,Black
TRUE,97,5+8,1596,1341,255,B00,3,Resign,White
TRUE,63,10+10,1323,1449,-126,D20,4,Out of Time,White
TRUE,65,3+8,1829,1324,505,B15,5,Mate,White
TRUE,75,15+10,1537,1330,207,A53,4,Mate,White
TRUE,122,15+0,1393,1314,79,B10,5,Out of Time,Black
TRUE,61,5+6,1480,1322,158,B13,5,Resign,White
TRUE,51,5+6,1676,1325,351,B10,2,Resign,White
TRUE,99,5+6,1301,1697,-396,D06,4,Resign,White
TRUE,57,15+8,1305,1611,-306,D94,11,Resign,Black
TRUE,52,5+15,1671,1668,3,A40,2,Mate,Black
FALSE,44,10+60,2586,1618,968,D34,17,Resign,White
FALSE,52,10+15,1204,1083,121,A00,1,Mate,Black
TRUE,49,5+5,1903,1390,513,C34,6,Out of Time,White
FALSE,23,15+0,1387,1390,-3,C20,3,Resign,Black
TRUE,20,7+8,1400,1439,-39,C40,4,Resign,Black
TRUE,35,7+8,1428,1411,17,C20,3,Mate,White
TRUE,93,7+8,1398,1445,-47,C41,5,Resign,White
TRUE,22,15+10,1410,1337,73,C46,5,Out of Time,Black
TRUE,64,15+10,1421,1429,-8,B01,4,Resign,Black
TRUE,130,9+0,1435,1383,52,B01,4,Out of Time,Black
TRUE,121,15+1,1420,1471,-51,C33,5,Out of Time,White
TRUE,45,10+5,1445,1431,14,D20,6,Resign,White
TRUE,148,15+10,1312,1422,-110,C44,5,Resign,Black
TRUE,77,15+10,1412,1321,91,C50,5,Mate,White
TRUE,66,15+10,1331,1401,-70,C45,7,Resign,Black
TRUE,51,10+5,1390,1386,4,B01,4,Resign,White
TRUE,130,10+2,1401,1430,-29,B21,3,Mate,Black
TRUE,50,10+2,1283,1392,-109,A00,3,Out of Time,Black
TRUE,48,10+2,1381,1377,4,C45,7,Resign,Black
TRUE,25,10+2,1362,1392,-30,B18,8,Mate,White
TRUE,18,10+2,1380,1252,128,C50,9,Mate,Black
TRUE,56,15+10,1288,1368,-80,C66,8,Resign,Black
TRUE,107,15+10,1355,1302,53,B00,6,Mate,White
TRUE,43,15+10,1345,1235,110,C50,9,Resign,White
TRUE,62,15+10,1407,1326,81,C44,4,Mate,Black
TRUE,91,15+10,1282,1451,-169,C55,7,Mate,White
TRUE,23,15+10,1269,1205,64,B01,4,Resign,White
TRUE,60,15+10,1274,1570,-296,C41,4,Mate,Black
TRUE,50,5+8,1279,1576,-297,B00,2,Resign,Black
TRUE,75,5+8,1569,1284,285,A00,1,Resign,White
TRUE,71,18+19,1850,1285,565,C50,6,Resign,White
TRUE,75,5+10,1751,1287,464,A25,4,Resign,White
TRUE,132,30+0,1288,1952,-664,C00,4,Mate,Black
TRUE,46,11+11,1289,1825,-536,D02,3,Resign,Black
TRUE,17,10+10,1430,1274,156,B00,5,Mate,White
TRUE,33,10+12,1250,1439,-189,D02,4,Resign,White
TRUE,117,9+0,1230,1297,-67,D02,4,Out of Time,White
TRUE,52,5+5,1243,1314,-71,D02,4,Mate,Black
TRUE,30,10+0,1953,1721,232,E80,9,Resign,Black
TRUE,15,10+0,1340,1203,137,C02,5,Out of Time,White
TRUE,115,15+5,1365,1301,64,A40,2,Mate,White
FALSE,38,5+8,1493,1301,192,C44,6,Mate,Black
FALSE,52,30+0,1301,1571,-270,B20,2,Resign,Black
FALSE,61,30+0,1571,1301,270,B00,4,Mate,White
FALSE,49,30+0,1301,1571,-270,B20,3,Mate,White
FALSE,81,30+0,1571,1301,270,C23,3,Mate,White
FALSE,54,30+0,1500,1301,199,B00,4,Resign,Black
TRUE,48,30+0,1500,1455,45,A00,1,Mate,Black
FALSE,57,5+5,1791,1500,291,D20,5,Mate,White
FALSE,31,5+5,1500,1791,-291,B20,2,Resign,Black
FALSE,33,5+5,1791,1500,291,D06,4,Mate,White
FALSE,64,10+0,1629,2195,-566,C00,2,Out of Time,Black
FALSE,44,10+0,2195,2028,167,E67,12,Resign,Black
TRUE,86,10+0,1822,2192,-370,A00,1,Out of Time,Black
TRUE,60,10+0,2218,1990,228,E20,7,Resign,Black
TRUE,94,10+0,1795,2215,-420,C00,3,Resign,Black
TRUE,119,10+0,2202,2008,194,A18,5,Mate,White
TRUE,25,10+0,2199,1802,397,C55,7,Resign,White
TRUE,39,10+0,2198,1500,698,A34,3,Resign,White
TRUE,76,10+0,1555,2197,-642,D01,4,Mate,Black
TRUE,56,10+0,1787,2194,-407,C00,3,Resign,Black
TRUE,50,10+0,1467,2194,-727,A00,1,Mate,Black
TRUE,46,10+0,2189,1868,321,B40,5,Resign,White
TRUE,72,10+0,1897,2183,-286,B01,4,Resign,Black
TRUE,101,10+0,2183,1551,632,A29,7,Resign,White
TRUE,36,10+0,1775,2179,-404,B01,6,Mate,Black
TRUE,43,10+0,1718,2210,-492,D01,4,Resign,White
TRUE,39,10+0,2204,1967,237,C34,6,Mate,White
TRUE,54,10+0,1915,2198,-283,C02,9,Resign,Black
TRUE,89,10+0,1949,2225,-276,B01,6,Mate,White
TRUE,83,10+0,2222,1842,380,B00,2,Resign,White
TRUE,7,10+0,2222,1382,840,B01,4,Resign,White
TRUE,44,10+0,1299,2221,-922,C65,6,Resign,Black
TRUE,34,10+0,1954,2249,-295,C00,3,Resign,White
TRUE,52,10+0,2279,1826,453,A10,2,Resign,Black
TRUE,66,10+0,2063,2271,-208,B01,2,Resign,Black
TRUE,49,10+0,2270,1613,657,C00,3,Resign,White
TRUE,3,10+0,2269,1672,597,C40,3,Resign,White
TRUE,50,10+0,1835,2266,-431,B01,6,Mate,Black
TRUE,122,10+0,2277,1893,384,A16,7,Draw,Draw
TRUE,70,10+0,2088,2269,-181,E32,7,Resign,Black
TRUE,7,10+0,2262,2037,225,A28,7,Resign,White
TRUE,74,10+0,1915,2258,-343,C01,5,Resign,Black
TRUE,54,10+0,2251,2006,245,A29,7,Resign,White
TRUE,88,10+0,2106,2241,-135,C05,6,Out of Time,Black
TRUE,49,10+0,2229,2134,95,A21,5,Resign,White
TRUE,28,10+0,1820,2225,-405,C00,3,Resign,Black
TRUE,37,10+0,2222,1810,412,B12,5,Mate,White
TRUE,40,10+0,1622,2212,-590,A45,2,Resign,Black
TRUE,81,10+0,2090,2236,-146,B01,6,Resign,White
TRUE,80,5+8,1275,1253,22,A30,2,Resign,Black
FALSE,2,20+10,1049,1275,-226,A00,1,Resign,White
TRUE,49,10+0,1527,1341,186,B21,3,Mate,White
TRUE,13,15+3,1535,1500,35,A43,3,Resign,White
FALSE,45,5+60,2177,1686,491,D30,4,Resign,White
TRUE,62,8+0,1748,1855,-107,B32,8,Resign,Black
TRUE,94,8+0,1759,1500,259,B90,10,Mate,Black
TRUE,71,0+12,1516,1508,8,C62,6,Mate,White
TRUE,94,0+12,1500,1516,-16,D30,4,Draw,Draw
TRUE,63,10+0,1535,1528,7,C46,7,Resign,White
TRUE,104,10+0,1537,1662,-125,B25,4,Mate,Black
TRUE,69,10+0,1519,1650,-131,B01,6,Mate,White
TRUE,35,10+0,1662,1528,134,C34,6,Resign,White
TRUE,58,5+8,1360,1522,-162,C20,3,Mate,Black
TRUE,72,5+8,1542,1213,329,C41,4,Resign,Black
TRUE,30,10+0,1081,1356,-275,A00,1,Mate,Black
TRUE,37,10+0,1351,1116,235,B00,3,Mate,White
TRUE,44,10+0,1167,1346,-179,C70,6,Mate,Black
TRUE,31,10+0,1338,1264,74,C20,5,Mate,White
FALSE,3,15+5,2053,1264,789,C00,3,Resign,White
FALSE,56,30+0,1264,1358,-94,C42,5,Mate,Black
FALSE,34,30+0,1264,1065,199,C20,3,Mate,Black
FALSE,61,30+0,1065,1264,-199,C40,3,Resign,White
TRUE,43,10+5,1395,1500,-105,C20,3,Mate,White
FALSE,55,8+8,1579,1500,79,A40,2,Mate,White
TRUE,40,5+8,1161,1389,-228,C40,4,Resign,Black
TRUE,34,5+5,1373,1518,-145,B20,2,Resign,White
TRUE,48,6+7,1375,1385,-10,C20,3,Resign,White
TRUE,40,6+7,1397,1363,34,C20,3,Resign,Black
TRUE,61,5+8,1624,1402,222,C40,4,Mate,White
TRUE,104,5+8,1328,1393,-65,A00,1,Mate,Black
TRUE,141,5+8,1385,1274,111,C20,3,Resign,White
TRUE,40,5+8,1397,1368,29,C20,3,Mate,Black
TRUE,85,5+8,1628,1402,226,C23,3,Resign,White
TRUE,63,5+8,1597,1407,190,C40,4,Out of Time,White
TRUE,57,5+8,1401,1626,-225,B20,2,Mate,White
TRUE,57,5+8,1411,1422,-11,B20,2,Resign,Black
TRUE,47,5+8,1485,1420,65,C40,4,Mate,White
TRUE,38,5+8,1336,1412,-76,B00,4,Resign,Black
TRUE,41,5+8,1434,1422,12,C34,5,Resign,White
FALSE,58,5+8,1422,1500,-78,B20,2,Mate,Black
TRUE,27,5+8,1645,1437,208,C30,5,Resign,White
TRUE,98,5+8,1446,1489,-43,C20,3,Mate,Black
TRUE,33,5+8,1246,1441,-195,A00,1,Resign,Black
TRUE,99,5+8,1429,1467,-38,B01,4,Out of Time,White
TRUE,57,5+8,1417,1446,-29,C20,3,Resign,White
TRUE,2,5+8,1430,1366,64,C00,2,Resign,Black
TRUE,159,5+10,1455,1510,-55,C20,3,Draw,Draw
TRUE,29,5+10,1500,1465,35,C40,4,Mate,White
TRUE,48,5+5,1494,1447,47,C40,4,Mate,Black
TRUE,85,5+5,1433,1558,-125,C20,4,Mate,White
TRUE,53,5+5,1515,1441,74,C40,4,Resign,White
TRUE,64,5+8,1274,1435,-161,C40,4,Resign,Black
TRUE,165,10+0,2104,1818,286,D00,3,Mate,White
FALSE,103,20+5,1382,1389,-7,C00,4,Resign,White
FALSE,67,15+0,1606,1382,224,C22,7,Out of Time,White
FALSE,76,10+10,1382,1552,-170,C41,5,Resign,Black
FALSE,115,10+10,1412,1382,30,C44,11,Mate,White
FALSE,110,15+0,1311,1382,-71,C42,6,Mate,Black
TRUE,68,6+7,1393,1415,-22,C48,8,Resign,Black
FALSE,26,20+0,1500,1393,107,C24,4,Resign,Black
TRUE,59,10+0,1270,1408,-138,C20,3,Out of Time,White
TRUE,84,8+3,1423,1396,27,C30,4,Out of Time,Black
FALSE,44,15+15,1396,1485,-89,C40,4,Mate,Black
TRUE,38,30+10,1521,1403,118,C60,7,Resign,White
TRUE,75,8+5,1401,1477,-76,C10,6,Draw,Draw
TRUE,40,10+0,943,1013,-70,C10,7,Resign,Black
TRUE,55,10+0,1062,923,139,D00,3,Resign,Black
TRUE,33,10+4,1369,1074,295,B00,2,Mate,White
TRUE,68,10+5,1486,994,492,A40,2,Mate,Black
FALSE,67,20+60,1698,994,704,D00,3,Mate,White
TRUE,60,30+0,971,1046,-75,C20,3,Resign,White
TRUE,54,5+5,1159,911,248,D00,3,Resign,Black
TRUE,86,20+0,1710,1741,-31,B40,6,Draw,Draw
TRUE,57,20+0,1648,1707,-59,C02,7,Resign,Black
TRUE,82,20+0,1769,1639,130,D31,6,Resign,Black
TRUE,46,15+0,1619,1483,136,D00,3,Resign,Black
TRUE,30,10+0,1147,1087,60,C20,3,Mate,Black
TRUE,43,10+0,991,1084,-93,C47,7,Resign,White
FALSE,68,5+8,1257,991,266,D00,3,Mate,Black
FALSE,17,5+8,991,1257,-266,C40,4,Out of Time,White
FALSE,115,5+8,1257,991,266,B00,6,Draw,Draw
FALSE,63,10+10,991,1257,-266,A00,1,Mate,White
FALSE,78,15+5,1257,991,266,D01,5,Mate,Black
TRUE,25,10+6,2347,1906,441,B24,8,Resign,White
TRUE,51,7+5,2344,1898,446,A40,4,Resign,White
TRUE,45,9+2,2333,2134,199,B29,12,Resign,White
TRUE,22,10+3,2010,2327,-317,B35,13,Resign,Black
TRUE,42,10+3,2320,2013,307,B58,11,Resign,White
TRUE,39,10+0,1912,2316,-404,A01,2,Resign,Black
TRUE,57,10+0,2311,1917,394,E91,11,Resign,White
TRUE,59,8+8,2298,2146,152,B18,8,Resign,White
TRUE,72,8+8,2052,2287,-235,A59,13,Resign,Black
TRUE,54,8+8,2276,2057,219,D47,16,Resign,White
TRUE,45,10+6,2270,1908,362,B42,9,Resign,White
TRUE,43,9+4,2260,2005,255,A09,4,Out of Time,White
TRUE,87,7+10,2248,2015,233,A40,10,Resign,White
TRUE,63,9+4,2235,2010,225,D07,6,Out of Time,White
TRUE,128,7+2,2214,2112,102,A08,4,Resign,White
TRUE,41,5+5,2191,2077,114,A54,7,Resign,White
FALSE,110,8+0,2191,2277,-86,C42,9,Resign,Black
TRUE,29,10+0,2067,2243,-176,A00,6,Resign,White
FALSE,107,10+4,2243,2186,57,C42,14,Draw,Draw
FALSE,30,10+4,2186,2243,-57,B33,10,Resign,Black
TRUE,29,10+0,2223,2032,191,E40,7,Resign,White
TRUE,51,10+0,2208,1944,264,B19,15,Out of Time,White
TRUE,50,10+5,2055,2179,-124,B90,11,Resign,Black
TRUE,119,12+5,2052,2162,-110,C25,4,Draw,Draw
TRUE,26,8+8,2270,1974,296,E20,8,Resign,Black
TRUE,84,8+8,1978,2245,-267,B33,11,Resign,Black
TRUE,77,8+8,2210,1982,228,A22,5,Resign,White
FALSE,57,8+0,2210,1943,267,A35,6,Resign,White
TRUE,60,5+5,2185,1851,334,D02,8,Resign,White
TRUE,23,12+5,2094,2041,53,D24,7,Resign,White
TRUE,59,5+5,1874,2049,-175,A43,4,Mate,White
TRUE,51,5+5,1500,1793,-293,B23,4,Resign,White
TRUE,75,15+0,1608,1794,-186,B32,6,Resign,White
FALSE,103,60+0,1608,1500,108,C40,3,Mate,White
FALSE,14,60+0,1500,1608,-108,A00,3,Mate,Black
FALSE,23,60+0,1608,1500,108,B00,2,Mate,White
FALSE,12,60+0,1500,1608,-108,A00,1,Mate,Black
TRUE,117,15+0,1795,1811,-16,D30,8,Mate,White
TRUE,66,15+0,1832,1805,27,B44,9,Resign,White
TRUE,35,15+0,1794,1784,10,D06,4,Resign,White
TRUE,82,15+0,1803,1859,-56,D30,4,Mate,Black
TRUE,38,15+0,1794,1750,44,E12,7,Resign,White
TRUE,70,15+0,1784,1784,0,A45,2,Resign,Black
TRUE,61,15+0,1773,1785,-12,D20,5,Mate,White
TRUE,55,15+0,1877,1781,96,D32,10,Resign,White
TRUE,122,15+0,1807,1769,38,B20,2,Mate,Black
TRUE,94,15+0,1777,1853,-76,A40,2,Resign,Black
TRUE,123,15+0,1765,1841,-76,D20,5,Mate,White
TRUE,125,15+0,1832,1773,59,B20,3,Out of Time,White
TRUE,65,15+0,1762,1789,-27,E61,9,Mate,White
TRUE,85,15+0,1778,1773,5,B44,8,Out of Time,White
TRUE,64,15+0,1783,1779,4,E60,5,Mate,Black
TRUE,115,15+0,1773,1751,22,C00,3,Mate,White
TRUE,109,15+0,1761,1808,-47,E30,7,Mate,White
TRUE,20,15+0,1801,1749,52,B44,8,Mate,Black
TRUE,50,15+0,1746,1739,7,B07,5,Out of Time,Black
TRUE,69,15+0,1729,1706,23,D20,5,Mate,White
TRUE,95,15+0,1742,1739,3,B40,5,Out of Time,White
TRUE,77,15+0,1713,1809,-96,B08,8,Mate,White
TRUE,49,15+0,1699,1803,-104,D06,4,Mate,White
TRUE,51,15+0,1795,1707,88,B22,3,Mate,White
TRUE,56,15+0,1716,1768,-52,A43,3,Resign,Black
TRUE,91,15+0,1734,1727,7,B82,11,Out of Time,White
TRUE,56,15+0,1735,1794,-59,A56,6,Mate,Black
TRUE,80,15+0,1746,1729,17,D30,6,Mate,Black
TRUE,79,15+0,1758,1718,40,A40,2,Resign,Black
TRUE,83,15+0,1704,1770,-66,A15,2,Out of Time,White
TRUE,45,15+0,1798,1780,18,A15,2,Resign,White
TRUE,95,15+0,1755,1792,-37,E32,7,Out of Time,White
TRUE,152,15+0,1804,1752,52,D08,4,Mate,Black
TRUE,71,15+0,1795,1712,83,A60,10,Mate,White
FALSE,81,10+10,1279,1693,-414,D81,7,Mate,White
FALSE,64,10+10,1693,1279,414,A08,4,Mate,Black
TRUE,94,10+0,1486,1688,-202,B40,4,Out of Time,Black
TRUE,83,10+0,1676,1669,7,A07,3,Resign,White
TRUE,23,10+0,2199,1677,522,D85,8,Mate,White
TRUE,82,10+0,1694,1520,174,D02,5,Mate,Black
TRUE,67,10+0,1678,1839,-161,A05,4,Resign,White
TRUE,107,10+0,1791,1380,411,D10,6,Mate,White
TRUE,30,10+0,1874,1381,493,A08,4,Resign,White
TRUE,96,10+0,1411,1177,234,C50,8,Mate,Black
TRUE,69,10+0,1295,1427,-132,B20,3,Mate,White
TRUE,12,10+0,1418,1302,116,C46,5,Resign,White
TRUE,95,10+0,1397,1643,-246,B30,4,Out of Time,White
TRUE,41,10+0,1374,1687,-313,C40,4,Mate,White
TRUE,33,10+0,1685,1387,298,B40,4,Mate,White
TRUE,43,10+0,1388,2012,-624,C42,9,Resign,Black
TRUE,31,10+0,2029,1389,640,B30,4,Resign,White
TRUE,37,10+0,1389,2297,-908,A35,4,Resign,Black
TRUE,35,10+0,1375,1408,-33,A16,4,Mate,White
TRUE,101,10+0,1399,1386,13,C41,4,Resign,White
FALSE,70,30+0,1766,1386,380,A40,2,Resign,Black
TRUE,71,10+0,1375,1333,42,A10,2,Out of Time,White
TRUE,54,10+0,1345,1363,-18,D00,2,Mate,Black
TRUE,64,15+0,1239,1372,-133,B50,4,Mate,Black
TRUE,78,15+0,1387,1296,91,B27,4,Mate,Black
TRUE,51,10+0,1471,1397,74,A00,5,Mate,White
FALSE,64,30+0,1397,1766,-369,C20,3,Mate,Black
FALSE,31,30+0,1766,1397,369,A45,2,Mate,White
FALSE,49,30+0,1397,1766,-369,C20,3,Resign,White
TRUE,39,10+0,1382,1406,-24,A20,2,Mate,White
TRUE,114,10+0,1386,1683,-297,C68,10,Mate,Black
TRUE,15,10+0,1663,1391,272,B50,4,Mate,White
TRUE,92,10+0,1396,1638,-242,A21,3,Resign,Black
TRUE,83,35+0,1720,1406,314,B00,5,Resign,White
TRUE,61,10+0,1612,1506,106,A49,4,Mate,White
TRUE,70,10+0,1506,2221,-715,A00,1,Resign,Black
TRUE,57,10+0,1948,1508,440,B07,3,Resign,White
TRUE,83,10+0,1493,1585,-92,A04,2,Mate,White
TRUE,59,10+0,1480,1508,-28,A40,2,Out of Time,White
TRUE,76,10+0,1489,1580,-91,B00,2,Resign,Black
TRUE,119,10+0,1527,1501,26,B20,3,Resign,White
TRUE,71,10+0,1459,1515,-56,A43,5,Resign,White
TRUE,42,10+0,1514,1528,-14,C02,8,Resign,White
TRUE,43,10+0,1516,1500,16,D05,7,Resign,White
TRUE,50,10+0,1517,2061,-544,B90,10,Mate,Black
TRUE,42,10+0,1832,1520,312,B50,4,Resign,White
TRUE,43,10+0,1846,1524,322,D30,4,Mate,White
TRUE,44,10+0,1530,1484,46,A00,4,Resign,Black
TRUE,60,10+0,1176,1526,-350,B00,4,Mate,Black
TRUE,26,10+0,1530,1843,-313,D30,4,Resign,Black
TRUE,46,10+0,1538,1662,-124,B12,5,Resign,Black
TRUE,86,10+0,2018,1527,491,C10,5,Draw,Draw
TRUE,99,10+0,1517,1567,-50,C46,6,Mate,White
TRUE,65,10+0,1502,1590,-88,C02,11,Resign,White
TRUE,64,10+0,1511,1599,-88,A00,1,Resign,Black
TRUE,49,10+0,1808,1515,293,B54,6,Resign,White
TRUE,36,10+0,1772,1520,252,B20,3,Resign,White
FALSE,45,10+5,1520,1545,-25,D80,6,Resign,White
FALSE,36,7+10,2007,1865,142,E71,9,Resign,White
TRUE,51,7+10,1919,2021,-102,D25,7,Resign,White
TRUE,40,7+10,2036,1882,154,A25,4,Mate,Black
TRUE,62,7+10,2045,2024,21,A45,5,Mate,Black
TRUE,133,7+10,1816,2041,-225,B01,6,Resign,White
TRUE,96,7+10,2058,1798,260,A28,7,Resign,Black
TRUE,46,7+10,1802,2054,-252,B01,6,Resign,Black
TRUE,35,7+10,2050,1807,243,A21,3,Resign,White
TRUE,82,7+10,2025,2040,-15,B01,6,Resign,Black
TRUE,140,7+10,2032,1961,71,A16,3,Resign,White
TRUE,40,7+10,1838,2026,-188,A00,1,Resign,Black
TRUE,39,7+10,2021,1844,177,A22,5,Resign,White
TRUE,45,7+10,2116,2029,87,A45,5,Resign,White
TRUE,148,7+10,2044,1867,177,A34,5,Mate,Black
TRUE,30,7+10,1919,2037,-118,B01,6,Resign,Black
TRUE,73,7+10,2028,1981,47,A30,2,Resign,White
TRUE,28,7+10,2018,1988,30,A23,6,Resign,White
TRUE,43,7+10,2013,1823,190,A84,5,Resign,White
TRUE,20,7+10,1829,2008,-179,B01,6,Resign,Black
TRUE,31,7+10,2039,1996,43,B01,6,Resign,Black
TRUE,106,7+10,1984,2052,-68,A36,10,Resign,White
TRUE,65,7+10,1813,1999,-186,B01,2,Out of Time,White
TRUE,21,7+10,1989,1987,2,A10,2,Resign,White
TRUE,118,7+15,1907,1981,-74,B01,6,Out of Time,Black
TRUE,19,7+15,1903,1985,-82,B01,4,Resign,White
TRUE,69,7+15,1979,1800,179,E20,6,Resign,White
TRUE,94,7+15,1991,1932,59,D10,4,Resign,Black
TRUE,87,7+15,1920,2004,-84,B01,4,Resign,White
TRUE,60,7+15,2041,1992,49,B01,6,Resign,Black
TRUE,36,7+15,2004,1967,37,A22,4,Resign,Black
TRUE,132,7+15,1916,1996,-80,B01,2,Resign,Black
TRUE,68,7+15,1996,2132,-136,A10,2,Mate,Black
TRUE,25,7+15,2176,2001,175,A15,6,Resign,White
TRUE,65,7+15,2039,2011,28,A22,5,Resign,White
TRUE,60,7+15,2017,2167,-150,A15,6,Out of Time,Black
TRUE,120,7+15,1900,2010,-110,A00,1,Resign,Black
TRUE,78,7+15,2031,2086,-55,A10,2,Out of Time,Black
TRUE,24,7+15,1901,2024,-123,B01,2,Resign,Black
TRUE,61,7+15,1929,2037,-108,B01,4,Resign,White
TRUE,55,7+15,2030,1937,93,A36,5,Resign,White
TRUE,86,7+14,2017,2020,-3,B01,4,Resign,Black
TRUE,34,7+14,2030,2036,-6,E90,9,Out of Time,Black
TRUE,58,10+10,2000,2020,-20,A46,6,Mate,Black
TRUE,67,7+14,2011,1978,33,A21,3,Resign,White
TRUE,44,7+14,1912,2003,-91,A00,2,Resign,Black
TRUE,75,7+14,1993,1996,-3,E71,9,Resign,White
TRUE,118,7+14,2111,1981,130,B01,6,Draw,Draw
TRUE,60,7+14,1994,1917,77,A22,5,Resign,Black
TRUE,67,5+12,2028,1971,57,B30,5,Out of Time,White
TRUE,54,5+12,1997,1500,497,A82,4,Resign,Black
TRUE,17,8+8,1682,1396,286,C57,11,Mate,White
TRUE,19,15+0,1861,1398,463,A84,4,Resign,White
FALSE,96,5+8,1788,1399,389,C42,5,Resign,Black
TRUE,107,10+10,1776,1401,375,B90,10,Mate,White
FALSE,16,8+4,1401,1603,-202,C42,6,Resign,Black
FALSE,2,15+5,1401,1612,-211,B07,2,Resign,Black
TRUE,135,10+0,1706,1405,301,B20,3,Mate,White
TRUE,72,90+0,1418,1421,-3,C00,3,Mate,Black
TRUE,53,90+0,1408,1432,-24,A00,1,Mate,White
TRUE,29,25+10,1420,1591,-171,C45,7,Resign,White
TRUE,52,5+8,1430,1805,-375,C45,8,Mate,Black
TRUE,53,7+5,2022,1431,591,B90,11,Resign,White
TRUE,65,12+8,1551,1440,111,B84,12,Mate,White
TRUE,65,12+0,1640,1447,193,B33,11,Mate,White
TRUE,69,8+8,1783,1450,333,B50,4,Mate,White
TRUE,47,30+0,1428,1666,-238,B80,11,Mate,White
TRUE,37,20+0,1776,1432,344,B93,11,Resign,White
TRUE,120,20+0,1629,1410,219,B50,4,Mate,Black
TRUE,62,1+25,1450,1392,58,A40,1,Mate,Black
TRUE,65,8+0,1482,1460,22,C24,4,Resign,White
TRUE,52,20+0,1442,1449,-7,C50,7,Mate,Black
TRUE,52,5+8,1533,1435,98,C50,6,Mate,Black
TRUE,57,11+3,1500,1442,58,C50,9,Mate,White
TRUE,95,5+20,1450,1532,-82,A40,2,Resign,Black
TRUE,13,120+0,1623,1456,167,C50,8,Resign,White
TRUE,153,10+8,1541,1465,76,C45,8,Mate,White
TRUE,89,0+12,1655,1470,185,C21,4,Resign,White
TRUE,58,10+0,1480,1533,-53,A40,2,Resign,Black
TRUE,30,10+0,1311,1495,-184,D08,4,Resign,White
TRUE,73,60+0,1485,1474,11,D00,3,Resign,White
TRUE,47,8+0,1479,1496,-17,C20,4,Resign,White
TRUE,63,8+0,1485,1490,-5,A40,2,Resign,White
TRUE,16,15+0,1479,1573,-94,A40,2,Resign,Black
TRUE,4,5+8,1543,1466,77,C44,4,Out of Time,Black
TRUE,76,10+0,1478,1461,17,D00,3,Mate,Black
TRUE,58,17+0,1488,1490,-2,D00,3,Mate,Black
TRUE,78,17+13,1560,1475,85,D05,6,Resign,Black
TRUE,56,30+8,1477,1483,-6,C50,8,Resign,White
TRUE,58,11+8,1492,1553,-61,A45,2,Mate,Black
TRUE,76,5+5,1551,1479,72,D06,6,Out of Time,Black
TRUE,116,10+10,1603,1475,128,C44,6,Draw,Draw
TRUE,21,5+15,1500,1482,18,B20,3,Mate,White
TRUE,74,18+0,1485,1471,14,C20,4,Out of Time,Black
TRUE,128,6+6,1469,1524,-55,D00,3,Draw,Draw
TRUE,20,6+5,1376,1472,-96,C50,8,Draw,Draw
TRUE,45,15+0,1492,1483,9,B54,6,Resign,White
TRUE,67,10+0,1499,1493,6,B50,4,Mate,White
TRUE,49,8+0,1482,1483,-1,D00,3,Mate,White
TRUE,52,10+0,1468,1592,-124,D00,3,Resign,White
TRUE,79,16+8,1457,1446,11,D00,3,Mate,White
TRUE,45,15+8,1449,1377,72,A40,2,Resign,White
TRUE,70,6+6,1458,1521,-63,A40,2,Mate,Black
FALSE,40,5+8,1500,1500,0,C42,5,Resign,Black
TRUE,36,15+15,1002,1412,-410,B80,10,Resign,White
TRUE,36,15+15,1461,1402,59,D00,8,Resign,Black
TRUE,62,15+15,1256,1395,-139,B50,4,Mate,Black
TRUE,44,15+15,1370,1372,-2,D04,5,Resign,Black
TRUE,37,15+15,1325,1375,-50,A48,5,Resign,White
TRUE,96,15+15,1204,1379,-175,B23,3,Draw,Draw
TRUE,27,15+15,1429,1389,40,B21,5,Resign,White
TRUE,97,15+15,1470,1397,73,B20,3,Mate,White
TRUE,75,30+15,1386,1397,-11,C60,6,Mate,White
TRUE,16,15+15,1393,1539,-146,C55,6,Resign,Black
TRUE,47,15+15,1532,1400,132,B07,6,Mate,White
TRUE,63,15+15,1470,1409,61,B50,4,Mate,White
TRUE,121,10+10,1524,1416,108,B29,5,Mate,White
TRUE,63,15+15,1445,1426,19,A45,2,Mate,White
TRUE,77,15+15,1416,1438,-22,B54,6,Mate,White
TRUE,72,15+15,1359,1440,-81,B21,3,Draw,Draw
TRUE,65,15+15,1413,1430,-17,B28,4,Resign,Black
TRUE,58,15+15,1094,1427,-333,B02,4,Mate,Black
TRUE,79,15+15,1269,1421,-152,B54,5,Resign,Black
TRUE,59,15+15,1341,1434,-93,B51,5,Mate,White
TRUE,88,15+15,1250,1428,-178,A06,2,Resign,Black
TRUE,62,15+15,1417,1417,0,B20,2,Resign,Black
TRUE,94,15+15,1404,1418,-14,B20,3,Draw,Draw
TRUE,16,15+15,1397,1407,-10,B51,5,Resign,Black
TRUE,86,15+15,1463,1405,58,A45,3,Draw,Draw
TRUE,44,15+8,1300,1397,-97,B40,6,Resign,Black
TRUE,56,15+8,1401,1296,105,B20,3,Draw,Draw
TRUE,27,15+15,1319,1414,-95,C20,3,Resign,White
TRUE,79,15+15,1541,1422,119,B30,4,Resign,White
TRUE,55,15+15,1419,1074,345,C40,4,Mate,White
TRUE,26,15+15,1081,1416,-335,A45,3,Mate,Black
TRUE,42,15+15,1498,1391,107,A00,1,Resign,Black
TRUE,85,15+15,1534,1397,137,B22,3,Mate,White
TRUE,46,10+15,1417,1386,31,B20,3,Mate,Black
TRUE,25,15+15,1511,1393,118,B33,10,Resign,White
TRUE,39,15+15,1405,1403,2,A20,2,Mate,White
TRUE,84,15+15,1319,1395,-76,B20,2,Mate,Black
TRUE,56,15+15,1434,1383,51,A45,2,Resign,Black
TRUE,32,15+15,1421,1371,50,A00,1,Mate,Black
TRUE,88,15+15,1383,1360,23,B51,5,Mate,Black
TRUE,157,15+15,1262,1374,-112,A00,1,Mate,White
TRUE,48,15+30,1386,1326,60,C48,9,Mate,Black
TRUE,26,15+15,1054,1373,-319,A00,1,Resign,Black
TRUE,100,20+0,1381,1460,-79,B22,3,Mate,Black
TRUE,56,5+5,1831,2120,-289,B34,9,Out of Time,Black
TRUE,103,10+10,1943,1839,104,C41,5,Resign,White
TRUE,42,9+8,1842,2137,-295,A06,3,Resign,Black
TRUE,80,15+0,1849,1968,-119,C00,3,Resign,Black
TRUE,51,15+0,1960,1857,103,C41,5,Mate,White
TRUE,112,15+0,1865,1952,-87,D01,7,Resign,Black
TRUE,44,10+10,1870,2073,-203,A04,2,Resign,Black
TRUE,61,5+8,2022,1877,145,C34,5,Resign,White
TRUE,97,10+8,1909,1887,22,C41,5,Resign,White
TRUE,159,8+0,1954,1902,52,C41,5,Out of Time,White
TRUE,82,8+0,1913,1925,-12,A06,3,Resign,Black
TRUE,61,8+0,1901,1924,-23,A06,3,Resign,White
TRUE,59,8+0,1889,1938,-49,A06,3,Resign,White
TRUE,146,8+10,1950,1876,74,C41,5,Resign,Black
TRUE,20,5+5,1885,1960,-75,A04,2,Resign,Black
TRUE,119,5+5,1951,1894,57,A10,1,Resign,White
TRUE,98,15+2,1891,1912,-21,B30,4,Resign,Black
TRUE,41,15+0,2152,1895,257,C41,5,Out of Time,White
TRUE,58,12+12,1943,1882,61,C41,5,Resign,Black
TRUE,16,20+5,1993,1868,125,C41,5,Out of Time,Black
TRUE,97,10+2,1855,1912,-57,A06,3,Resign,White
TRUE,35,10+10,2177,1858,319,C41,5,Resign,White
TRUE,31,10+0,2092,1863,229,C00,4,Mate,White
TRUE,68,5+10,1870,1989,-119,A04,2,Resign,Black
TRUE,65,10+5,2054,1876,178,C41,5,Resign,White
TRUE,29,8+0,2026,1883,143,C00,3,Mate,White
TRUE,55,8+0,2017,1890,127,C00,3,Resign,White
TRUE,60,10+0,1897,2003,-106,A04,2,Resign,Black
TRUE,55,10+0,1995,1905,90,B10,4,Resign,White
TRUE,65,10+15,1869,1960,-91,A06,3,Resign,White
TRUE,50,10+5,1875,2042,-167,A06,3,Resign,Black
TRUE,16,5+10,1884,1932,-48,A04,3,Resign,Black
TRUE,39,5+5,1872,1918,-46,A04,2,Out of Time,White
TRUE,40,5+8,1915,1859,56,C27,3,Resign,Black
TRUE,23,5+8,1906,1869,37,C41,4,Resign,White
TRUE,46,5+5,2069,1875,194,A41,4,Resign,White
TRUE,71,7+5,1862,1935,-73,A04,3,Resign,White
TRUE,41,5+5,1937,1870,67,A41,2,Resign,White
TRUE,68,5+8,1973,1856,117,A41,3,Resign,Black
TRUE,155,7+2,1842,1958,-116,A06,3,Resign,White
FALSE,31,20+0,1276,1486,-210,D00,3,Resign,White
TRUE,41,10+0,1743,1504,239,D20,5,Mate,White
FALSE,90,10+2,1504,1685,-181,C46,5,Resign,Black
TRUE,55,10+2,1685,1504,181,B01,4,Mate,White
TRUE,3,8+10,1639,1504,135,D02,3,Resign,White
TRUE,21,15+0,1733,1504,229,A00,5,Resign,White
TRUE,52,5+5,1556,1588,-32,C00,4,Resign,Black
TRUE,55,5+5,1713,1525,188,D35,6,Resign,White
TRUE,74,5+15,1823,1880,-57,C61,6,Resign,Black
TRUE,66,5+6,1739,1713,26,C46,7,Out of Time,Black
TRUE,6,4+8,1966,1616,350,C60,6,Out of Time,Black
TRUE,44,4+8,1620,1909,-289,B02,4,Resign,Black
TRUE,164,5+8,1829,1500,329,D00,4,Resign,Black
FALSE,4,20+60,1992,1811,181,B00,2,Draw,Draw
FALSE,39,5+5,1413,1430,-17,B01,2,Resign,Black
FALSE,67,20+20,2430,1413,1017,B07,3,Mate,White
FALSE,31,10+0,1666,1413,253,D12,8,Resign,White
FALSE,42,8+2,1477,1413,64,B07,7,Resign,White
FALSE,27,10+0,1806,1413,393,A41,2,Resign,White
FALSE,24,10+0,1413,1806,-393,B12,5,Resign,Black
FALSE,85,11+0,1388,1413,-25,A41,2,Out of Time,White
FALSE,24,8+4,1413,1425,-12,B21,3,Resign,Black
FALSE,31,10+0,1849,1413,436,B07,3,Resign,White
FALSE,16,7+5,1413,1336,77,C44,5,Resign,Black
FALSE,29,8+8,1413,1820,-407,B10,2,Resign,Black
FALSE,50,15+0,1852,1413,439,A40,1,Resign,White
FALSE,51,6+3,1861,1413,448,A40,1,Out of Time,White
TRUE,119,12+12,1421,1413,8,B07,2,Draw,Draw
TRUE,68,12+12,1423,1432,-9,C41,5,Resign,Black
TRUE,62,12+12,1431,1516,-85,C45,9,Resign,Black
TRUE,110,12+12,1650,1414,236,A41,3,Resign,Black
TRUE,49,12+12,1424,1441,-17,C41,5,Resign,Black
TRUE,74,12+12,1563,1431,132,B07,6,Resign,White
TRUE,68,12+10,1428,1527,-99,C00,3,Draw,Draw
TRUE,39,12+10,1439,1426,13,C45,7,Resign,Black
TRUE,44,13+12,1587,1423,164,C41,4,Mate,Black
TRUE,50,13+12,1390,1413,-23,B07,2,Resign,Black
TRUE,8,13+12,1403,1388,15,B00,3,Resign,White
TRUE,162,13+12,1600,1387,213,B06,8,Mate,Black
TRUE,47,13+12,1470,1395,75,C41,5,Mate,White
TRUE,55,13+12,1406,1391,15,B12,3,Resign,Black
TRUE,47,13+12,1379,1418,-39,A00,1,Mate,White
TRUE,73,13+12,1411,1303,108,C00,3,Resign,White
TRUE,105,13+12,1387,1401,-14,B07,2,Resign,Black
TRUE,48,13+12,1411,1404,7,B01,6,Mate,Black
TRUE,77,13+12,1418,1574,-156,C41,5,Resign,Black
TRUE,38,12+12,1419,1382,37,B10,5,Resign,Black
TRUE,48,15+15,1429,1432,-3,B06,2,Resign,Black
TRUE,49,15+15,1492,1438,54,A41,2,Resign,White
TRUE,35,15+15,1447,1499,-52,C44,5,Resign,Black
TRUE,119,15+15,1436,1472,-36,C44,5,Resign,White
TRUE,8,15+15,1518,1431,87,B07,2,Draw,Draw
TRUE,141,15+15,1352,1444,-92,B07,2,Mate,White
TRUE,39,10+15,1441,1464,-23,C45,8,Mate,White
TRUE,52,10+15,1500,1432,68,B07,3,Mate,Black
TRUE,107,10+15,1424,1355,69,C40,5,Resign,White
FALSE,39,30+0,1441,1500,-59,C21,3,Mate,White
TRUE,70,15+0,1710,1911,-201,B01,2,Mate,Black
FALSE,48,16+4,1944,1896,48,C26,7,Mate,Black
TRUE,94,10+8,1944,1928,16,A46,5,Mate,Black
TRUE,70,15+0,1781,1930,-149,A06,3,Resign,Black
TRUE,51,15+0,1914,1788,126,B08,9,Resign,White
TRUE,77,15+0,1892,1831,61,C41,7,Resign,White
TRUE,30,7+5,1733,1875,-142,C50,8,Resign,Black
TRUE,58,20+10,1791,1851,-60,C41,4,Mate,Black
TRUE,28,17+0,1940,1808,132,C38,12,Resign,Black
TRUE,76,10+5,1774,1772,2,B10,2,Resign,White
TRUE,52,10+0,1850,1905,-55,A46,5,Mate,Black
TRUE,61,7+8,2041,1876,165,A15,4,Mate,White
FALSE,85,9+3,1329,1876,-547,D00,3,Mate,White
TRUE,40,12+5,1670,1848,-178,A46,5,Resign,Black
TRUE,33,15+0,1814,1661,153,D02,4,Resign,White
TRUE,94,30+8,1884,1827,57,D24,7,Mate,Black
TRUE,3,7+6,1880,1886,-6,C23,3,Draw,Draw
TRUE,93,25+0,1857,1537,320,C27,3,Mate,White
TRUE,64,25+0,1541,1817,-276,B20,3,Mate,Black
TRUE,77,20+10,1662,1692,-30,B03,10,Resign,White
TRUE,48,5+8,1500,1500,0,B07,2,Resign,Black
TRUE,3,10+2,1563,1396,167,C40,3,Draw,Draw
FALSE,61,14+0,1835,1396,439,C41,7,Resign,White
TRUE,27,8+8,1329,1061,268,C41,4,Resign,White
TRUE,60,8+8,1067,1263,-196,C22,6,Mate,Black
TRUE,115,10+8,1392,1500,-108,C20,3,Mate,White
TRUE,68,10+0,1000,999,1,C42,4,Mate,Black
TRUE,92,10+0,1006,1399,-393,C02,5,Resign,Black
TRUE,91,8+0,1404,1013,391,B20,2,Resign,White
TRUE,74,10+0,1015,1563,-548,B13,5,Resign,Black
FALSE,51,15+5,1015,1200,-185,C44,5,Resign,Black
TRUE,81,15+0,1619,1017,602,C46,7,Resign,White
TRUE,90,15+0,1020,1618,-598,C44,5,Resign,Black
TRUE,37,15+0,1617,1022,595,B50,4,Mate,White
FALSE,76,30+8,1173,1022,151,B20,2,Resign,White
TRUE,43,15+3,1169,1448,-279,A00,1,Mate,White
TRUE,37,19+8,1152,1471,-319,B06,5,Mate,White
TRUE,60,10+3,1494,1215,279,A00,4,Mate,Black
TRUE,77,10+3,1194,1519,-325,B00,2,Mate,White
TRUE,35,10+2,1513,1273,240,A00,4,Resign,White
TRUE,92,8+5,1240,1507,-267,A40,2,Out of Time,Black
TRUE,43,9+6,1504,1139,365,A00,1,Mate,White
TRUE,80,9+6,1148,1500,-352,A00,1,Mate,Black
TRUE,105,8+0,1497,1113,384,A00,2,Out of Time,White
TRUE,45,8+0,1494,1116,378,A49,11,Resign,White
TRUE,39,10+0,1283,1516,-233,B06,7,Mate,White
TRUE,73,13+0,1513,1156,357,A00,1,Mate,White
TRUE,59,12+0,1507,1248,259,A00,1,Mate,White
TRUE,53,8+8,1502,1227,275,A00,1,Mate,White
TRUE,23,10+0,1498,1147,351,A00,1,Resign,White
TRUE,44,30+8,1248,1492,-244,B06,2,Resign,Black
TRUE,49,30+0,1485,1298,187,A00,1,Resign,White
FALSE,63,30+8,1500,1329,171,C00,3,Mate,White
TRUE,48,10+0,1382,1644,-262,A00,1,Mate,Black
TRUE,27,10+0,1638,1500,138,B07,3,Mate,White
TRUE,58,40+0,1611,1839,-228,C43,6,Resign,Black
TRUE,74,20+0,1622,1694,-72,C62,11,Mate,Black
TRUE,24,15+30,1941,1626,315,C69,10,Resign,White
TRUE,25,20+0,1795,1635,160,C55,6,Mate,White
TRUE,71,15+0,1642,1847,-205,B00,2,Resign,Black
TRUE,59,10+15,1900,1647,253,C78,9,Resign,White
TRUE,42,15+0,1649,2183,-534,B32,8,Resign,Black
TRUE,90,30+0,1651,2068,-417,B96,13,Mate,Black
TRUE,28,8+0,1668,1808,-140,C60,6,Resign,Black
TRUE,89,30+0,1855,1675,180,C20,3,Resign,White
TRUE,36,15+5,2240,1677,563,C45,8,Resign,White
TRUE,73,15+5,1678,2205,-527,C72,9,Resign,Black
TRUE,33,15+0,1679,2293,-614,C91,19,Resign,Black
TRUE,24,20+0,1921,1685,236,D06,4,Resign,White
TRUE,32,20+15,1674,2022,-348,C11,7,Draw,Draw
TRUE,68,12+0,1966,1679,287,C58,11,Resign,White
TRUE,65,15+0,2105,1681,424,C55,10,Resign,White
TRUE,60,20+0,1886,1688,198,C46,7,Resign,White
TRUE,47,10+5,1690,2172,-482,B43,10,Resign,Black
TRUE,49,15+10,2121,1693,428,C78,11,Resign,White
TRUE,53,20+0,1918,1699,219,D04,5,Mate,White
TRUE,51,10+8,1703,2021,-318,B32,8,Resign,Black
TRUE,56,14+8,1707,2021,-314,C41,5,Out of Time,Black
TRUE,82,15+10,2021,1711,310,C55,7,Resign,White
TRUE,29,15+10,1694,1838,-144,C71,16,Resign,White
TRUE,102,15+7,1906,1672,234,C47,8,Resign,Black
TRUE,94,15+0,1673,2300,-627,C81,17,Resign,Black
TRUE,25,10+5,2037,1677,360,C46,7,Resign,White
TRUE,26,20+0,1920,1682,238,D85,8,Resign,White
TRUE,60,15+1,1688,1935,-247,C41,8,Mate,Black
TRUE,71,180+0,1896,1644,252,C45,7,Resign,Black
TRUE,41,45+0,1870,1650,220,C33,7,Mate,White
TRUE,52,15+1,1860,1657,203,D06,4,Resign,White
TRUE,58,30+8,1786,1665,121,C77,9,Resign,White
TRUE,19,15+10,2134,1667,467,C45,8,Resign,White
TRUE,66,30+10,1660,1852,-192,B01,9,Draw,Draw
TRUE,40,20+0,1793,1640,153,C46,7,Resign,Black
TRUE,75,90+0,1865,1617,248,C92,18,Resign,Black
TRUE,56,15+0,1601,1943,-342,C60,6,Resign,Black
TRUE,48,10+5,1603,2001,-398,C88,13,Resign,Black
TRUE,50,10+5,1946,1607,339,E70,7,Resign,White
TRUE,40,8+0,1612,1891,-279,C60,5,Resign,Black
TRUE,34,90+0,1808,1619,189,C55,7,Resign,White
TRUE,37,20+0,1624,1864,-240,B07,3,Resign,Black
TRUE,59,10+0,1922,1629,293,C68,7,Resign,White
TRUE,73,12+0,1841,1636,205,D90,7,Mate,White
TRUE,41,8+0,1696,1702,-6,C41,7,Out of Time,White
TRUE,112,10+0,1642,1585,57,C00,2,Resign,Black
TRUE,56,10+0,1765,1622,143,A00,7,Resign,Black
TRUE,64,10+0,1649,1500,149,A30,2,Out of Time,Black
TRUE,89,6+3,1138,1104,34,A02,1,Mate,White
TRUE,74,6+3,1135,1125,10,B01,2,Mate,Black
TRUE,32,4+8,1157,1264,-107,C20,3,Out of Time,Black
TRUE,31,4+8,1126,1094,32,B10,2,Out of Time,White
TRUE,87,5+9,1328,1146,182,A41,2,Resign,White
TRUE,79,4+8,1681,1150,531,C30,3,Resign,White
TRUE,114,4+8,1154,1679,-525,C02,6,Resign,Black
TRUE,37,4+8,1165,1127,38,C02,7,Mate,White
TRUE,102,4+8,1188,1415,-227,C41,4,Resign,Black
TRUE,82,8+3,1096,1135,-39,C42,5,Mate,Black
FALSE,50,5+8,1135,1709,-574,D00,2,Mate,Black
FALSE,110,10+5,2186,1466,720,B23,3,Draw,Draw
FALSE,48,10+5,1756,1466,290,B23,3,Out of Time,Black
FALSE,40,10+5,1181,1466,-285,B51,5,Resign,Black
FALSE,94,10+5,1766,1466,300,A00,1,Mate,Black
FALSE,57,10+5,1662,1466,196,B54,6,Resign,Black
TRUE,165,10+0,1869,1724,145,A45,2,Out of Time,White
TRUE,139,10+0,1727,1627,100,A45,2,Out of Time,Draw
TRUE,78,10+0,1750,1715,35,B00,2,Mate,Black
FALSE,94,10+0,1887,1715,172,B12,5,Draw,Draw
FALSE,38,10+0,1715,1887,-172,D92,9,Resign,Black
TRUE,3,10+0,1677,1716,-39,A40,1,Draw,Draw
TRUE,85,10+0,1707,1637,70,D10,5,Resign,White
FALSE,48,15+0,1707,1193,514,C21,3,Mate,Black
FALSE,52,8+0,1707,2000,-293,A45,2,Mate,Black
FALSE,53,8+0,2000,1707,293,D10,5,Resign,White
TRUE,115,10+0,1694,1755,-61,D30,4,Mate,White
TRUE,85,10+0,1683,1708,-25,D11,5,Resign,White
TRUE,56,10+0,1692,1756,-64,E60,5,Resign,Black
FALSE,42,10+0,1275,1692,-417,C57,11,Mate,Black
TRUE,45,10+0,1707,1703,4,B13,5,Resign,White
TRUE,164,10+0,1862,1698,164,A40,1,Out of Time,Draw
TRUE,43,10+0,1683,1814,-131,D31,6,Resign,White
TRUE,101,10+0,1677,1460,217,A40,4,Mate,White
FALSE,121,10+0,1500,1677,-177,A00,1,Draw,Draw
FALSE,80,10+0,1677,1500,177,E00,4,Mate,Black
FALSE,32,10+0,1500,1677,-177,B12,5,Resign,Black
FALSE,88,10+0,1677,1245,432,C40,6,Mate,Black
FALSE,106,8+0,1728,1677,51,B10,5,Resign,Black
FALSE,48,9+0,1677,1500,177,A84,3,Resign,White
FALSE,89,10+0,1677,1728,-51,D35,6,Resign,White
TRUE,54,10+0,1687,1732,-45,D20,5,Resign,Black
FALSE,77,9+0,2060,1687,373,A03,2,Mate,White
TRUE,94,10+0,1699,1704,-5,A40,2,Out of Time,Black
FALSE,147,10+0,1834,1699,135,B12,5,Mate,White
FALSE,63,10+0,1699,1834,-135,D35,6,Resign,White
TRUE,61,5+5,1504,1398,106,B01,4,Mate,White
TRUE,62,5+8,1506,1978,-472,B23,3,Mate,Black
TRUE,65,10+2,1494,1348,146,B01,6,Mate,White
TRUE,52,5+8,1522,1360,162,C40,4,Out of Time,Black
TRUE,11,5+8,1342,1553,-211,C00,2,Resign,White
TRUE,14,5+8,1924,1512,412,C15,7,Resign,Black
TRUE,65,5+8,1554,1532,22,C01,5,Resign,White
TRUE,102,11+0,1623,1530,93,A40,2,Resign,Black
TRUE,48,11+0,1511,1614,-103,B01,2,Resign,Black
TRUE,49,11+0,1607,1463,144,A43,2,Resign,White
TRUE,49,12+0,1606,1101,505,A40,1,Resign,White
TRUE,47,15+0,1596,1535,61,A40,2,Mate,White
TRUE,62,8+2,1600,1880,-280,D00,5,Mate,Black
TRUE,66,10+0,1607,1771,-164,A45,2,Mate,Black
TRUE,90,10+0,1619,1593,26,A45,2,Resign,Black
TRUE,44,10+0,1634,1526,108,A40,2,Resign,Black
TRUE,89,10+0,1547,1625,-78,B22,3,Resign,Black
TRUE,92,5+8,1799,1634,165,B20,3,Out of Time,Black
FALSE,31,14+0,1634,1601,33,D20,6,Resign,White
TRUE,30,30+5,1789,1607,182,B27,4,Resign,Black
TRUE,59,5+5,1901,1613,288,B24,5,Resign,White
TRUE,18,5+8,1638,1631,7,A00,1,Resign,White
FALSE,155,15+8,1854,1631,223,E10,5,Out of Time,White
TRUE,61,15+10,1627,1661,-34,B20,3,Resign,White
FALSE,59,5+8,2048,1661,387,B36,8,Resign,White
TRUE,13,15+1,1629,1858,-229,A40,2,Resign,White
FALSE,58,15+0,1895,1831,64,B30,5,Resign,Black
FALSE,69,15+0,1895,1636,259,B30,5,Resign,White
FALSE,87,15+0,1895,1893,2,B30,5,Draw,Draw
FALSE,122,15+0,1675,1895,-220,B20,3,Resign,Black
FALSE,24,15+0,1768,1895,-127,A02,3,Resign,Black
FALSE,117,15+0,1853,1895,-42,B10,2,Resign,White
FALSE,62,15+0,1895,1774,121,B12,7,Resign,Black
TRUE,84,8+0,1808,1752,56,A45,3,Resign,Black
TRUE,44,10+0,1631,1500,131,B10,2,Resign,Black
FALSE,63,5+5,1804,1703,101,B40,4,Out of Time,White
TRUE,43,10+1,1633,1591,42,E60,5,Resign,White
TRUE,26,10+0,1606,1465,141,C48,7,Resign,Black
TRUE,24,10+0,1472,1599,-127,C65,6,Resign,Black
TRUE,23,10+0,1589,1569,20,C70,8,Resign,White
TRUE,58,10+1,1600,1595,5,D06,4,Resign,Black
TRUE,69,10+0,1571,1612,-41,B08,8,Resign,White
TRUE,36,10+0,1626,1536,90,B33,11,Mate,Black
TRUE,66,10+0,1561,1616,-55,A16,3,Resign,Black
TRUE,29,10+0,1610,1427,183,B32,5,Resign,White
TRUE,88,10+4,1328,1607,-279,B21,3,Resign,Black
TRUE,42,10+0,1616,1673,-57,C01,7,Mate,Black
TRUE,77,10+0,1448,1632,-184,B20,3,Out of Time,White
TRUE,15,10+0,1646,1573,73,C42,5,Resign,Black
TRUE,47,10+0,1636,1601,35,B01,4,Mate,White
TRUE,84,10+0,1525,1628,-103,A48,5,Resign,Black
TRUE,43,10+0,1618,1579,39,B07,3,Mate,White
TRUE,33,10+0,1689,1627,62,E71,9,Resign,White
TRUE,45,10+0,1689,1637,52,E90,11,Resign,White
TRUE,29,10+0,1650,1585,65,C62,6,Resign,Black
TRUE,49,10+1,1642,1541,101,C66,8,Resign,White
TRUE,33,10+0,1633,1550,83,C79,10,Resign,White
TRUE,51,10+0,1647,1562,85,C66,8,Resign,Black
TRUE,41,10+0,1766,1655,111,A45,2,Mate,White
TRUE,22,10+0,1822,1662,160,C48,8,Resign,White
TRUE,22,10+0,1672,1706,-34,B01,4,Resign,Black
TRUE,58,10+0,1682,1744,-62,B01,6,Resign,Black
TRUE,92,10+0,1757,1667,90,C50,9,Mate,Black
TRUE,76,10+0,1680,1673,7,C41,5,Resign,Black
TRUE,47,10+0,1669,1629,40,B90,11,Resign,White
TRUE,23,10+0,1708,1680,28,B07,6,Resign,White
TRUE,146,10+0,1682,1629,53,C66,8,Draw,Draw
TRUE,90,15+15,1500,1676,-176,E61,4,Mate,Black
TRUE,34,15+15,1664,1649,15,C78,12,Resign,White
TRUE,27,10+0,1640,1664,-24,C42,5,Resign,White
TRUE,52,10+0,1664,1626,38,E90,11,Resign,Black
TRUE,97,10+0,1618,1640,-22,C20,3,Resign,White
TRUE,80,10+0,1648,1792,-144,C00,4,Resign,Black
TRUE,20,10+0,1342,1632,-290,E00,1,Mate,Black
TRUE,18,30+0,1402,1642,-240,B08,8,Out of Time,Black
FALSE,5,11+7,1706,1402,304,A00,1,Out of Time,White
TRUE,40,10+10,1702,1500,202,B00,2,Resign,White
TRUE,5,3+9,1348,1545,-197,E00,1,Resign,White
FALSE,71,0+180,1110,1500,-390,A04,1,Out of Time,White
FALSE,13,16+8,1110,1500,-390,A04,2,Out of Time,White
FALSE,97,16+8,1110,1500,-390,A00,1,Resign,White
TRUE,114,5+15,1968,2344,-376,C16,7,Mate,Black
TRUE,86,10+0,2230,1948,282,B90,10,Out of Time,Black
TRUE,53,7+7,1933,2008,-75,C42,5,Resign,White
TRUE,127,10+0,2003,1942,61,D94,9,Resign,White
TRUE,92,10+0,1953,1957,-4,C00,3,Resign,Black
TRUE,81,7+7,1939,2011,-72,C55,6,Out of Time,White
TRUE,45,15+0,2197,1943,254,B51,5,Resign,White
TRUE,79,15+0,2264,1946,318,A15,6,Resign,White
TRUE,34,15+0,1949,2260,-311,C00,3,Resign,Black
TRUE,83,10+0,1934,2045,-111,B00,2,Resign,White
TRUE,92,15+2,1939,2129,-190,C46,6,Resign,Black
FALSE,65,15+0,2104,1939,165,B54,6,Out of Time,White
TRUE,66,5+5,1947,2060,-113,C58,11,Resign,Black
TRUE,72,12+0,1954,2082,-128,C00,3,Resign,Black
TRUE,102,8+0,1965,1940,25,B10,2,Out of Time,Black
TRUE,31,6+4,1533,1270,263,C40,3,Resign,White
TRUE,45,10+10,1679,1294,385,C21,3,Mate,White
TRUE,32,10+0,1352,1577,-225,C20,3,Mate,Black
FALSE,57,5+5,1514,2032,-518,B07,2,Resign,White
FALSE,4,10+10,1775,1514,261,A00,1,Resign,White
FALSE,50,5+5,1514,2032,-518,B07,6,Resign,Black
FALSE,55,15+5,1514,1333,181,D11,7,Resign,White
FALSE,45,5+6,1531,1514,17,C50,6,Resign,Black
FALSE,27,10+0,1514,1836,-322,A42,5,Resign,White
FALSE,59,10+1,1521,1514,7,A43,4,Out of Time,White
TRUE,11,10+0,1511,1514,-3,C42,5,Out of Time,White
TRUE,7,15+0,1554,1104,450,C41,5,Resign,White
TRUE,126,25+30,1364,1033,331,B02,4,Mate,Black
FALSE,69,30+0,1033,1500,-467,C20,3,Mate,White
TRUE,49,12+9,1442,1041,401,B02,2,Mate,White
TRUE,40,12+9,1050,1439,-389,A01,2,Mate,Black
TRUE,51,12+9,1437,1060,377,B01,2,Resign,White
FALSE,39,10+0,1842,1060,782,B01,4,Mate,White
TRUE,85,14+5,1362,1076,286,D00,3,Resign,White
TRUE,64,20+0,1388,1112,276,C42,6,Resign,White
TRUE,10,20+0,1137,1383,-246,A40,2,Resign,Black
TRUE,13,20+0,1378,1170,208,C40,4,Resign,White
TRUE,78,20+0,1218,1371,-153,C20,4,Mate,Black
TRUE,21,20+0,1363,1299,64,D00,3,Resign,White
TRUE,31,5+8,1605,1352,253,C41,5,Resign,White
TRUE,65,5+8,1559,1500,59,C41,5,Out of Time,White
FALSE,41,25+0,2005,978,1027,C55,7,Resign,White
FALSE,54,25+0,978,2005,-1027,B25,4,Mate,Black
FALSE,108,25+0,1483,2005,-522,B25,4,Out of Time,Draw
FALSE,139,8+0,2005,1895,110,A03,2,Out of Time,White
FALSE,162,8+0,1878,2005,-127,B30,4,Out of Time,Black
TRUE,76,10+2,1088,1217,-129,B54,6,Resign,White
TRUE,30,10+10,1224,1372,-148,C60,5,Out of Time,Black
TRUE,45,10+2,1209,1237,-28,B20,2,Resign,White
TRUE,115,5+5,1504,1241,263,A40,2,Resign,White
TRUE,71,10+5,1225,1378,-153,C62,6,Resign,White
TRUE,29,8+10,1222,1356,-134,C64,6,Out of Time,White
TRUE,115,10+0,1202,1522,-320,C44,5,Resign,White
TRUE,97,10+0,1132,1193,-61,A01,3,Resign,Black
TRUE,36,10+0,1202,1513,-311,C65,6,Resign,Black
TRUE,55,10+3,1207,1422,-215,B21,3,Resign,Black
TRUE,62,15+8,1328,1215,113,B07,2,Resign,White
TRUE,52,25+0,1224,1294,-70,C41,6,Resign,Black
TRUE,62,7+5,1121,1212,-91,A40,2,Mate,Black
TRUE,36,15+3,1221,1334,-113,C00,4,Resign,Black
TRUE,68,15+3,1350,1204,146,A04,2,Mate,Black
TRUE,50,10+0,1212,1331,-119,B00,2,Resign,Black
TRUE,34,5+8,1216,1523,-307,C41,4,Resign,Black
TRUE,30,5+5,1228,1222,6,C42,6,Resign,Black
TRUE,29,5+5,1233,1215,18,B20,3,Resign,Black
TRUE,63,8+0,1340,1235,105,B32,7,Resign,White
TRUE,22,10+5,1242,1402,-160,B21,3,Out of Time,Black
TRUE,30,15+3,1230,1246,-16,B20,3,Resign,White
TRUE,56,10+5,1594,1225,369,B23,3,Mate,Black
TRUE,37,19+2,1442,1230,212,B32,7,Resign,White
TRUE,99,30+0,1222,1314,-92,B01,4,Resign,White
TRUE,16,30+0,1329,1206,123,B20,2,Resign,Black
TRUE,78,25+0,1198,1316,-118,C44,6,Mate,Black
TRUE,81,9+4,1206,1341,-135,B00,3,Resign,Black
TRUE,115,8+3,1196,1112,84,C41,4,Mate,White
TRUE,31,8+3,1081,1213,-132,B27,3,Mate,White
TRUE,32,10+2,1528,1192,336,B20,3,Mate,Black
TRUE,54,10+7,1199,1359,-160,C00,3,Mate,Black
FALSE,18,5+8,1829,1420,409,C41,5,Resign,White
FALSE,26,11+10,2212,1829,383,D11,6,Resign,Black
FALSE,11,30+0,1829,1544,285,C60,5,Resign,White
FALSE,96,15+10,1829,1641,188,C70,8,Resign,Black
TRUE,42,5+8,1799,1811,-12,B12,7,Mate,Black
TRUE,37,5+8,1830,1830,0,C20,3,Resign,White
TRUE,22,10+35,1558,1500,58,B00,2,Resign,White
TRUE,53,4+6,1190,949,241,A02,2,Mate,White
TRUE,62,4+6,966,1185,-219,A10,3,Mate,Black
TRUE,78,5+8,915,910,5,B00,2,Out of Time,Black
TRUE,78,10+0,932,1389,-457,C50,6,Mate,Black
FALSE,35,15+30,1041,932,109,B02,2,Mate,White
TRUE,58,14+8,1015,1007,8,C20,2,Mate,Black
TRUE,40,4+7,1223,1333,-110,A40,2,Resign,Black
TRUE,27,4+7,1324,1321,3,A43,3,Mate,White
TRUE,75,20+8,1531,1190,341,B00,2,Mate,White
TRUE,24,20+8,1264,1477,-213,B02,4,Mate,Black
TRUE,7,20+8,1350,1500,-150,C20,3,Mate,White
TRUE,56,5+5,1500,1670,-170,C20,3,Mate,Black
TRUE,12,19+0,946,1545,-599,A02,2,Resign,Black
TRUE,9,19+0,1500,987,513,B00,2,Mate,White
TRUE,63,10+0,1899,1263,636,B00,2,Mate,White
TRUE,52,10+0,1272,1807,-535,A00,2,Mate,Black
TRUE,58,10+0,1628,1532,96,C20,3,Resign,Black
TRUE,74,11+0,1662,1584,78,B27,4,Out of Time,Black
FALSE,109,5+8,1802,1662,140,D02,3,Resign,White
TRUE,85,6+12,1635,1625,10,B18,8,Out of Time,White
TRUE,23,6+12,1705,1599,106,C34,6,Resign,Black
TRUE,65,8+0,1683,1627,56,C23,3,Resign,White
TRUE,64,8+0,1672,1663,9,C23,3,Resign,White
TRUE,37,7+2,1667,1708,-41,C40,6,Mate,White
TRUE,45,7+2,1661,1677,-16,C46,7,Resign,White
TRUE,37,12+0,1614,1608,6,A25,4,Resign,Black
TRUE,77,10+0,1631,1531,100,A02,1,Resign,Black
TRUE,129,5+8,1545,1616,-71,C02,5,Mate,White
TRUE,119,7+7,1526,1536,-10,C00,3,Resign,White
TRUE,79,5+8,1342,1580,-238,C45,7,Mate,White
TRUE,62,7+8,1667,1394,273,D00,3,Resign,White
FALSE,32,8+8,1500,1394,106,D00,2,Resign,White
TRUE,114,7+2,1500,1675,-175,C46,7,Resign,Black
TRUE,44,10+0,1923,1974,-51,B50,5,Resign,Black
TRUE,75,10+0,1747,1962,-215,B30,4,Mate,White
TRUE,57,10+0,1774,2003,-229,B25,4,Resign,White
TRUE,65,10+0,2024,2031,-7,B20,3,Resign,White
TRUE,106,10+0,1771,2019,-248,A00,1,Resign,Black
TRUE,76,10+0,2052,2028,24,B50,5,Resign,Black
TRUE,151,10+0,1605,2114,-509,B20,3,Out of Time,White
TRUE,57,8+0,2103,1822,281,C00,4,Resign,White
TRUE,75,8+0,2074,2013,61,C62,6,Resign,White
TRUE,57,8+0,1982,2042,-60,B30,4,Resign,Black
TRUE,33,8+0,2050,1981,69,C89,16,Draw,Draw
TRUE,152,8+0,1978,2061,-83,B30,4,Out of Time,Draw
TRUE,33,8+0,2074,2121,-47,B25,4,Resign,White
TRUE,96,8+0,2209,2044,165,B22,3,Resign,Black
TRUE,114,8+0,1689,2201,-512,B20,3,Resign,Black
TRUE,67,8+0,2198,1519,679,C44,5,Resign,White
TRUE,126,8+0,1524,2195,-671,B22,3,Out of Time,Black
FALSE,27,10+0,2195,2137,58,B50,5,Resign,White
TRUE,94,8+0,1357,2193,-836,A85,5,Mate,Black
TRUE,55,8+0,2192,1357,835,C41,4,Resign,White
FALSE,116,13+2,1609,2192,-583,B20,3,Resign,Black
FALSE,13,13+2,2192,1609,583,C44,6,Resign,White
TRUE,71,5+10,2130,2054,76,C43,7,Resign,White
TRUE,57,10+0,2113,1692,421,A06,3,Resign,White
TRUE,1,10+0,1484,2113,-629,B00,1,Resign,White
TRUE,61,8+0,2099,1627,472,C44,6,Mate,White
TRUE,22,8+0,1629,2082,-453,B34,9,Resign,Black
TRUE,50,10+0,1757,1896,-139,B00,4,Resign,White
TRUE,24,10+0,2007,1500,507,B24,5,Draw,Draw
TRUE,33,5+8,1467,1305,162,B10,2,Resign,White
TRUE,58,11+11,1333,1289,44,B10,2,Resign,Black
TRUE,49,11+11,1271,1346,-75,D06,4,Mate,White
TRUE,39,10+8,1572,1276,296,D10,4,Resign,White
TRUE,34,10+8,1281,1568,-287,D06,4,Mate,Black
TRUE,44,15+0,1282,1213,69,D20,4,Resign,Black
TRUE,30,5+8,1298,1285,13,D35,7,Resign,Black
TRUE,50,5+8,1301,1664,-363,A40,4,Mate,Black
TRUE,88,8+1,1642,1273,369,D00,3,Out of Time,Black
TRUE,76,10+0,1529,1247,282,B10,2,Resign,Black
TRUE,71,10+0,1515,1253,262,B10,2,Resign,White
TRUE,60,5+8,1270,1247,23,D35,6,Resign,Black
TRUE,49,5+8,1233,1289,-56,B15,5,Resign,White
TRUE,103,5+6,1542,1295,247,B10,2,Resign,White
FALSE,69,10+8,1295,1733,-438,A40,2,Resign,Black
TRUE,45,10+3,1305,1479,-174,D20,4,Resign,Black
TRUE,77,5+8,1282,1394,-112,D30,4,Mate,White
TRUE,101,5+8,1342,1298,44,B00,3,Resign,White
TRUE,58,15+0,1281,1286,-5,A80,2,Resign,White
TRUE,79,15+15,1655,1286,369,B10,2,Resign,White
FALSE,18,16+8,1500,1247,253,B00,3,Out of Time,Black
TRUE,73,10+10,1368,1500,-132,C20,4,Mate,White
FALSE,3,15+5,1500,1500,0,B23,3,Resign,White
TRUE,9,10+0,1581,1631,-50,C42,5,Resign,White
FALSE,53,15+10,1504,1631,-127,D44,8,Resign,Black
FALSE,90,20+20,1631,1606,25,C22,7,Resign,Black
FALSE,41,15+0,1500,1631,-131,A00,5,Resign,White
FALSE,61,20+0,1711,1631,80,C42,9,Resign,White
FALSE,45,15+0,1594,1631,-37,C48,8,Mate,White
FALSE,63,15+0,1631,1546,85,C21,3,Mate,White
TRUE,69,10+0,1617,1674,-57,B13,5,Resign,White
TRUE,103,10+0,1950,1620,330,C42,9,Resign,White
TRUE,68,10+0,1608,1591,17,B21,3,Draw,Draw
TRUE,47,10+0,1600,1432,168,C00,4,Mate,White
TRUE,60,10+0,1626,1599,27,C43,6,Draw,Draw
TRUE,50,10+0,1699,1581,118,C41,5,Mate,Black
TRUE,51,10+0,1562,1714,-152,C41,5,Resign,White
TRUE,16,10+0,1302,1585,-283,A10,2,Resign,White
TRUE,38,10+0,1593,1737,-144,C22,8,Resign,Black
TRUE,23,10+0,1730,1603,127,C55,6,Resign,White
TRUE,48,10+0,1611,1775,-164,B21,3,Mate,Black
TRUE,40,10+0,1635,1595,40,C24,4,Resign,Black
TRUE,70,10+0,1604,1757,-153,C22,8,Resign,Black
TRUE,72,10+0,1589,1588,1,C40,3,Resign,Black
FALSE,66,10+0,1588,1500,88,B00,5,Resign,Black
FALSE,76,10+0,1500,1588,-88,C20,3,Resign,Black
FALSE,28,15+8,1588,1203,385,B01,4,Resign,White
FALSE,111,10+0,1588,1500,88,B07,4,Resign,White
FALSE,49,8+0,1296,1588,-292,C26,4,Resign,Black
TRUE,70,30+0,1697,1566,131,C24,4,Resign,Black
FALSE,38,5+5,1662,1586,76,D06,4,Out of Time,Black
FALSE,43,5+5,1586,1662,-76,B00,4,Resign,White
TRUE,3,6+8,1362,1265,97,B01,2,Out of Time,White
TRUE,3,6+8,1362,1265,97,B01,2,Out of Time,White
FALSE,50,19+30,1265,1500,-235,D01,4,Mate,Black
FALSE,30,19+30,1500,1265,235,C47,7,Mate,Black
FALSE,50,19+30,1265,1500,-235,A00,1,Mate,Black
TRUE,10,8+0,1099,1574,-475,B01,2,Out of Time,Black
TRUE,21,8+4,1459,1143,316,C42,6,Mate,White
TRUE,20,8+4,1175,1455,-280,A00,1,Mate,Black
TRUE,43,8+8,1466,1500,-34,A40,2,Mate,White
TRUE,29,5+8,1773,1366,407,C21,3,Resign,White
TRUE,34,12+0,1385,1246,139,A40,2,Mate,Black
TRUE,40,12+20,1300,1374,-74,C20,3,Mate,Black
TRUE,63,15+0,1320,1391,-71,A00,1,Out of Time,White
TRUE,41,15+5,1293,1411,-118,C41,4,Resign,White
TRUE,19,10+8,1230,1402,-172,C46,5,Resign,Black
TRUE,65,45+0,1611,1410,201,C41,4,Resign,White
TRUE,93,10+20,1321,1430,-109,C60,5,Resign,White
TRUE,78,9+9,1292,1419,-127,A00,1,Resign,Black
TRUE,38,25+0,1205,1412,-207,D03,6,Mate,Black
TRUE,32,15+2,1306,1400,-94,C57,8,Mate,Black
TRUE,56,10+6,1257,1389,-132,C20,3,Mate,Black
TRUE,34,15+0,1188,1381,-193,D02,4,Mate,Black
TRUE,101,29+30,1399,1399,0,D06,4,Resign,White
TRUE,74,10+15,1279,1386,-107,C20,3,Out of Time,Black
TRUE,62,8+8,1485,1362,123,C44,5,Resign,Black
TRUE,60,10+0,1387,1246,141,D05,7,Resign,Black
TRUE,19,15+9,1373,1286,87,D02,4,Resign,White
TRUE,24,15+5,1348,1353,-5,A00,1,Mate,Black
TRUE,66,5+8,1374,1377,-3,A40,2,Mate,Black
TRUE,53,5+8,1347,1455,-108,A41,2,Mate,White
TRUE,29,8+8,1324,1311,13,D02,5,Mate,White
TRUE,93,5+5,1461,1500,-39,C30,4,Mate,White
TRUE,20,8+10,981,1318,-337,C57,11,Mate,Black
TRUE,35,8+8,1224,1298,-74,A03,2,Resign,Black
TRUE,41,10+1,1426,1317,109,D00,2,Mate,White
TRUE,69,20+0,1479,1334,145,C50,8,Resign,White
TRUE,61,12+8,1309,1253,56,D05,6,Mate,White
TRUE,30,1+30,1333,1423,-90,D00,3,Resign,Black
TRUE,35,10+0,1331,1371,-40,C44,4,Resign,White
TRUE,41,3+10,1464,1403,61,C20,3,Out of Time,White
TRUE,60,10+0,1564,1430,134,C50,9,Resign,White
TRUE,30,120+1,886,1426,-540,C25,4,Resign,Black
TRUE,62,8+0,1486,1391,95,A46,5,Out of Time,Black
TRUE,67,15+5,1543,1539,4,C25,5,Mate,White
TRUE,44,2+15,1490,1472,18,D02,4,Out of Time,Black
TRUE,41,15+5,1590,1539,51,C24,4,Resign,White
TRUE,50,5+5,1438,1497,-59,B06,2,Mate,Black
TRUE,74,5+5,1457,1164,293,C34,6,Mate,Black
TRUE,94,5+8,1468,1484,-16,C57,8,Resign,Black
TRUE,66,10+0,1499,1478,21,B30,4,Resign,White
TRUE,34,5+5,1407,1468,-61,B32,7,Resign,Black
TRUE,9,5+5,1392,1483,-91,A42,5,Resign,White
FALSE,40,180+5,1366,1483,-117,A42,5,Resign,White
FALSE,55,180+5,1366,1483,-117,B21,3,Resign,White
TRUE,23,10+2,1474,1365,109,C00,3,Resign,White
TRUE,88,15+10,1485,1512,-27,A03,2,Resign,Black
FALSE,43,10+0,1184,1485,-301,A00,1,Out of Time,White
TRUE,29,15+10,1495,1565,-70,B54,6,Resign,Black
FALSE,29,10+10,1495,1257,238,C30,4,Resign,White
FALSE,52,12+5,1366,1495,-129,B23,3,Mate,Black
TRUE,57,5+5,1476,1740,-264,B53,7,Resign,White
TRUE,57,8+0,1399,1491,-92,A35,4,Resign,White
TRUE,24,7+8,1464,1479,-15,B21,3,Resign,Black
FALSE,4,5+8,1500,1479,21,A00,1,Resign,White
FALSE,66,10+0,1479,1810,-331,B32,6,Resign,Black
FALSE,66,10+0,1479,1810,-331,B20,3,Resign,Black
TRUE,99,11+10,1462,1605,-143,C31,5,Resign,White
TRUE,35,5+15,1450,1432,18,C00,3,Mate,White
TRUE,54,8+0,1437,1632,-195,C37,6,Resign,Black
TRUE,49,12+7,1444,1642,-198,B20,3,Resign,Black
TRUE,37,10+0,1795,1700,95,C42,9,Mate,White
TRUE,81,10+0,1776,1829,-53,C62,6,Resign,White
TRUE,63,10+2,1813,1792,21,B50,5,Resign,White
TRUE,52,4+8,1992,1801,191,B90,11,Resign,White
TRUE,52,5+8,1858,1779,79,B21,3,Resign,Black
TRUE,64,25+25,1784,2085,-301,E73,12,Resign,Black
TRUE,46,10+0,1797,1931,-134,D11,5,Resign,Black
TRUE,43,9+11,2074,1804,270,B21,3,Resign,White
TRUE,16,8+0,1887,1777,110,A00,1,Mate,Black
TRUE,69,8+0,1747,1902,-155,B12,3,Resign,White
TRUE,79,6+10,1424,1500,-76,B00,3,Resign,White
TRUE,47,20+10,1568,1561,7,C40,4,Mate,White
TRUE,40,20+10,1576,1687,-111,C55,6,Out of Time,Black
TRUE,58,20+10,1582,1773,-191,B00,2,Mate,Black
TRUE,106,20+10,1581,1667,-86,C55,6,Out of Time,Black
TRUE,74,20+10,1590,1697,-107,C50,7,Mate,Black
TRUE,49,20+10,1578,1569,9,C57,10,Resign,White
TRUE,40,20+10,1583,1820,-237,C55,6,Resign,Black
TRUE,44,20+10,1601,1423,178,C42,5,Resign,Black
TRUE,39,20+10,1599,1484,115,C40,4,Resign,White
TRUE,113,20+10,1597,1134,463,C50,8,Resign,White
TRUE,67,20+10,1591,1392,199,C55,7,Resign,White
TRUE,74,20+10,1613,1257,356,C50,9,Mate,Black
TRUE,62,20+10,1628,1276,352,C50,7,Mate,Black
TRUE,31,20+10,1622,1430,192,B00,5,Mate,White
TRUE,87,20+10,1616,1459,157,B30,5,Mate,White
TRUE,109,20+10,1606,1537,69,A45,5,Mate,White
TRUE,136,20+10,1623,1473,150,C50,6,Mate,Black
TRUE,55,20+10,1612,1582,30,B12,3,Out of Time,White
TRUE,131,20+10,1613,1406,207,C55,6,Draw,Draw
TRUE,65,20+10,1602,1572,30,C41,5,Out of Time,White
TRUE,97,20+10,1593,1509,84,B01,2,Resign,White
TRUE,10,20+10,1583,1554,29,C42,5,Resign,White
TRUE,55,20+10,1573,1496,77,C50,9,Mate,White
TRUE,49,20+10,1585,1591,-6,B07,4,Resign,Black
TRUE,65,20+10,1582,1260,322,C50,8,Mate,White
TRUE,29,20+10,1578,1277,301,B00,2,Mate,White
TRUE,56,20+10,1580,2002,-422,B12,5,Mate,Black
TRUE,65,20+10,1573,1500,73,B90,11,Resign,White
TRUE,124,20+10,1564,1461,103,C55,6,Resign,White
TRUE,100,20+10,1557,1500,57,C46,7,Resign,White
TRUE,70,20+10,1566,1643,-77,C50,6,Resign,Black
TRUE,55,20+5,1595,1483,112,B02,2,Resign,Black
TRUE,33,20+5,1591,1338,253,C42,5,Resign,White
TRUE,110,20+5,1606,1498,108,B08,8,Mate,Black
TRUE,55,20+5,1602,1343,259,C50,6,Resign,White
TRUE,44,20+5,1600,1175,425,C02,7,Resign,White
TRUE,72,20+5,1616,1467,149,C00,4,Mate,Black
TRUE,67,20+5,1605,1575,30,C50,9,Resign,White
TRUE,47,20+5,1598,1451,147,B29,5,Resign,White
TRUE,21,20+5,1592,1401,191,B40,6,Resign,White
TRUE,19,20+5,1587,1347,240,C41,5,Mate,White
TRUE,63,20+5,1577,1500,77,B30,5,Resign,White
TRUE,37,20+5,1565,1548,17,C55,6,Mate,White
TRUE,30,20+5,1561,1275,286,C50,6,Resign,White
TRUE,82,10+0,1461,1253,208,D06,3,Resign,Black
TRUE,26,10+8,1377,1500,-123,C00,3,Resign,White
FALSE,49,20+0,1327,1364,-37,C46,5,Mate,White
FALSE,36,5+8,1070,1802,-732,B00,2,Mate,Black
TRUE,68,7+7,1097,1171,-74,C00,3,Mate,Black
TRUE,7,8+0,1271,1130,141,C20,3,Mate,White
TRUE,10,12+2,1130,1455,-325,B20,3,Out of Time,Black
TRUE,15,1+12,1568,1307,261,C20,4,Out of Time,White
TRUE,10,11+0,1240,1602,-362,B20,2,Out of Time,Black
TRUE,16,180+180,1240,1422,-182,C20,3,Out of Time,Black
TRUE,18,180+180,1240,1587,-347,C20,3,Out of Time,Black
TRUE,26,180+180,1295,1322,-27,C23,4,Resign,Black
TRUE,17,5+8,1380,1189,191,C21,5,Resign,Black
FALSE,112,15+5,1271,1624,-353,C23,3,Out of Time,Black
FALSE,84,5+5,1500,1749,-249,C43,7,Mate,Black
TRUE,44,12+0,1500,1404,96,B01,2,Resign,Black
FALSE,84,8+0,1838,1774,64,B54,6,Mate,Black
FALSE,19,8+180,1172,1774,-602,D30,9,Resign,White
FALSE,55,180+180,1241,1744,-503,C40,4,Resign,Black
TRUE,73,10+0,1667,1644,23,B21,3,Resign,White
TRUE,39,10+0,1904,1648,256,A46,4,Resign,White
TRUE,48,10+0,1661,1619,42,B32,7,Resign,Black
TRUE,41,10+0,1677,1672,5,D06,4,Resign,White
TRUE,79,10+0,1661,1632,29,B07,3,Resign,White
TRUE,32,10+0,1683,1651,32,B32,7,Resign,Black
TRUE,28,10+0,1652,2159,-507,C49,8,Resign,Black
TRUE,52,10+0,1364,1649,-285,A15,2,Resign,Black
TRUE,48,10+0,1653,1889,-236,B01,6,Resign,Black
TRUE,65,10+0,1674,1657,17,B20,2,Resign,White
TRUE,84,10+0,1664,1810,-146,B01,4,Resign,Black
TRUE,51,20+5,1673,1722,-49,B80,10,Resign,Black
TRUE,18,1+30,1625,1500,125,C00,3,Resign,White
FALSE,3,35+15,1240,1161,79,C40,3,Resign,White
TRUE,25,10+10,1323,1441,-118,A40,3,Resign,Black
TRUE,78,8+0,1500,1496,4,C40,4,Mate,Black
FALSE,20,8+4,1349,1500,-151,C40,4,Resign,Black
TRUE,61,5+8,1066,1174,-108,C68,7,Mate,White
TRUE,21,10+0,1262,1236,26,C46,7,Mate,White
TRUE,47,10+5,1460,1279,181,C26,6,Mate,White
TRUE,80,10+3,1390,1346,44,B93,11,Mate,Black
TRUE,88,10+0,1571,1784,-213,D30,4,Resign,Black
TRUE,59,10+0,1806,1577,229,B08,9,Resign,White
TRUE,35,10+0,1584,1737,-153,D32,10,Resign,Black
TRUE,43,10+0,1597,1583,14,A40,2,Resign,Black
TRUE,37,10+0,2081,1599,482,A00,2,Resign,White
TRUE,101,10+0,1592,1390,202,A40,2,Out of Time,White
TRUE,63,10+0,1828,1598,230,B07,4,Resign,White
TRUE,122,10+0,1648,1596,52,B08,8,Out of Time,Draw
TRUE,78,10+0,1613,1520,93,D11,7,Resign,Black
TRUE,56,10+0,1495,1603,-108,B08,9,Resign,Black
TRUE,73,10+0,1599,1274,325,A41,3,Mate,White
TRUE,111,10+0,1875,1589,286,B07,2,Draw,Draw
TRUE,45,10+0,1636,1601,35,B07,2,Resign,White
TRUE,72,10+0,1657,1584,73,A00,1,Out of Time,Black
TRUE,17,10+0,1576,1373,203,D20,5,Mate,White
TRUE,69,10+0,1593,1549,44,A43,3,Resign,Black
TRUE,82,10+0,1606,1644,-38,D00,3,Resign,Black
TRUE,16,10+0,1678,1586,92,B04,8,Resign,Black
TRUE,93,10+0,1790,1594,196,B02,5,Resign,White
TRUE,54,10+0,1597,2007,-410,D00,4,Resign,Black
TRUE,55,10+0,1581,1566,15,D00,3,Resign,White
TRUE,57,10+0,1495,1500,-5,B01,4,Mate,White
FALSE,77,15+8,1040,1215,-175,C00,2,Resign,White
FALSE,62,30+5,1215,1500,-285,A00,1,Resign,Black
TRUE,56,20+0,1289,1442,-153,C20,3,Mate,Black
TRUE,39,20+0,1434,1500,-66,C50,5,Mate,White
FALSE,15,15+0,1500,1266,234,C57,11,Resign,White
FALSE,53,5+60,1525,1888,-363,C42,5,Resign,White
TRUE,85,20+10,1861,1797,64,A00,1,Mate,White
TRUE,31,17+17,1824,1805,19,C14,13,Resign,White
TRUE,55,15+0,1786,1748,38,C10,5,Mate,White
TRUE,81,20+0,1710,1972,-262,A00,1,Mate,White
TRUE,67,15+5,1650,1695,-45,C28,7,Resign,White
TRUE,37,15+5,1565,1709,-144,C26,5,Mate,White
TRUE,46,10+0,1637,1462,175,D02,5,Out of Time,Black
TRUE,56,10+5,1578,1325,253,C43,6,Mate,Black
TRUE,68,15+5,1326,1480,-154,E00,1,Resign,Black
FALSE,52,10+0,1500,1326,174,B00,2,Resign,White
TRUE,16,8+5,1363,1740,-377,A15,2,Mate,Black
TRUE,75,5+8,1500,1615,-115,B32,6,Mate,White
FALSE,48,10+0,1270,1372,-102,A40,2,Mate,Black
FALSE,68,10+0,1328,1372,-44,C01,4,Mate,Black
FALSE,130,18+0,1372,1293,79,A13,2,Resign,Black
FALSE,94,8+0,1336,1372,-36,A00,1,Resign,Black
FALSE,46,6+3,826,1372,-546,B30,5,Resign,Black
FALSE,34,5+8,1500,1372,128,A00,1,Mate,Black
FALSE,46,5+8,1372,1500,-128,A11,2,Resign,Black
FALSE,67,5+8,1500,1372,128,B22,3,Mate,White
FALSE,59,10+1,1500,1372,128,E70,7,Resign,White
FALSE,56,10+1,1372,1500,-128,C00,3,Mate,Black
FALSE,106,10+0,1372,1500,-128,A15,2,Resign,Black
FALSE,103,10+0,1500,1372,128,B34,9,Resign,White
FALSE,75,3+8,1372,2093,-721,A11,2,Resign,White
FALSE,75,15+0,1500,1372,128,A04,2,Resign,White
FALSE,34,10+0,1372,1500,-128,C00,3,Resign,Black
FALSE,54,10+0,1372,1500,-128,A13,2,Resign,Black
FALSE,93,5+8,1372,1500,-128,A21,4,Draw,Draw
FALSE,109,10+0,1500,1372,128,D32,10,Resign,White
TRUE,57,5+8,1710,1376,334,B21,3,Mate,White
TRUE,55,14+0,1708,1851,-143,B32,7,Resign,White
TRUE,53,5+5,1245,1336,-91,B30,4,Resign,Black
TRUE,48,15+0,1599,2051,-452,C01,5,Resign,White
TRUE,52,15+0,1446,1556,-110,B20,3,Mate,Black
TRUE,92,10+2,1418,1589,-171,B20,3,Draw,Draw
TRUE,105,15+0,1512,1465,47,C46,5,Out of Time,White
TRUE,55,15+0,1470,1195,275,A00,1,Mate,White
TRUE,38,20+10,1559,1641,-82,B10,4,Resign,White
TRUE,41,10+8,1771,1500,271,B32,8,Draw,Draw
TRUE,75,11+11,1420,1483,-63,C41,4,Mate,White
TRUE,113,180+180,1421,1315,106,C20,3,Mate,White
TRUE,4,180+180,1240,1240,0,C20,3,Resign,White
TRUE,36,15+10,2078,1960,118,C11,6,Resign,White
TRUE,36,15+10,1969,2023,-54,B40,7,Resign,Black
TRUE,27,15+10,1936,1980,-44,C15,6,Resign,White
TRUE,27,10+10,1757,1866,-109,B20,3,Resign,Black
TRUE,37,15+10,1675,1500,175,A45,3,Resign,Black
TRUE,49,10+0,1887,1500,387,A40,4,Mate,White
TRUE,16,15+0,1371,1575,-204,A00,1,Mate,Black
TRUE,57,15+0,1314,1398,-84,A50,4,Mate,White
TRUE,107,15+0,1628,1408,220,A00,5,Mate,White
TRUE,121,15+0,1514,1425,89,C55,8,Resign,White
TRUE,18,15+0,1446,1505,-59,C50,6,Mate,Black
TRUE,90,15+0,1448,1418,30,D31,6,Resign,Black
TRUE,49,15+0,1377,1451,-74,D00,3,Mate,White
TRUE,61,15+0,1424,1396,28,C40,4,Mate,White
TRUE,66,15+0,1434,1737,-303,C00,4,Resign,Black
TRUE,41,15+0,1407,1500,-93,C00,3,Resign,White
TRUE,42,15+0,1446,1364,82,C65,6,Mate,Black
TRUE,21,15+0,1398,1436,-38,C21,5,Resign,Black
TRUE,33,15+0,1418,1443,-25,C46,6,Mate,White
TRUE,51,15+0,1443,1499,-56,C24,4,Mate,White
TRUE,56,15+0,1288,1470,-182,D06,4,Mate,Black
TRUE,37,15+0,1431,1295,136,C42,5,Mate,White
TRUE,35,15+0,1358,1367,-9,A40,2,Resign,White
TRUE,86,15+0,1289,1260,29,C26,5,Mate,Black
FALSE,33,15+0,1245,1260,-15,A00,1,Resign,White
FALSE,41,15+0,1260,1245,15,C40,4,Mate,White
FALSE,30,15+0,1260,1565,-305,C02,11,Resign,Black
FALSE,20,15+0,1714,1260,454,C57,10,Out of Time,Black
FALSE,114,15+0,1222,1260,-38,A10,2,Mate,Black
FALSE,36,15+0,1260,1222,38,C41,5,Mate,Black
FALSE,20,15+0,1260,1222,38,C20,3,Mate,Black
FALSE,47,15+0,1260,1392,-132,B00,2,Out of Time,White
FALSE,66,15+0,1392,1260,132,A00,1,Mate,Black
FALSE,49,15+0,1500,1260,240,C64,7,Mate,White
TRUE,34,15+0,1279,1716,-437,D01,4,Mate,Black
FALSE,63,15+8,1279,1488,-209,C20,3,Resign,White
FALSE,95,15+0,1461,1279,182,C44,4,Mate,White
TRUE,40,10+0,1336,1563,-227,C21,5,Out of Time,Black
TRUE,54,15+11,1347,1938,-591,C20,3,Mate,Black
TRUE,32,15+0,1500,1549,-49,C00,3,Out of Time,Black
FALSE,54,15+0,1500,1591,-91,C41,4,Out of Time,Black
FALSE,74,15+0,1591,1500,91,A20,2,Mate,Black
FALSE,79,15+0,1591,1500,91,A20,2,Mate,White
FALSE,107,15+0,1591,1500,91,A20,2,Out of Time,White
FALSE,35,10+0,1331,1500,-169,D00,6,Mate,White
FALSE,64,150+60,1492,1500,-8,B20,3,Mate,Black
FALSE,40,18+18,1512,1500,12,B22,3,Resign,Black
FALSE,2,18+18,1500,1500,0,B20,2,Out of Time,Black
FALSE,36,5+8,1400,1500,-100,C22,6,Resign,Black
FALSE,46,5+8,1500,1696,-196,A00,1,Mate,Black
TRUE,60,20+1,1250,1208,42,A00,1,Resign,Black
TRUE,12,6+5,1213,1599,-386,C22,6,Resign,Black
TRUE,15,10+5,1626,1217,409,C44,5,Resign,White
TRUE,17,20+0,1700,1220,480,C67,8,Resign,White
TRUE,87,16+8,1937,1221,716,C44,5,Resign,White
TRUE,29,7+8,1596,1229,367,C55,7,Resign,White
TRUE,25,10+0,1508,1237,271,B01,4,Resign,White
TRUE,27,16+0,1393,1251,142,C50,5,Resign,White
TRUE,41,5+10,1512,1261,251,C23,3,Resign,White
TRUE,33,18+10,1266,1669,-403,C20,3,Resign,Black
TRUE,59,5+8,1426,1282,144,C20,3,Out of Time,White
TRUE,23,8+0,1625,1289,336,C21,3,Mate,White
TRUE,17,15+1,1502,1302,200,C60,6,Mate,White
TRUE,46,15+0,1330,1340,-10,C16,7,Mate,Black
TRUE,26,5+8,1350,1765,-415,B07,4,Resign,Black
TRUE,76,5+10,1640,1290,350,C20,3,Mate,Black
TRUE,87,20+4,1443,1313,130,C20,3,Resign,White
TRUE,89,15+0,1847,1287,560,B01,4,Resign,White
TRUE,43,8+1,1636,1298,338,C40,4,Resign,White
FALSE,61,10+2,1500,1298,202,D02,3,Resign,Black
FALSE,33,5+5,1323,1318,5,D00,3,Mate,White
TRUE,29,5+8,1457,1327,130,C20,3,Resign,White
TRUE,50,20+0,1289,1275,14,A00,1,Resign,Black
TRUE,39,9+0,1189,1410,-221,B10,2,Mate,White
FALSE,96,20+15,1189,1366,-177,C23,3,Resign,Black
FALSE,86,150+3,1367,1208,159,A00,1,Resign,Black
FALSE,30,5+8,1367,1208,159,A00,1,Out of Time,Black
TRUE,25,12+0,1505,1229,276,B00,2,Mate,White
TRUE,15,180+8,1161,1244,-83,A04,2,Resign,White
FALSE,20,8+0,1161,1465,-304,C20,3,Resign,Black
TRUE,21,30+5,2022,1162,860,C30,3,Mate,White
TRUE,17,15+5,1465,1189,276,B00,1,Resign,White
TRUE,45,1+13,1292,1422,-130,A01,2,Mate,White
TRUE,71,15+0,2054,1977,77,B32,8,Mate,White
TRUE,81,15+0,1696,2054,-358,D11,7,Resign,White
TRUE,68,15+0,2054,1626,428,C22,6,Resign,Black
TRUE,2,0+16,2073,2257,-184,B01,2,Out of Time,Black
TRUE,4,0+16,2104,2081,23,A03,3,Out of Time,Black
TRUE,2,0+16,2159,1500,659,B01,2,Out of Time,Black
TRUE,2,0+16,1816,2230,-414,B01,2,Out of Time,Black
TRUE,37,0+16,2098,2279,-181,A06,3,Resign,White
TRUE,39,0+16,2002,2302,-300,C00,3,Draw,Draw
TRUE,23,0+16,2276,2111,165,C46,5,Mate,White
TRUE,33,0+16,1500,2352,-852,A00,1,Resign,White
TRUE,2,0+16,1425,2346,-921,A01,2,Out of Time,Black
TRUE,2,0+16,1836,2340,-504,D00,2,Out of Time,Black
TRUE,2,0+16,1921,2322,-401,D00,2,Out of Time,Black
TRUE,2,0+16,1491,2318,-827,A01,2,Out of Time,Black
TRUE,90,8+0,1305,2318,-1013,D11,7,Mate,Black
TRUE,2,0+16,1654,2314,-660,B01,2,Out of Time,Black
TRUE,2,0+16,1500,2314,-814,A01,2,Out of Time,Black
TRUE,2,0+16,1513,2312,-799,B01,2,Out of Time,Black
TRUE,27,6+3,1591,1348,243,C23,3,Out of Time,White
TRUE,19,10+0,1531,1354,177,C23,3,Resign,White
TRUE,23,10+0,1337,1567,-230,C60,5,Resign,White
TRUE,53,10+0,1349,1308,41,B23,3,Resign,Black
TRUE,28,10+0,1354,1337,17,C50,8,Out of Time,Black
TRUE,14,10+0,1345,1471,-126,B25,4,Resign,Black
TRUE,26,10+0,1352,1503,-151,B23,3,Resign,Black
TRUE,45,12+5,1336,1364,-28,C50,6,Resign,White
TRUE,39,15+5,1527,1371,156,C64,6,Resign,White
TRUE,35,6+5,1572,1376,196,D02,5,Out of Time,White
TRUE,34,6+5,1382,1567,-185,B00,3,Mate,Black
TRUE,34,15+0,1372,1395,-23,C65,8,Resign,White
TRUE,61,10+0,1412,1406,6,C58,11,Out of Time,White
TRUE,26,10+3,1414,1557,-143,B03,7,Resign,Black
TRUE,41,10+5,1398,1515,-117,B00,5,Resign,White
TRUE,18,6+7,1415,1437,-22,C00,2,Resign,Black
TRUE,46,20+0,1421,1630,-209,C77,9,Mate,Black
TRUE,75,20+0,1624,1427,197,C23,3,Mate,White
TRUE,48,10+0,1439,1422,17,C41,4,Resign,Black
TRUE,14,10+0,1454,1427,27,A01,5,Resign,Black
TRUE,33,10+0,1413,1441,-28,B07,2,Mate,White
TRUE,42,10+0,1444,1400,44,C44,5,Mate,Black
TRUE,37,10+0,1518,1408,110,C50,6,Resign,White
TRUE,101,10+0,1394,1442,-48,C60,5,Mate,White
TRUE,51,10+0,1380,1418,-38,B00,2,Mate,White
TRUE,22,10+5,1500,1369,131,C50,8,Mate,Black
TRUE,45,30+0,1770,1372,398,A51,4,Mate,White
TRUE,42,15+30,1374,1848,-474,B12,5,Resign,Black
TRUE,35,5+5,1457,1384,73,D04,6,Out of Time,White
TRUE,42,5+5,1480,1368,112,B00,5,Mate,Black
TRUE,31,15+4,1313,1370,-57,C64,6,Draw,Draw
TRUE,47,15+4,1359,1323,36,C41,4,Resign,White
TRUE,28,5+5,1361,1755,-394,C51,10,Out of Time,Black
TRUE,39,5+5,1752,1363,389,C50,8,Mate,White
TRUE,54,10+5,1373,1464,-91,B23,3,Resign,Black
TRUE,86,10+0,1373,2007,-634,C46,7,Resign,Black
TRUE,62,10+0,1197,1379,-182,C50,6,Draw,Draw
TRUE,20,30+0,1382,1748,-366,B18,8,Out of Time,Black
TRUE,136,30+2,1778,1360,418,A52,7,Resign,Black
TRUE,55,7+3,1547,1366,181,C50,8,Resign,White
TRUE,38,5+5,1279,1408,-129,C48,7,Resign,White
TRUE,34,10+0,1599,1473,126,C55,6,Mate,Black
TRUE,33,8+0,1497,1500,-3,C00,2,Resign,White
TRUE,105,10+0,1631,1563,68,C50,7,Resign,White
FALSE,56,20+8,1500,1563,-63,D00,3,Mate,Black
FALSE,29,20+8,1563,1500,63,C44,4,Resign,White
FALSE,42,7+8,1500,1563,-63,C23,3,Out of Time,Black
FALSE,49,9+0,1952,1563,389,C60,5,Mate,White
FALSE,23,0+15,1352,1298,54,C46,6,Resign,White
FALSE,26,5+8,1421,1563,-142,C21,3,Resign,Black
FALSE,71,3+8,1485,1352,133,C45,7,Mate,White
FALSE,113,20+0,1563,1445,118,C46,7,Out of Time,White
FALSE,62,5+7,1223,1563,-340,C20,3,Out of Time,Black
FALSE,84,10+2,1702,1375,327,D20,5,Resign,White
TRUE,102,180+180,1430,1667,-237,A02,2,Draw,Draw
TRUE,63,5+5,1394,1228,166,D06,4,Out of Time,White
TRUE,86,5+15,1511,1500,11,C20,3,Out of Time,Black
TRUE,120,10+0,2016,2000,16,A04,2,Out of Time,Black
TRUE,101,10+0,2006,1960,46,A04,2,Mate,White
TRUE,59,10+0,2043,2017,26,D03,10,Resign,White
TRUE,120,10+0,1600,2015,-415,B06,2,Resign,Black
TRUE,64,10+0,1806,2009,-203,B06,5,Mate,Black
TRUE,79,10+0,2000,1920,80,A04,2,Out of Time,White
TRUE,49,10+0,1999,1487,512,A04,2,Mate,White
TRUE,33,10+0,1988,2010,-22,A04,2,Resign,White
TRUE,32,10+0,1927,1978,-51,B06,4,Resign,Black
TRUE,40,10+0,1958,1967,-9,A00,1,Mate,Black
TRUE,65,10+0,1955,1969,-14,A04,2,Resign,White
TRUE,29,10+0,1970,1853,117,A07,3,Resign,Black
TRUE,152,10+0,1850,1974,-124,A03,2,Draw,Draw
TRUE,130,10+0,1989,1891,98,A04,2,Mate,Black
TRUE,46,10+0,1948,1978,-30,B02,3,Mate,Black
TRUE,84,10+0,1873,1970,-97,C26,6,Mate,Black
TRUE,144,10+0,1987,1797,190,A04,2,Resign,Black
TRUE,58,10+0,1670,1984,-314,B06,4,Mate,Black
TRUE,68,10+0,1880,1975,-95,C42,9,Mate,Black
TRUE,61,10+0,1968,1809,159,A04,2,Mate,White
TRUE,49,10+0,1956,1992,-36,A39,13,Mate,White
TRUE,48,10+0,1951,1718,233,A08,4,Resign,White
TRUE,73,10+0,1942,1845,97,D02,4,Resign,White
TRUE,104,10+0,1853,1933,-80,B08,8,Resign,Black
TRUE,19,10+0,1923,1862,61,A07,3,Resign,White
TRUE,33,10+0,1915,1794,121,A07,3,Resign,White
TRUE,74,10+0,1160,1915,-755,A45,3,Out of Time,Black
TRUE,85,10+0,2098,1920,178,B06,5,Resign,White
TRUE,114,10+0,1846,1910,-64,A45,2,Out of Time,Black
TRUE,13,10+0,1904,1752,152,A08,4,Resign,White
TRUE,59,10+0,1890,1959,-69,A04,2,Resign,White
TRUE,33,10+0,1895,1760,135,A05,4,Resign,White
TRUE,30,10+0,1719,1907,-188,B02,5,Resign,Black
TRUE,30,10+0,1900,1725,175,A13,3,Resign,White
TRUE,69,10+0,1890,1846,44,D02,4,Resign,White
TRUE,110,10+0,1856,1878,-22,B06,5,Out of Time,Black
TRUE,86,10+0,1746,1870,-124,A46,5,Out of Time,Black
TRUE,40,30+10,1121,1355,-234,A20,2,Mate,Black
TRUE,29,15+15,1208,1500,-292,C40,4,Mate,White
TRUE,64,10+0,1383,1226,157,A40,2,Mate,Black
TRUE,57,5+17,1339,1500,-161,C20,3,Mate,White
TRUE,26,15+0,1290,975,315,C21,4,Resign,Black
TRUE,11,15+0,950,1297,-347,A00,1,Draw,Draw
TRUE,21,30+5,1794,951,843,D00,3,Mate,White
TRUE,52,30+5,951,1793,-842,A00,1,Mate,Black
TRUE,16,180+0,1496,954,542,D00,2,Resign,White
TRUE,23,5+8,1488,957,531,C00,3,Resign,White
TRUE,3,10+0,1146,996,150,C00,3,Resign,White
TRUE,50,2+10,992,1318,-326,A01,1,Mate,Black
TRUE,63,15+15,1434,1041,393,C34,6,Resign,White
TRUE,26,5+7,1659,1044,615,C20,4,Resign,White
TRUE,53,5+8,1518,1050,468,C41,5,Mate,White
TRUE,61,6+6,1068,1304,-236,A00,1,Resign,Black
TRUE,19,6+6,1298,1092,206,C42,5,Resign,White
TRUE,68,7+6,1133,1218,-85,A00,1,Resign,Black
TRUE,15,5+25,1216,1191,25,A40,1,Resign,White
TRUE,29,10+0,1777,1197,580,C50,9,Mate,White
TRUE,2,5+8,1500,1246,254,C20,2,Resign,Black
TRUE,12,180+180,895,1164,-269,B01,4,Resign,Black
TRUE,36,13+14,871,1006,-135,C20,3,Resign,Black
TRUE,19,5+5,957,1058,-101,C00,2,Resign,Black
TRUE,57,11+4,1334,880,454,C20,3,Mate,White
TRUE,3,7+2,1392,1914,-522,B20,3,Resign,Black
FALSE,50,10+20,1500,1392,108,A45,2,Mate,Black
FALSE,123,180+180,1392,1500,-108,B01,2,Mate,White
TRUE,68,10+0,1500,1669,-169,D02,4,Mate,Black
TRUE,51,10+5,1761,1515,246,D00,3,Resign,White
TRUE,33,10+5,1499,1268,231,C21,3,Resign,White
TRUE,87,10+5,1491,1367,124,C00,4,Resign,White
TRUE,42,10+5,1502,1736,-234,B21,5,Out of Time,Black
TRUE,83,10+5,1495,1342,153,C21,4,Mate,White
TRUE,45,10+5,1504,1585,-81,C21,9,Out of Time,White
TRUE,47,10+5,1502,1128,374,B00,5,Resign,White
TRUE,34,10+5,1497,1521,-24,B00,2,Mate,Black
TRUE,108,10+5,1504,1606,-102,B21,5,Out of Time,Black
TRUE,70,10+5,1508,1796,-288,C21,5,Resign,Black
TRUE,49,10+5,1496,1507,-11,C21,5,Resign,White
TRUE,68,10+5,1507,1532,-25,C21,3,Resign,Black
TRUE,35,10+5,1488,1698,-210,C21,9,Mate,White
TRUE,61,10+5,1479,1398,81,C21,3,Out of Time,White
TRUE,64,10+5,1475,1165,310,C00,3,Resign,White
TRUE,28,10+5,1469,1273,196,C21,3,Resign,White
TRUE,57,10+5,1448,1748,-300,C21,10,Mate,White
TRUE,90,10+5,1454,1663,-209,C21,10,Mate,Black
TRUE,17,10+5,1440,1480,-40,C21,3,Resign,White
TRUE,84,10+5,1452,1463,-11,B21,12,Mate,Black
TRUE,41,10+5,1420,1420,0,B06,4,Resign,White
TRUE,68,10+5,1432,1454,-22,C21,3,Mate,Black
TRUE,53,10+5,1414,1550,-136,C21,10,Out of Time,White
TRUE,94,10+5,1428,1394,34,B00,5,Resign,Black
TRUE,15,10+5,1421,1236,185,C21,3,Mate,White
TRUE,54,10+5,1426,1929,-503,B12,4,Resign,Black
TRUE,60,10+5,1409,1570,-161,C21,4,Resign,White
TRUE,41,10+5,1406,1035,371,C21,5,Mate,White
TRUE,41,10+5,1401,1111,290,C21,9,Mate,White
TRUE,60,10+5,1398,1293,105,B21,6,Mate,Black
TRUE,23,10+5,1399,1630,-231,C21,5,Resign,Black
TRUE,169,10+5,1379,1563,-184,C21,10,Mate,White
TRUE,44,10+5,1382,1778,-396,C21,5,Resign,Black
TRUE,30,10+5,1387,1623,-236,C21,9,Resign,Black
TRUE,43,10+5,1379,1228,151,C21,3,Resign,White
TRUE,40,10+5,1387,1547,-160,B00,1,Resign,Black
TRUE,46,10+5,1411,1584,-173,B01,2,Mate,Black
TRUE,31,10+5,1393,1483,-90,C21,9,Mate,White
TRUE,118,10+5,1404,1499,-95,C21,5,Out of Time,Black
TRUE,29,10+0,1555,1500,55,A40,2,Out of Time,White
FALSE,35,45+0,1564,1503,61,B01,4,Resign,White
TRUE,93,5+5,1465,1416,49,B00,4,Resign,White
TRUE,92,5+5,1426,1436,-10,A00,2,Resign,Black
TRUE,112,5+5,1473,1414,59,B00,2,Resign,Black
TRUE,74,5+5,1424,1440,-16,A00,2,Mate,Black
TRUE,28,5+5,1486,1412,74,B01,4,Resign,Black
TRUE,39,5+5,1398,1544,-146,A00,1,Resign,White
TRUE,73,5+5,1511,1405,106,B00,2,Mate,White
TRUE,88,5+8,1679,1342,337,B01,4,Resign,Black
TRUE,36,5+5,1462,1500,-38,B01,2,Mate,Black
TRUE,99,15+1,1602,1424,178,B07,3,Out of Time,White
TRUE,138,25+30,1500,1791,-291,C33,6,Out of Time,Black
TRUE,70,7+4,1700,1675,25,D00,4,Resign,Black
TRUE,56,7+4,1711,1652,59,D00,3,Resign,Black
TRUE,64,7+4,1722,1723,-1,D00,3,Resign,Black
TRUE,131,7+4,1734,1710,24,B40,4,Resign,Black
TRUE,81,7+4,1704,1551,153,A45,2,Mate,White
TRUE,54,12+0,1713,1768,-55,A45,2,Resign,Black
TRUE,94,12+0,1701,1758,-57,D00,4,Resign,White
TRUE,46,7+15,1713,1668,45,A45,2,Resign,Black
TRUE,57,7+15,1703,1678,25,A40,2,Resign,White
TRUE,56,7+15,1695,1600,95,A40,2,Resign,White
TRUE,54,7+15,1709,1610,99,A40,2,Mate,Black
TRUE,45,7+15,1700,1620,80,A45,2,Resign,White
TRUE,62,7+15,1629,1691,-62,E00,5,Resign,Black
TRUE,140,7+15,1705,1616,89,A45,2,Mate,Black
TRUE,67,7+15,1781,1715,66,B32,6,Mate,White
TRUE,27,7+15,1724,1771,-47,A45,2,Resign,Black
TRUE,87,7+15,1720,1481,239,A40,2,Mate,White
TRUE,88,7+15,1734,1634,100,D00,4,Resign,Black
TRUE,39,7+15,1719,1856,-137,A40,2,Resign,White
TRUE,77,10+3,1458,1738,-280,D02,3,Resign,White
TRUE,78,10+3,1728,1689,39,A80,2,Resign,White
TRUE,32,10+3,1717,1699,18,D00,3,Resign,White
TRUE,40,10+3,1710,1705,5,B40,5,Resign,Black
TRUE,134,10+3,1705,1710,-5,D00,4,Draw,Draw
TRUE,89,7+5,1446,1725,-279,B40,4,Resign,White
TRUE,78,7+5,1721,1450,271,A40,1,Resign,White
TRUE,83,7+5,1709,1695,14,A45,2,Resign,White
TRUE,60,7+5,1697,1718,-21,D00,3,Resign,White
TRUE,80,7+5,1689,1578,111,A40,2,Resign,White
TRUE,127,7+5,1691,1626,65,D00,3,Draw,Draw
TRUE,43,7+5,1681,1733,-52,A40,1,Resign,White
TRUE,46,7+5,1685,1946,-261,A45,2,Resign,Black
TRUE,89,7+5,1682,1350,332,A40,2,Mate,White
TRUE,90,7+5,1697,1546,151,A40,2,Resign,Black
TRUE,64,7+5,1714,1553,161,A40,2,Resign,Black
TRUE,81,7+5,1699,1809,-110,A80,2,Resign,White
TRUE,55,7+5,1693,1521,172,A40,2,Resign,White
TRUE,99,7+5,1680,1713,-33,D00,3,Resign,White
TRUE,79,7+5,1674,1491,183,A40,2,Mate,White
TRUE,161,5+10,1846,1669,177,D00,3,Draw,Draw
TRUE,48,8+2,1675,1858,-183,A45,2,Resign,Black
TRUE,12,7+5,1551,1667,-116,C55,6,Resign,Black
TRUE,60,7+5,1662,1408,254,A40,2,Resign,White
TRUE,40,7+5,1651,1629,22,D00,3,Resign,White
TRUE,107,7+5,1663,1300,363,D00,3,Draw,Draw
TRUE,101,7+5,1655,1518,137,D00,3,Mate,White
TRUE,51,5+5,1381,1583,-202,B00,3,Mate,White
TRUE,144,7+2,1749,1716,33,C50,8,Resign,Black
TRUE,22,7+2,1551,1697,-146,C24,4,Resign,Black
TRUE,49,7+2,1685,1390,295,B07,4,Resign,White
TRUE,37,7+2,1735,1500,235,C00,3,Mate,White
TRUE,116,7+2,1766,1826,-60,D31,6,Mate,Black
TRUE,30,7+2,1425,1754,-329,B00,2,Resign,Black
TRUE,57,7+2,1799,1500,299,B00,2,Resign,Black
TRUE,65,7+2,1760,1711,49,C41,4,Resign,White
TRUE,20,7+2,1723,1706,17,C02,8,Resign,Black
TRUE,57,7+2,1710,1777,-67,B20,3,Resign,White
TRUE,67,7+2,1750,1500,250,A40,2,Resign,White
TRUE,31,5+8,1383,1500,-117,B01,4,Resign,White
TRUE,52,10+0,1277,1342,-65,A03,2,Mate,Black
FALSE,47,20+60,1342,1299,43,D02,3,Resign,White
FALSE,47,10+5,1357,904,453,C00,3,Resign,Black
TRUE,11,10+0,1341,1259,82,D00,2,Resign,White
FALSE,102,10+5,1280,1341,-61,D02,3,Mate,Black
TRUE,49,12+8,1336,1099,237,D02,3,Resign,White
FALSE,27,15+15,1336,1190,146,A40,2,Mate,White
FALSE,38,10+5,1336,1259,77,D02,4,Resign,Black
FALSE,10,5+8,944,1336,-392,A00,1,Resign,Black
FALSE,59,5+8,1336,944,392,D02,3,Resign,White
FALSE,54,10+5,1336,1217,119,D02,4,Resign,White
FALSE,51,10+5,1336,1273,63,A41,4,Resign,White
FALSE,47,10+5,1202,1336,-134,B01,4,Mate,White
FALSE,50,8+9,1500,1354,146,A25,4,Resign,White
FALSE,10,10+5,1354,1680,-326,D00,2,Resign,Black
FALSE,97,10+4,1404,1354,50,C21,4,Resign,White
FALSE,70,10+8,1354,1181,173,C42,5,Mate,Black
FALSE,41,10+8,1354,1289,65,D02,3,Mate,White
TRUE,38,30+5,1140,1637,-497,A04,2,Mate,Black
TRUE,32,5+8,1140,1498,-358,A04,2,Out of Time,Black
TRUE,24,15+10,1464,1106,358,B00,2,Out of Time,Black
TRUE,12,15+12,1084,1099,-15,A00,1,Resign,Black
TRUE,32,10+10,1362,1094,268,B30,4,Resign,White
TRUE,6,15+0,1101,1478,-377,A00,1,Out of Time,Black
TRUE,25,10+0,1070,1265,-195,A00,1,Resign,White
TRUE,29,10+0,1257,1091,166,C40,4,Mate,White
TRUE,15,10+0,1116,1247,-131,B10,2,Resign,Black
TRUE,3,10+0,1236,1150,86,B00,1,Resign,White
TRUE,29,9+0,1535,1160,375,A06,3,Resign,White
TRUE,12,10+8,1185,1390,-205,A00,1,Mate,Black
TRUE,9,10+8,1099,1290,-191,A00,1,Resign,White
TRUE,6,10+8,1139,1283,-144,A00,1,Mate,Black
TRUE,14,14+0,1171,1554,-383,A00,1,Resign,Black
TRUE,16,9+0,1199,1503,-304,A00,1,Mate,Black
TRUE,13,9+0,1498,1238,260,A06,3,Resign,White
TRUE,12,9+0,1304,1493,-189,A02,2,Resign,Black
TRUE,13,9+0,1460,1500,-40,B00,4,Resign,White
TRUE,2,5+5,988,1056,-68,A00,1,Out of Time,Black
TRUE,13,5+5,1041,1500,-459,B00,2,Resign,White
FALSE,3,25+0,1148,1614,-466,B27,3,Resign,Black
TRUE,25,15+5,1149,1796,-647,B07,5,Resign,Black
FALSE,28,25+17,1669,1149,520,C40,5,Resign,White
FALSE,55,25+17,1149,1669,-520,A00,4,Mate,White
FALSE,11,25+17,1669,1149,520,C40,4,Resign,White
FALSE,43,25+17,1149,1669,-520,A00,1,Resign,Black
FALSE,2,25+17,1149,1669,-520,A80,2,Resign,Black
FALSE,46,25+17,1149,1672,-523,D00,6,Mate,Black
FALSE,18,25+17,1672,1149,523,C40,4,Resign,White
FALSE,28,25+17,1149,1672,-523,A00,1,Resign,Black
FALSE,5,25+17,1672,1149,523,C00,3,Resign,White
FALSE,2,25+17,1149,1672,-523,B01,2,Resign,Black
FALSE,14,25+17,1672,1149,523,C48,7,Resign,White
FALSE,17,25+17,1149,1672,-523,D00,6,Resign,Black
FALSE,45,25+17,1672,1149,523,C40,4,Resign,White
FALSE,62,25+17,1149,1672,-523,D10,4,Resign,Black
TRUE,25,30+5,1151,1578,-427,D00,9,Resign,Black
TRUE,47,30+5,1125,1643,-518,C11,7,Resign,White
TRUE,102,5+6,1830,1500,330,C25,4,Out of Time,Black
TRUE,102,180+180,1430,1667,-237,A02,2,Draw,Draw
TRUE,22,180+180,1331,1661,-330,C20,3,Resign,Black
TRUE,92,180+180,1337,1623,-286,C20,3,Resign,Black
TRUE,44,180+180,1500,1545,-45,A00,3,Mate,Black
TRUE,102,180+180,1500,1430,70,A20,2,Mate,Black
TRUE,69,8+0,2235,1500,735,D38,9,Resign,White
TRUE,54,8+0,2022,2226,-204,B06,2,Resign,Black
TRUE,32,8+0,2216,2029,187,C45,8,Resign,White
TRUE,31,8+0,2210,1912,298,B40,4,Resign,White
TRUE,47,8+0,2202,1965,237,C00,3,Resign,White
FALSE,14,5+5,1183,1431,-248,B10,4,Mate,Black
TRUE,51,30+0,1503,1500,3,A40,1,Mate,White
TRUE,44,15+0,1892,2344,-452,C00,4,Resign,Black
TRUE,61,7+10,1028,1500,-472,B00,4,Resign,White
TRUE,56,10+0,1603,2241,-638,C47,7,Out of Time,Black
TRUE,53,10+0,2238,1742,496,A13,6,Out of Time,White
TRUE,96,10+0,1613,2237,-624,A20,2,Resign,Black
TRUE,63,1+30,2235,1652,583,A10,1,Resign,White
TRUE,134,7+2,2263,2136,127,B28,5,Mate,Black
TRUE,46,7+2,1800,2260,-460,C47,9,Resign,Black
TRUE,80,7+2,1737,2257,-520,A00,1,Mate,Black
TRUE,72,8+0,2069,2244,-175,D90,8,Mate,Black
TRUE,65,8+0,2229,2077,152,B83,17,Resign,White
FALSE,28,30+0,1500,1700,-200,A00,1,Mate,Black
TRUE,53,30+0,1694,1495,199,C24,4,Mate,White
TRUE,23,30+0,1408,1690,-282,D30,4,Resign,Black
TRUE,69,30+0,1695,1702,-7,A00,1,Mate,White
TRUE,53,30+0,1709,1442,267,B13,5,Mate,White
TRUE,31,30+0,1675,1722,-47,C45,7,Resign,White
TRUE,53,30+0,1696,1711,-15,C45,7,Resign,Black
TRUE,49,30+0,1707,1404,303,C23,4,Mate,White
TRUE,71,30+0,1697,1660,37,C50,8,Out of Time,White
TRUE,77,30+0,1552,1713,-161,C45,7,Mate,White
TRUE,29,30+0,1703,1679,24,B20,3,Mate,White
TRUE,26,30+0,1657,1693,-36,C22,6,Mate,Black
TRUE,53,30+0,1685,1579,106,B20,3,Resign,White
TRUE,26,30+0,1695,1716,-21,C24,4,Resign,Black
TRUE,112,30+0,1527,1677,-150,C20,4,Resign,Black
TRUE,101,30+0,1670,1522,148,C23,3,Mate,White
TRUE,101,30+0,1665,1684,-19,B20,3,Draw,Draw
TRUE,44,30+0,1650,1574,76,C23,3,Resign,White
TRUE,56,30+0,1666,1661,5,C64,7,Resign,White
TRUE,31,30+0,1773,1670,103,D06,3,Mate,White
TRUE,34,30+0,1687,1657,30,C55,6,Resign,Black
TRUE,116,30+0,1688,1484,204,C50,7,Resign,Black
TRUE,47,30+0,1631,1677,-46,C51,8,Resign,Black
TRUE,35,30+0,1670,1542,128,C23,3,Resign,White
TRUE,73,30+0,1502,1687,-185,D06,4,Resign,White
TRUE,28,30+0,1706,1482,224,B01,2,Mate,Black
TRUE,54,10+0,1837,1426,411,B01,4,Draw,Draw
TRUE,2,180+0,856,1423,-567,D00,2,Resign,Black
TRUE,3,180+0,1420,859,561,C20,3,Resign,White
TRUE,2,180+0,1417,861,556,A00,1,Resign,White
TRUE,2,180+0,864,1414,-550,A00,1,Resign,Black
TRUE,2,180+0,867,1410,-543,A00,1,Resign,Black
TRUE,3,180+0,1407,871,536,A00,1,Resign,White
TRUE,2,180+0,1403,874,529,A00,1,Resign,White
TRUE,2,180+0,877,1399,-522,A00,1,Resign,Black
TRUE,3,180+180,1395,881,514,A00,1,Resign,White
TRUE,3,180+180,1390,885,505,A00,1,Resign,White
TRUE,3,180+0,1386,889,497,A00,1,Resign,White
TRUE,3,180+180,1381,893,488,A00,1,Resign,White
TRUE,2,180+0,897,1375,-478,B07,2,Resign,Black
TRUE,3,180+180,1369,902,467,A00,1,Resign,White
TRUE,2,180+180,908,1363,-455,A00,1,Resign,Black
TRUE,2,180+180,1356,913,443,A00,1,Resign,White
TRUE,2,180+0,1348,919,429,A00,1,Resign,White
TRUE,2,180+180,926,1340,-414,A00,1,Resign,Black
TRUE,3,180+180,1330,934,396,B07,2,Resign,White
TRUE,2,180+180,943,1319,-376,A00,1,Resign,Black
TRUE,2,180+180,1306,953,353,B07,2,Resign,White
TRUE,2,180+180,1291,965,326,B01,2,Resign,White
TRUE,2,180+180,1271,979,292,B01,2,Resign,White
FALSE,27,0+180,1500,1271,229,C57,11,Resign,White
FALSE,18,0+180,1271,1500,-229,D06,4,Resign,Black
FALSE,34,40+0,1169,1369,-200,C20,2,Mate,Black
TRUE,9,20+0,1393,1195,198,C42,6,Mate,White
TRUE,43,20+0,1387,1228,159,B01,2,Resign,White
TRUE,43,60+5,1195,1386,-191,C20,2,Draw,Draw
FALSE,63,40+0,1195,1369,-174,C21,5,Mate,White
FALSE,95,40+0,1195,1369,-174,C21,3,Mate,White
FALSE,76,5+8,1195,1247,-52,B02,6,Resign,Black
TRUE,40,20+0,1369,1062,307,C41,4,Resign,Black
TRUE,44,60+5,1185,1288,-103,C40,4,Resign,Black
TRUE,55,60+5,1291,1117,174,C40,4,Draw,Draw
FALSE,44,30+0,1152,1117,35,C21,3,Out of Time,Black
TRUE,108,12+2,1121,1458,-337,B06,2,Resign,Black
TRUE,56,10+2,1580,1402,178,C20,3,Mate,Black
FALSE,7,8+5,1023,879,144,C20,3,Resign,White
TRUE,51,15+12,1354,1389,-35,B07,2,Mate,White
TRUE,56,6+8,1404,1407,-3,C20,3,Resign,Black
TRUE,103,10+2,1668,1427,241,D10,4,Mate,White
TRUE,59,8+5,1337,1484,-147,B00,2,Mate,White
TRUE,30,5+5,1411,1262,149,C20,3,Resign,Black
TRUE,69,10+10,1218,1452,-234,C20,3,Resign,White
TRUE,61,10+10,1946,1221,725,A85,5,Resign,White
TRUE,37,18+8,1073,1371,-298,C41,5,Mate,White
TRUE,27,10+10,1208,1445,-237,C20,3,Resign,White
TRUE,61,10+10,1439,1282,157,C41,4,Mate,White
TRUE,41,15+8,1500,1422,78,C02,5,Resign,Black
FALSE,119,5+8,1146,1200,-54,B20,3,Mate,White
TRUE,31,20+0,1992,1816,176,D26,12,Resign,White
TRUE,60,5+10,1628,1810,-182,B23,4,Mate,Black
FALSE,89,4+6,2102,1810,292,C09,10,Resign,White
FALSE,66,4+6,1810,2102,-292,D03,5,Resign,Black
TRUE,64,5+8,1537,1805,-268,A40,2,Resign,Black
FALSE,77,5+5,2101,1805,296,C10,13,Resign,White
FALSE,49,5+5,2101,1805,296,B90,10,Resign,White
FALSE,71,5+5,2101,1805,296,C08,8,Resign,White
TRUE,49,8+2,1784,2121,-337,D05,9,Resign,White
TRUE,78,10+15,1799,1771,28,B22,3,Mate,Black
TRUE,35,5+5,1845,1781,64,C02,11,Resign,White
TRUE,102,7+3,1800,1565,235,D02,4,Mate,Black
FALSE,38,180+45,1500,1133,367,A40,2,Resign,White
TRUE,3,5+8,1252,1168,84,B00,2,Resign,White
FALSE,65,1+45,1392,1168,224,B00,2,Mate,White
TRUE,30,10+45,1213,1392,-179,A00,1,Mate,Black
TRUE,85,10+2,1559,1230,329,A01,1,Resign,White
TRUE,12,10+2,1250,1556,-306,A00,1,Mate,Black
TRUE,19,10+2,1552,1275,277,A45,2,Mate,White
TRUE,37,25+10,1598,1301,297,B07,3,Mate,White
FALSE,83,180+180,1500,1301,199,A00,1,Resign,White
TRUE,11,10+4,1403,1393,10,A00,1,Mate,White
TRUE,31,5+8,1399,1381,18,B20,2,Draw,Draw
TRUE,11,15+0,1693,1500,193,A45,3,Mate,White
TRUE,37,5+8,1255,1142,113,B01,2,Out of Time,White
TRUE,29,10+0,1475,1147,328,D00,2,Resign,White
TRUE,57,20+8,1394,1152,242,D00,3,Resign,White
TRUE,31,15+3,1172,1075,97,B01,2,Resign,Black
TRUE,44,8+0,1196,1172,24,D00,2,Resign,Black
TRUE,94,5+5,1336,1058,278,D20,5,Mate,Black
TRUE,22,20+8,1203,1215,-12,C44,6,Resign,Black
TRUE,42,20+8,1227,1190,37,B01,4,Mate,Black
TRUE,55,8+3,1171,1381,-210,B00,5,Resign,White
TRUE,100,6+4,1378,1159,219,B01,2,Mate,Black
TRUE,9,9+1,1144,1226,-82,B21,3,Out of Time,White
TRUE,34,5+8,1244,1141,103,B01,2,Mate,Black
TRUE,43,5+8,1383,1146,237,B01,4,Mate,White
TRUE,48,10+7,1155,1256,-101,C21,6,Mate,Black
TRUE,2,5+17,1305,1734,-429,B00,2,Resign,Black
TRUE,2,5+17,1730,1327,403,B00,1,Resign,White
TRUE,2,5+17,1358,1726,-368,A00,1,Resign,Black
TRUE,2,5+17,1720,1405,315,A00,1,Resign,White
TRUE,2,5+17,1500,1713,-213,B00,2,Resign,Black
FALSE,10,5+8,1155,1203,-48,A01,2,Resign,White
TRUE,4,10+0,1448,1181,267,A40,1,Resign,White
TRUE,7,10+0,1573,1403,170,B06,2,Out of Time,White
TRUE,3,8+10,1845,1441,404,B00,2,Out of Time,White
TRUE,15,9+0,1585,1441,144,B00,2,Out of Time,White
TRUE,3,8+10,1842,1500,342,B00,2,Out of Time,White
TRUE,28,20+0,1500,1212,288,A00,2,Out of Time,Black
TRUE,5,6+7,1853,1500,353,B00,2,Out of Time,White
FALSE,122,8+0,2005,1900,105,B56,10,Resign,Black
TRUE,66,20+0,1545,1706,-161,B01,5,Out of Time,Black
TRUE,91,10+0,1567,1796,-229,B56,10,Out of Time,White
TRUE,37,11+0,1954,1787,167,B20,5,Resign,Black
TRUE,55,11+0,1796,1669,127,D06,4,Resign,White
TRUE,53,11+0,1774,1690,84,A40,2,Mate,White
TRUE,75,10+0,1743,1738,5,C60,6,Resign,White
TRUE,67,10+0,1735,1759,-24,A03,2,Resign,White
TRUE,65,9+0,1765,1654,111,A01,5,Mate,White
TRUE,2,15+15,1839,1765,74,D00,2,Out of Time,Black
TRUE,39,10+0,1687,1763,-76,B21,3,Out of Time,White
TRUE,87,9+0,1580,1716,-136,A00,1,Mate,White
TRUE,66,6+5,1743,2134,-391,A06,3,Out of Time,Black
TRUE,74,30+0,1617,1500,117,D02,5,Mate,Black
FALSE,109,20+20,1500,1793,-293,D60,12,Resign,White
FALSE,53,5+5,1793,1750,43,D30,4,Resign,White
FALSE,42,5+5,1750,1793,-43,D60,13,Resign,Black
FALSE,31,10+0,1793,850,943,A50,4,Resign,White
FALSE,45,10+0,1793,1254,539,D30,4,Resign,White
TRUE,149,8+0,2131,1924,207,C05,9,Out of Time,White
TRUE,120,8+0,1937,1869,68,C46,5,Out of Time,Black
TRUE,20,180+0,1276,1111,165,B01,2,Resign,White
TRUE,54,12+0,1144,1096,48,A40,2,Mate,Black
FALSE,44,5+8,1091,1096,-5,D04,5,Resign,Black
TRUE,71,20+15,1072,1111,-39,A00,1,Mate,White
TRUE,31,11+4,1271,1119,152,A40,2,Resign,White
TRUE,52,14+0,1129,1208,-79,B01,4,Resign,Black
TRUE,55,20+5,1633,1131,502,A00,1,Resign,White
FALSE,11,15+15,1131,1377,-246,C50,6,Resign,Black
TRUE,46,30+0,1141,1230,-89,B01,3,Resign,Black
TRUE,30,15+0,1151,1248,-97,C20,3,Mate,Black
TRUE,40,10+10,1339,1158,181,A40,2,Resign,White
TRUE,11,5+6,1257,1169,88,C41,5,Mate,White
TRUE,69,30+0,1216,1182,34,A41,2,Mate,White
TRUE,28,20+9,1199,1129,70,C41,5,Mate,Black
TRUE,18,60+0,1028,1220,-192,A40,2,Resign,White
TRUE,33,5+12,1201,1236,-35,A40,2,Mate,White
TRUE,17,10+5,1218,1294,-76,C00,2,Mate,White
TRUE,74,30+0,1202,1201,1,B01,4,Resign,White
TRUE,87,20+10,1507,1207,300,C00,2,Resign,White
TRUE,61,10+0,1517,1212,305,A45,3,Out of Time,White
TRUE,82,25+9,1438,1186,252,B40,4,Mate,Black
TRUE,36,5+10,1698,1155,543,E76,9,Mate,Black
TRUE,39,13+20,1347,1460,-113,A00,1,Resign,White
TRUE,14,10+0,1500,1549,-49,A03,2,Resign,Black
FALSE,46,8+8,1500,1389,111,D00,2,Resign,White
TRUE,36,5+10,1474,1331,143,B01,2,Mate,Black
TRUE,83,5+10,1313,1491,-178,A06,2,Out of Time,White
TRUE,23,10+0,1317,1430,-113,A04,2,Resign,Black
TRUE,86,7+8,1232,1307,-75,B01,2,Mate,Black
TRUE,35,7+8,1296,1241,55,A04,2,Resign,White
TRUE,139,0+15,1370,1226,144,A00,1,Resign,White
TRUE,3,0+15,1325,1249,76,B01,2,Out of Time,White
TRUE,45,15+10,1375,1314,61,B01,4,Resign,White
TRUE,39,8+8,1502,1321,181,A40,2,Mate,White
TRUE,39,15+6,1320,1343,-23,A06,3,Mate,White
TRUE,29,5+8,1418,1330,88,B01,4,Out of Time,White
TRUE,47,5+8,1311,1433,-122,A06,2,Mate,White
TRUE,33,5+6,1505,1319,186,B01,2,Resign,White
TRUE,62,5+8,1299,1304,-5,B01,2,Mate,Black
TRUE,25,10+10,1309,1601,-292,A04,2,Resign,Black
TRUE,52,5+10,1207,1298,-91,B01,2,Resign,Black
TRUE,60,2+10,1211,1258,-47,A06,3,Resign,White
TRUE,31,2+10,1242,1248,-6,B01,2,Mate,White
TRUE,3,2+10,1202,1261,-59,A04,2,Resign,White
TRUE,23,7+8,1299,1169,130,A04,2,Mate,White
TRUE,45,7+8,1153,1322,-169,B01,4,Resign,White
TRUE,47,9+0,1662,1327,335,B01,4,Resign,White
TRUE,39,10+0,1242,1313,-71,A40,2,Resign,Black
TRUE,16,6+5,1334,1294,40,B01,2,Resign,Black
TRUE,78,15+0,986,1289,-303,B01,2,Mate,Black
TRUE,65,5+10,1373,1303,70,B01,4,Resign,White
TRUE,57,5+10,1279,1387,-108,A06,3,Resign,White
TRUE,52,10+0,1376,1263,113,B02,2,Mate,Black
FALSE,65,25+0,1500,1411,89,C41,4,Out of Time,White
TRUE,50,30+0,1500,1732,-232,A00,1,Mate,Black
FALSE,118,1+20,1500,1500,0,C00,3,Mate,Black
FALSE,74,10+0,1500,1500,0,C00,4,Mate,Black
TRUE,67,5+5,2182,2210,-28,C00,3,Resign,White
TRUE,149,5+5,2622,2188,434,B00,3,Resign,White
TRUE,83,5+5,2199,2233,-34,B00,2,Resign,White
TRUE,97,5+5,2239,2198,41,C00,3,Draw,Draw
TRUE,45,5+5,2184,2200,-16,B53,7,Resign,White
TRUE,106,5+5,2183,2257,-74,B00,5,Resign,White
TRUE,53,0+40,1625,1363,262,C40,4,Mate,White
TRUE,59,0+20,1587,1500,87,C20,2,Mate,White
TRUE,68,10+0,1883,2093,-210,C00,4,Mate,Black
FALSE,75,10+0,2064,1947,117,A00,4,Mate,White
FALSE,72,10+0,1713,2054,-341,B01,2,Mate,Black
FALSE,67,10+0,2044,1716,328,D30,4,Mate,White
FALSE,49,10+0,2004,2004,0,A06,3,Resign,White
FALSE,41,10+2,2004,1744,260,B32,7,Mate,White
FALSE,48,15+0,1700,1990,-290,B13,5,Resign,Black
FALSE,50,5+8,1677,1944,-267,B50,6,Resign,Black
FALSE,46,10+5,1613,1927,-314,B21,3,Out of Time,Black
FALSE,85,10+0,1909,1598,311,A00,2,Resign,White
FALSE,23,10+0,1886,1590,296,E50,10,Resign,White
FALSE,41,10+0,1831,1733,98,A13,6,Resign,White
FALSE,47,10+0,1769,1655,114,B07,6,Resign,White
FALSE,71,10+0,1650,1651,-1,A00,5,Mate,White
FALSE,51,10+0,1500,1447,53,A00,1,Resign,White
TRUE,19,7+6,1316,1293,23,C50,5,Resign,White
FALSE,5,10+15,1392,1293,99,C26,5,Resign,White
FALSE,14,10+15,1334,1293,41,D20,5,Resign,White
FALSE,24,10+5,1064,1069,-5,C20,3,Out of Time,Black
TRUE,52,25+4,1705,1324,381,B21,3,Resign,White
TRUE,17,20+0,1498,1500,-2,B02,4,Mate,White
TRUE,72,20+0,1814,2038,-224,A44,6,Mate,Black
TRUE,80,10+0,1809,2058,-249,A83,8,Resign,Black
TRUE,40,10+0,1838,2048,-210,C40,6,Resign,Black
TRUE,32,10+0,2048,1885,163,A03,3,Out of Time,Black
TRUE,58,15+0,1436,2047,-611,D00,2,Resign,Black
TRUE,93,10+5,1441,1392,49,C40,4,Out of Time,White
FALSE,78,7+3,2305,1500,805,B53,7,Draw,Draw
FALSE,19,7+3,2305,1500,805,B22,12,Resign,White
FALSE,122,7+3,1500,2305,-805,B23,3,Mate,Black
FALSE,50,30+30,2475,2305,170,B90,11,Resign,Black
TRUE,129,5+8,1679,1795,-116,A20,2,Resign,White
TRUE,65,5+8,1500,1689,-189,B40,5,Mate,White
TRUE,38,5+8,1263,1521,-258,C20,3,Out of Time,Black
TRUE,32,5+8,1299,1585,-286,C00,2,Out of Time,Black
TRUE,79,10+0,1504,1387,117,C41,5,Mate,White
FALSE,53,5+8,1651,1364,287,C30,3,Mate,White
FALSE,38,5+8,1364,1175,189,B01,2,Out of Time,Black
FALSE,40,5+8,1364,1501,-137,C00,3,Out of Time,Black
FALSE,28,5+8,1364,1078,286,C00,3,Out of Time,Black
FALSE,15,5+8,1336,1500,-164,C23,3,Resign,Black
TRUE,88,6+3,1510,1303,207,B00,2,Resign,White
TRUE,48,3+8,1309,1671,-362,A48,5,Mate,Black
TRUE,39,3+8,1668,1313,355,C20,4,Mate,White
TRUE,54,3+8,1316,1665,-349,B20,2,Resign,Black
TRUE,44,5+5,1271,1463,-192,A40,3,Mate,Black
TRUE,21,5+5,1382,1500,-118,B01,4,Resign,White
TRUE,30,7+8,1234,1288,-54,B00,2,Out of Time,Black
TRUE,43,10+0,1315,1301,14,A40,2,Mate,White
TRUE,50,1+20,1128,1293,-165,A40,2,Resign,Black
TRUE,61,5+8,1338,1306,32,A10,1,Mate,White
TRUE,77,5+5,1323,1395,-72,A00,2,Resign,White
TRUE,35,10+10,1302,982,320,A01,1,Resign,White
TRUE,23,10+0,1464,1310,154,D06,4,Out of Time,White
TRUE,51,7+8,1371,1306,65,A40,2,Resign,Black
TRUE,22,10+0,1730,1849,-119,B01,4,Resign,White
TRUE,93,10+0,1858,1939,-81,E11,8,Resign,Black
TRUE,63,10+0,1850,1870,-20,A04,2,Resign,White
TRUE,117,18+18,1867,1524,343,B00,2,Mate,White
TRUE,35,25+0,1410,1561,-151,A10,2,Resign,White
TRUE,47,17+0,1670,1575,95,A03,2,Resign,White
TRUE,30,5+5,1325,1457,-132,C46,6,Resign,White
TRUE,46,5+5,1484,1405,79,C26,6,Resign,Black
TRUE,40,5+5,1291,1471,-180,C65,6,Resign,Black
TRUE,156,10+0,1265,1461,-196,B06,2,Mate,Black
TRUE,47,10+0,1455,1298,157,A25,4,Mate,White
TRUE,26,14+9,1316,1635,-319,B06,2,Mate,Black
TRUE,51,5+6,1892,1322,570,D11,6,Mate,White
TRUE,44,10+8,1443,1227,216,D15,7,Mate,Black
TRUE,78,15+10,1795,1234,561,D12,8,Resign,White
TRUE,25,12+12,1484,1273,211,D00,2,Mate,White
TRUE,36,90+0,1295,1675,-380,C46,7,Mate,Black
TRUE,12,90+0,1672,1322,350,C57,7,Resign,White
TRUE,100,5+8,1357,1689,-332,B30,4,Resign,Black
TRUE,19,5+8,1685,1413,272,C57,7,Resign,White
TRUE,37,40+9,1500,1741,-241,C00,3,Resign,Black
TRUE,12,7+3,1386,1500,-114,B00,3,Out of Time,Black
FALSE,126,5+5,2152,2075,77,C50,9,Out of Time,Black
FALSE,49,5+5,2064,1889,175,A08,4,Resign,White
FALSE,134,10+10,1834,2064,-230,D15,8,Resign,White
FALSE,41,10+10,2056,1841,215,A38,10,Resign,White
FALSE,80,10+10,1848,2049,-201,D93,11,Resign,Black
FALSE,40,7+3,1663,2069,-406,C00,3,Resign,Black
FALSE,73,7+3,2066,1665,401,D17,12,Resign,White
FALSE,24,25+0,1616,2064,-448,C42,4,Resign,Black
FALSE,96,25+20,1715,2060,-345,B20,3,Resign,Black
FALSE,91,9+0,2056,1684,372,C60,6,Resign,White
FALSE,102,9+0,1687,2052,-365,C00,3,Resign,Black
FALSE,145,8+0,1800,2079,-279,C00,3,Resign,White
FALSE,102,10+0,2003,2162,-159,A00,2,Resign,White
FALSE,88,10+0,1723,2159,-436,D04,5,Out of Time,Black
FALSE,23,10+0,2158,1477,681,B18,11,Resign,White
FALSE,77,10+0,2158,992,1166,A15,3,Resign,White
FALSE,85,10+0,2156,1640,516,E06,9,Resign,White
FALSE,45,10+0,1554,2155,-601,D20,4,Resign,Black
FALSE,35,10+0,2155,1361,794,A40,2,Mate,White
FALSE,67,10+0,2153,1555,598,D02,4,Resign,White
FALSE,71,10+0,2152,1580,572,A04,2,Resign,White
TRUE,66,5+5,1810,1738,72,B30,4,Resign,Black
TRUE,85,5+5,1724,1824,-100,B32,7,Resign,White
TRUE,107,10+5,1406,1459,-53,C45,7,Draw,Draw
TRUE,41,10+5,1412,1417,-5,D00,3,Mate,White
TRUE,51,10+0,2315,2200,115,B19,14,Resign,White
TRUE,65,10+0,2196,1869,327,E95,15,Resign,White
TRUE,51,12+4,1855,1202,653,C55,7,Mate,White
FALSE,41,180+180,1202,1009,193,A40,1,Resign,Black
TRUE,74,12+2,1386,1255,131,B01,4,Resign,White
TRUE,33,5+8,1830,1263,567,D20,4,Mate,White
TRUE,85,14+6,1781,1274,507,C20,3,Mate,White
FALSE,9,180+150,1100,1500,-400,B00,5,Resign,White
TRUE,15,30+0,1613,1309,304,B01,2,Mate,White
TRUE,32,30+0,1364,1609,-245,D00,3,Mate,Black
FALSE,8,180+120,1261,1174,87,B00,4,Resign,White
TRUE,57,15+0,1589,1500,89,C02,5,Mate,White
TRUE,121,20+1,1238,885,353,A00,1,Mate,White
TRUE,57,5+5,1708,1500,208,B02,5,Mate,White
TRUE,85,15+5,1706,886,820,B04,8,Mate,White
FALSE,27,20+12,788,1307,-519,A04,2,Resign,Black
TRUE,53,8+8,1437,892,545,B00,2,Mate,White
TRUE,21,10+0,955,959,-4,B00,3,Mate,White
TRUE,43,5+5,1411,1500,-89,A50,4,Mate,White
TRUE,27,5+8,1149,1013,136,B06,2,Mate,White
TRUE,51,30+16,1523,1009,514,A00,1,Mate,White
TRUE,26,30+16,1028,1521,-493,A00,1,Mate,Black
TRUE,61,15+0,1366,1090,276,C42,4,Mate,White
FALSE,41,15+7,1500,1005,495,B00,2,Mate,White
TRUE,55,12+8,1130,1500,-370,D00,3,Mate,White
TRUE,66,20+10,1394,1998,-604,D10,5,Resign,Black
TRUE,47,20+10,1998,1358,640,C41,5,Resign,White
TRUE,40,20+10,1276,1997,-721,D10,4,Resign,Black
TRUE,35,20+10,2026,1593,433,C78,12,Resign,Black
TRUE,65,20+10,2015,1877,138,B38,11,Resign,White
TRUE,42,20+10,1527,2013,-486,D00,3,Resign,Black
TRUE,79,20+10,2011,1511,500,B06,4,Resign,White
TRUE,74,20+10,1512,2009,-497,D00,2,Resign,Black
TRUE,66,10+20,2037,1734,303,B34,8,Resign,Black
TRUE,125,30+15,1432,2069,-637,C53,9,Out of Time,White
FALSE,50,5+10,2069,1500,569,C60,6,Resign,Black
FALSE,35,45+45,1144,1500,-356,C42,4,Resign,Black
FALSE,23,10+5,1144,1500,-356,C62,6,Resign,Black
FALSE,52,20+120,1022,1165,-143,C40,4,Mate,Black
TRUE,93,5+5,1781,1516,265,D52,11,Mate,White
TRUE,96,5+5,1601,1688,-87,C01,5,Mate,Black
TRUE,103,5+5,1939,1662,277,D37,8,Mate,White
TRUE,59,5+5,1500,1500,0,C50,6,Resign,White
TRUE,74,10+0,1785,1815,-30,B18,8,Mate,Black
TRUE,53,10+0,1777,1453,324,B00,2,Mate,White
FALSE,165,7+2,1571,1457,114,B35,13,Draw,Draw
FALSE,41,7+2,1571,1487,84,B01,8,Resign,White
TRUE,65,10+0,1620,1658,-38,C30,4,Resign,White
TRUE,55,10+0,1648,1630,18,C20,3,Mate,White
TRUE,79,9+3,1619,1635,-16,B10,2,Mate,White
TRUE,54,9+3,1647,1606,41,E94,13,Resign,Black
TRUE,41,9+3,1617,1637,-20,C30,6,Resign,Black
TRUE,34,9+3,1626,1628,-2,C02,6,Resign,White
FALSE,26,5+5,1869,1500,369,D10,5,Resign,Black
FALSE,19,8+4,1500,1500,0,C40,6,Resign,White
FALSE,33,9+9,1672,1455,217,C62,6,Draw,Draw
FALSE,11,20+0,1561,1718,-157,B02,4,Resign,White
FALSE,49,20+3,1703,1475,228,A06,3,Mate,White
FALSE,18,30+0,1328,1657,-329,B06,4,Resign,Black
FALSE,25,15+10,1636,1417,219,A00,4,Resign,White
FALSE,25,10+5,1500,1681,-181,B07,2,Out of Time,White
TRUE,6,10+8,801,1223,-422,B00,3,Resign,Black
TRUE,34,10+8,1207,804,403,A06,2,Resign,White
TRUE,29,7+3,1403,1389,14,B00,2,Mate,White
TRUE,44,30+8,1500,1662,-162,A00,1,Mate,Black
FALSE,48,180+0,1484,1500,-16,C62,6,Out of Time,Black
FALSE,60,180+0,1500,1484,16,C27,3,Mate,Black
TRUE,67,12+3,2206,2238,-32,C27,6,Resign,White
TRUE,30,8+2,2252,2121,131,B20,5,Resign,Black
TRUE,52,8+0,2259,2386,-127,B20,5,Resign,Black
TRUE,40,5+5,2074,2253,-179,A52,7,Resign,Black
TRUE,41,5+5,2247,2094,153,B20,6,Mate,White
TRUE,77,5+5,2240,2104,136,D35,6,Out of Time,White
TRUE,84,5+5,2111,2233,-122,A45,2,Resign,Black
TRUE,43,5+5,2226,2119,107,C02,8,Resign,White
TRUE,124,5+5,2127,2218,-91,A45,2,Resign,Black
TRUE,62,5+5,2232,2113,119,C00,3,Mate,Black
TRUE,21,5+5,2225,2096,129,C21,10,Resign,White
TRUE,136,5+5,2217,2135,82,C00,3,Resign,White
TRUE,82,30+8,1123,1500,-377,B27,4,Mate,Black
FALSE,8,8+0,1506,1282,224,A40,2,Out of Time,Black
FALSE,3,2+40,1408,1570,-162,D02,3,Draw,Draw
TRUE,83,19+5,1130,1144,-14,A40,2,Mate,White
TRUE,53,5+8,1158,1500,-342,A41,2,Mate,White
TRUE,79,12+0,1658,1444,214,C48,8,Resign,White
TRUE,118,10+0,1669,1850,-181,B25,4,Resign,Black
TRUE,22,11+0,1565,1652,-87,C42,6,Resign,Black
TRUE,51,20+5,1422,1641,-219,A00,1,Resign,Black
TRUE,33,9+0,1620,1565,55,C46,5,Mate,White
TRUE,64,9+8,1846,1576,270,C30,4,Mate,Black
TRUE,58,10+0,1374,1549,-175,C55,6,Mate,Black
TRUE,47,10+0,1527,1422,105,C25,4,Resign,White
TRUE,82,15+5,1448,1500,-52,A84,3,Mate,Black
TRUE,58,17+0,1154,1490,-336,C42,4,Mate,Black
TRUE,50,16+0,1160,1480,-320,C49,12,Mate,Black
TRUE,39,12+0,1433,1515,-82,C00,4,Mate,White
TRUE,23,15+0,1387,1094,293,C46,6,Resign,White
TRUE,52,60+0,1496,1305,191,C20,3,Mate,Black
TRUE,39,180+0,1195,1491,-296,B25,4,Out of Time,White
FALSE,64,30+10,1510,1447,63,B02,4,Resign,Black
FALSE,37,10+3,1433,1436,-3,A00,5,Resign,White
FALSE,30,10+3,1436,1433,3,C55,7,Draw,Draw
FALSE,15,8+8,1502,1430,72,C20,3,Draw,Draw
FALSE,10,15+30,952,1410,-458,C24,4,Resign,Black
FALSE,31,15+30,1408,955,453,C46,7,Resign,White
FALSE,170,10+0,1569,1366,203,C68,7,Mate,Black
FALSE,52,10+0,1366,1269,97,C20,3,Resign,Black
FALSE,112,15+8,1340,1367,-27,C20,3,Out of Time,Black
FALSE,60,5+5,1199,1341,-142,C21,10,Out of Time,Black
FALSE,17,5+5,1176,1398,-222,B00,2,Resign,White
FALSE,3,10+10,1412,1485,-73,B27,3,Resign,Black
FALSE,78,10+10,1281,1380,-99,A40,2,Mate,Black
FALSE,30,15+0,1359,1359,0,A40,2,Resign,Black
FALSE,66,15+0,1383,1347,36,C55,6,Resign,Black
FALSE,56,19+5,1134,1397,-263,C45,7,Draw,Draw
FALSE,107,7+5,1412,1211,201,C01,5,Mate,White
FALSE,104,8+1,1211,1434,-223,A00,1,Mate,Black
FALSE,14,10+0,1434,1352,82,C41,5,Out of Time,Black
FALSE,59,180+180,1410,1337,73,B20,3,Resign,White
FALSE,66,10+8,1443,1425,18,C00,4,Resign,Black
FALSE,32,10+2,1393,1487,-94,C28,6,Resign,White
FALSE,61,10+9,1225,1552,-327,D02,4,Resign,White
FALSE,44,10+5,1061,1602,-541,C68,7,Resign,Black
FALSE,8,5+8,1678,1678,0,A00,1,Resign,White
FALSE,37,8+0,1615,1727,-112,A00,5,Resign,White
FALSE,47,10+0,1728,1571,157,A06,3,Resign,Black
TRUE,53,12+8,1568,1292,276,B07,5,Resign,White
TRUE,29,12+8,1273,1653,-380,C21,3,Resign,White
TRUE,55,10+10,1580,1757,-177,A52,7,Resign,White
TRUE,72,15+10,1711,1622,89,A85,5,Resign,White
TRUE,44,10+0,1631,1540,91,A00,5,Mate,Black
TRUE,57,10+1,1480,1393,87,C02,7,Resign,White
TRUE,68,10+1,1403,1371,32,A00,1,Resign,Black
TRUE,47,15+0,1552,1283,269,B34,9,Draw,Draw
TRUE,63,15+0,1500,1423,77,E20,5,Resign,Black
TRUE,47,5+5,1500,1341,159,D06,4,Resign,White
TRUE,23,18+15,1419,1362,57,B07,4,Resign,White
TRUE,64,180+180,1500,1584,-84,C00,3,Mate,Black
TRUE,37,18+8,1500,1535,-35,A22,4,Mate,White
TRUE,103,15+10,1506,1588,-82,B30,4,Out of Time,White
TRUE,87,15+10,1501,1221,280,B11,4,Mate,White
TRUE,47,10+0,1677,1508,169,C21,9,Mate,White
TRUE,55,5+8,1627,1515,112,C41,6,Resign,White
FALSE,63,9+8,1515,1448,67,B20,2,Resign,White
TRUE,43,15+0,1494,1843,-349,B10,2,Resign,White
TRUE,57,15+0,1690,1501,189,C24,4,Resign,White
TRUE,31,8+8,1784,1505,279,D07,7,Resign,White
TRUE,52,3+12,1363,1706,-343,A03,2,Resign,Black
TRUE,47,3+12,1703,1366,337,A04,4,Resign,White
TRUE,18,13+0,1352,1380,-28,D00,3,Resign,White
TRUE,51,13+0,1395,1338,57,C40,4,Resign,Black
TRUE,80,13+0,1349,1383,-34,D00,3,Resign,Black
TRUE,29,13+0,1399,1335,64,C44,6,Resign,Black
TRUE,27,5+5,1183,1427,-244,C45,7,Resign,Black
TRUE,66,15+0,1405,1632,-227,B12,5,Resign,Black
TRUE,72,10+0,1377,1392,-15,C22,6,Mate,Black
TRUE,8,10+0,1391,1378,13,C22,6,Resign,Black
TRUE,83,10+0,1453,1389,64,A40,2,Resign,White
TRUE,73,10+0,1455,1387,68,D00,2,Draw,Draw
FALSE,103,10+0,1466,1529,-63,D08,4,Out of Time,White
FALSE,26,10+15,1466,1297,169,D02,4,Resign,White
FALSE,62,10+0,1445,1466,-21,B23,4,Mate,Black
FALSE,150,8+8,1500,1466,34,C20,3,Mate,Black
FALSE,4,5+8,1415,1466,-51,D01,4,Resign,Black
FALSE,28,2+15,1500,1466,34,A00,1,Out of Time,Black
FALSE,88,8+4,1466,1533,-67,B54,5,Out of Time,Black
TRUE,97,19+45,1549,1466,83,C07,20,Resign,Black
FALSE,58,8+0,1466,1500,-34,B13,5,Mate,Black
FALSE,39,10+8,1466,1500,-34,A02,1,Mate,White
FALSE,36,10+8,1500,1466,34,D00,2,Resign,Black
TRUE,46,5+5,1500,1500,0,B07,2,Mate,Black
TRUE,101,10+0,1251,1166,85,C41,5,Mate,White
TRUE,62,9+6,1216,1584,-368,B01,4,Mate,Black
TRUE,29,9+6,1580,1257,323,C40,3,Mate,White
FALSE,111,7+2,1068,807,261,C20,3,Mate,White
FALSE,97,10+2,1068,807,261,C20,3,Out of Time,White
FALSE,48,5+9,1076,1373,-297,C01,5,Mate,Black
FALSE,91,20+8,1076,807,269,C21,5,Out of Time,White
FALSE,92,20+8,807,1076,-269,D00,3,Mate,Black
FALSE,25,20+8,1076,807,269,C20,3,Resign,White
FALSE,45,10+0,1011,1076,-65,C20,3,Mate,White
FALSE,101,10+0,1076,1011,65,C20,3,Out of Time,White
TRUE,32,8+0,1500,1383,117,D00,3,Mate,Black
TRUE,17,10+8,1529,1088,441,C00,2,Out of Time,White
TRUE,17,10+10,1671,1094,577,A00,1,Resign,White
TRUE,23,6+6,1444,1118,326,A40,1,Resign,White
TRUE,9,5+8,1121,1831,-710,A00,1,Resign,Black
TRUE,13,10+0,1375,1167,208,B07,2,Resign,White
FALSE,21,5+8,1501,1030,471,C00,3,Resign,White
TRUE,20,10+0,1312,1274,38,A00,1,Resign,White
TRUE,23,5+25,1410,1500,-90,B07,3,Resign,White
TRUE,47,11+2,1198,1571,-373,A40,1,Mate,White
TRUE,3,11+2,1500,1202,298,A00,1,Resign,White
FALSE,31,10+3,1500,1209,291,C67,8,Resign,White
FALSE,15,10+3,1209,1429,-220,C42,5,Resign,Black
TRUE,115,25+0,1527,1212,315,C45,7,Resign,White
TRUE,71,25+0,1188,1597,-409,C02,7,Resign,White
TRUE,37,5+8,1174,1500,-326,C46,7,Mate,White
FALSE,53,6+6,1500,1174,326,C44,6,Resign,Black
FALSE,31,6+10,1174,1500,-326,C41,5,Out of Time,White
FALSE,14,6+10,1500,1174,326,C24,5,Mate,Black
FALSE,95,6+10,1174,1500,-326,A00,1,Resign,White
FALSE,107,20+0,1500,1174,326,C20,4,Mate,White
TRUE,70,30+0,1458,1485,-27,C22,6,Mate,Black
TRUE,76,30+0,1613,1472,141,C50,6,Mate,Black
TRUE,36,8+2,2059,1640,419,B01,4,Resign,White
TRUE,69,10+15,1500,1422,78,C20,3,Resign,White
TRUE,47,7+2,1667,1500,167,E00,5,Mate,White
TRUE,36,10+10,1348,1557,-209,C46,5,Resign,White
TRUE,73,10+10,1550,1500,50,A28,7,Mate,White
TRUE,104,15+5,1588,1533,55,B01,4,Resign,Black
TRUE,21,15+5,1581,1500,81,C41,4,Resign,White
TRUE,12,15+5,1571,1558,13,C41,4,Resign,White
TRUE,35,15+5,1560,1522,38,B32,6,Out of Time,White
TRUE,64,15+5,1571,1597,-26,C02,7,Resign,Black
TRUE,47,15+5,1560,1547,13,C40,4,Resign,White
TRUE,68,15+5,1526,1542,-16,A00,1,Mate,Black
TRUE,100,15+5,1517,1531,-14,D02,4,Resign,Black
TRUE,91,15+5,1520,1521,-1,E61,6,Out of Time,White
TRUE,81,15+5,1511,1418,93,C41,5,Resign,White
TRUE,193,15+5,1501,1447,54,B00,2,Mate,White
TRUE,112,15+5,1519,1306,213,C47,8,Out of Time,Black
TRUE,69,15+5,1513,1350,163,C44,5,Resign,White
TRUE,119,15+5,1501,1499,2,C41,5,Mate,White
TRUE,123,15+5,1486,1568,-82,C45,9,Resign,White
TRUE,26,15+5,1501,1404,97,C46,7,Resign,Black
TRUE,128,15+5,1519,1330,189,C27,3,Mate,Black
TRUE,96,15+5,1536,1399,137,D02,4,Mate,Black
TRUE,29,15+5,1533,1131,402,C26,5,Mate,White
TRUE,135,15+5,1524,1448,76,A00,1,Mate,White
TRUE,47,10+8,1515,1421,94,D06,4,Mate,White
TRUE,23,15+5,1510,1283,227,D20,5,Mate,White
TRUE,77,10+0,1498,1537,-39,D06,4,Mate,White
TRUE,47,5+8,1489,1500,-11,A40,4,Mate,White
TRUE,82,10+0,1361,1481,-120,B20,3,Resign,Black
TRUE,39,25+0,1470,1438,32,E61,6,Resign,White
TRUE,31,20+30,1481,1515,-34,A40,2,Resign,Black
TRUE,53,5+8,1772,1485,287,B40,4,Resign,White
TRUE,46,10+0,1475,1387,88,A40,1,Resign,White
TRUE,50,60+0,1301,1468,-167,D00,3,Mate,Black
TRUE,11,5+8,1213,1489,-276,D00,4,Mate,White
TRUE,32,7+7,1502,1318,184,D08,4,Mate,Black
TRUE,50,11+8,1522,1289,233,A54,6,Resign,Black
TRUE,57,8+5,1352,1541,-189,D00,3,Resign,White
FALSE,27,10+0,1392,1254,138,D15,7,Resign,White
TRUE,57,5+8,1535,1318,217,A40,2,Resign,White
TRUE,89,8+0,1338,1539,-201,B20,2,Mate,White
TRUE,58,10+0,2096,1901,195,B13,5,Out of Time,Black
TRUE,68,10+0,1920,2087,-167,D02,5,Resign,Black
TRUE,54,5+8,2004,2073,-69,C47,8,Mate,Black
TRUE,113,10+0,2084,2066,18,B70,10,Mate,White
TRUE,149,5+5,2074,1908,166,C41,4,Resign,White
TRUE,64,5+5,1788,2067,-279,B02,5,Mate,Black
TRUE,59,5+5,2060,1792,268,B12,7,Resign,White
TRUE,74,2+10,1819,2052,-233,B03,6,Resign,Black
TRUE,47,10+0,2047,1710,337,B05,8,Resign,White
TRUE,117,10+5,2136,2062,74,D02,4,Mate,White
TRUE,30,5+7,2081,2096,-15,B30,4,Out of Time,Black
TRUE,59,25+0,2063,2027,36,B06,4,Out of Time,White
TRUE,117,5+21,2048,1924,124,C44,6,Resign,White
FALSE,31,19+4,1804,1997,-193,C47,9,Resign,White
TRUE,55,10+0,2051,2072,-21,C70,6,Resign,White
TRUE,67,5+21,2057,1923,134,C44,6,Resign,White
TRUE,82,5+21,1922,2040,-118,C50,9,Resign,Black
TRUE,144,30+1,2063,2038,25,C70,8,Draw,Draw
TRUE,53,30+1,2003,2078,-75,C44,5,Resign,White
TRUE,52,5+10,1996,1618,378,C44,5,Resign,White
TRUE,138,6+8,1804,2013,-209,D00,4,Draw,Draw
TRUE,46,10+4,1834,1994,-160,C70,8,Resign,Black
TRUE,85,9+0,1867,1968,-101,C50,11,Resign,Black
TRUE,43,15+10,1653,1711,-58,B06,4,Resign,White
TRUE,85,10+5,1663,1706,-43,C62,6,Resign,Black
TRUE,49,15+5,1692,1674,18,C00,3,Resign,White
TRUE,91,8+10,1709,1685,24,D31,6,Mate,White
TRUE,69,15+0,1631,1698,-67,C00,3,Mate,White
TRUE,87,8+10,1708,1772,-64,A40,4,Resign,Black
TRUE,114,8+10,1724,1545,179,D20,5,Resign,Black
TRUE,56,8+10,1723,1713,10,C00,3,Resign,Black
TRUE,34,15+8,1642,1703,-61,D00,2,Mate,Black
TRUE,49,8+10,1689,1770,-81,D11,5,Mate,White
TRUE,59,10+10,1763,1698,65,A20,2,Resign,White
TRUE,86,17+17,1693,1477,216,C41,5,Resign,White
TRUE,85,8+5,1664,1706,-42,C02,8,Resign,White
TRUE,70,10+5,1500,1701,-201,C00,3,Mate,Black
TRUE,38,8+10,1704,1689,15,D10,4,Mate,Black
TRUE,46,15+15,1680,1677,3,D00,2,Resign,Black
TRUE,51,10+5,1757,1687,70,A01,4,Resign,White
TRUE,74,5+8,1666,1675,-9,D00,3,Resign,Black
TRUE,113,7+5,1663,1667,-4,C55,6,Resign,White
TRUE,13,10+5,1651,1641,10,B21,5,Out of Time,White
TRUE,46,10+5,1654,1638,16,C00,3,Mate,Black
TRUE,29,10+5,1680,1623,57,C01,5,Resign,Black
TRUE,59,15+9,1610,1617,-7,C02,7,Resign,White
TRUE,79,10+15,1754,1618,136,C02,6,Resign,White
TRUE,78,10+15,1713,1602,111,C00,2,Mate,Black
TRUE,36,15+10,1795,1581,214,C00,3,Mate,Black
TRUE,39,10+5,1658,1565,93,C01,5,Resign,Black
TRUE,79,15+10,1721,1573,148,D32,9,Resign,White
TRUE,73,15+15,1557,1614,-57,C38,9,Resign,White
TRUE,34,15+10,1423,1500,-77,C45,8,Resign,Black
TRUE,66,10+10,1566,1694,-128,C55,6,Resign,Black
FALSE,22,25+0,1432,1493,-61,C68,7,Mate,Black
TRUE,39,15+1,1656,1577,79,D00,2,Resign,White
TRUE,25,10+10,1557,1713,-156,B01,6,Resign,White
TRUE,51,7+8,1686,1567,119,C41,5,Resign,White
TRUE,95,5+8,1606,1579,27,C00,3,Resign,White
TRUE,45,10+10,1519,1597,-78,C20,3,Resign,White
TRUE,102,10+0,1619,1452,167,B00,2,Resign,Black
TRUE,35,10+10,1610,1500,110,C42,6,Mate,White
TRUE,33,8+5,1612,1626,-14,C02,9,Resign,White
TRUE,56,10+15,1633,1610,23,C00,3,Mate,Black
TRUE,117,10+15,1595,1583,12,C60,5,Mate,White
TRUE,63,10+5,1696,1607,89,C02,9,Mate,White
TRUE,62,10+5,1743,1586,157,C00,3,Resign,Black
TRUE,66,10+15,1630,1584,46,C00,3,Draw,Draw
TRUE,50,10+15,1609,1564,45,C02,7,Resign,Black
TRUE,113,15+0,1508,1586,-78,D00,3,Resign,White
TRUE,97,10+15,1573,1465,108,C40,4,Mate,White
FALSE,132,5+5,1459,1494,-35,B50,4,Resign,Black
TRUE,24,20+1,1061,1133,-72,C20,3,Out of Time,Black
TRUE,82,5+5,1210,1151,59,A40,3,Out of Time,Black
TRUE,13,10+0,1812,1797,15,C30,4,Mate,White
TRUE,66,15+60,1628,1581,47,C50,8,Resign,Black
TRUE,99,15+60,1577,1571,6,B01,4,Resign,White
TRUE,54,15+60,1638,1497,141,C01,5,Mate,Black
TRUE,46,15+60,1605,1403,202,C50,6,Resign,White
TRUE,90,15+60,1705,1348,357,A10,2,Resign,Black
TRUE,42,15+60,1691,1335,356,B01,4,Resign,White
TRUE,58,15+60,1253,1679,-426,B20,2,Resign,Black
TRUE,53,15+60,1238,1811,-573,B54,6,Mate,White
TRUE,47,15+60,1806,1199,607,C41,5,Resign,White
TRUE,54,15+60,1200,1802,-602,B20,2,Mate,Black
TRUE,104,15+60,1258,1793,-535,B20,3,Mate,Black
FALSE,99,15+60,1706,1287,419,C50,8,Draw,Draw
TRUE,81,15+60,1782,1325,457,C46,7,Resign,White
TRUE,57,15+60,1770,1321,449,B01,4,Resign,White
TRUE,58,15+60,1387,1739,-352,D00,2,Mate,Black
TRUE,33,15+60,1697,1405,292,C41,5,Resign,White
TRUE,65,15+60,1687,1108,579,C00,4,Mate,White
TRUE,80,15+5,1200,1670,-470,D00,2,Resign,Black
FALSE,33,7+2,1624,1620,4,C21,9,Resign,White
FALSE,6,7+2,1325,1620,-295,C24,4,Resign,Black
FALSE,71,7+2,1677,1620,57,C50,9,Mate,White
TRUE,65,15+60,1595,1416,179,C00,3,Mate,White
TRUE,94,30+8,1292,1500,-208,A00,1,Mate,Black
TRUE,86,15+30,1325,1087,238,A02,1,Mate,Black
FALSE,46,20+30,1033,1263,-230,B00,2,Mate,Black
TRUE,172,20+8,1500,1501,-1,A13,2,Resign,Black
FALSE,47,5+8,1521,1500,21,A04,2,Mate,White
TRUE,84,7+10,1490,1672,-182,C64,6,Resign,Black
FALSE,34,15+10,828,1192,-364,A00,1,Mate,Black
TRUE,7,15+0,1245,906,339,C00,3,Out of Time,White
FALSE,5,5+15,1090,837,253,B00,2,Resign,White
TRUE,15,15+0,1576,910,666,A00,1,Resign,White
FALSE,44,20+0,838,1642,-804,A00,1,Resign,Black
TRUE,39,8+5,1317,920,397,B07,2,Resign,White
TRUE,53,20+20,1500,850,650,A06,3,Resign,White
TRUE,19,10+0,1497,924,573,B07,2,Resign,White
TRUE,9,20+20,1500,848,652,B00,2,Mate,White
TRUE,7,4+180,1129,954,175,B00,2,Mate,White
TRUE,44,4+180,996,1108,-112,A00,2,Mate,Black
TRUE,2,14+10,1233,1391,-158,C20,2,Out of Time,Black
TRUE,30,20+0,1260,1211,49,C00,3,Out of Time,Black
TRUE,2,30+12,1300,1064,236,C20,2,Out of Time,Black
TRUE,75,15+5,1344,1325,19,C20,3,Out of Time,White
TRUE,80,10+0,1350,1566,-216,C30,3,Mate,Black
TRUE,34,5+8,1367,1533,-166,C34,6,Mate,Black
TRUE,29,5+8,1526,1388,138,C48,9,Mate,White
TRUE,14,5+8,1373,1530,-157,C30,6,Draw,Draw
TRUE,17,5+11,1365,1445,-80,B01,2,Draw,Draw
TRUE,24,60+13,1180,1341,-161,C20,3,Resign,Black
TRUE,76,60+13,1310,1189,121,C30,3,Resign,White
TRUE,63,8+0,1763,1318,445,C24,4,Out of Time,White
TRUE,115,7+5,1582,1769,-187,A21,3,Mate,White
FALSE,92,7+2,1375,1473,-98,C00,3,Mate,Black
FALSE,75,7+2,1300,1375,-75,C40,4,Mate,White
FALSE,62,7+2,1368,1484,-116,C42,5,Out of Time,Black
FALSE,57,7+2,1484,1303,181,C24,4,Resign,White
FALSE,43,7+2,1368,1484,-116,C40,4,Mate,White
TRUE,2,5+8,1720,1500,220,A01,2,Out of Time,Black
TRUE,2,10+2,1461,828,633,C20,2,Resign,White
TRUE,2,10+2,830,1460,-630,D00,2,Resign,Black
TRUE,2,10+2,1459,832,627,C00,2,Resign,White
TRUE,2,9+4,1442,834,608,C00,2,Resign,White
TRUE,2,5+8,835,1754,-919,D00,2,Resign,Black
TRUE,2,5+8,1376,838,538,A00,1,Resign,White
TRUE,2,5+8,842,1374,-532,A40,1,Resign,Black
TRUE,2,5+8,1373,846,527,A00,1,Resign,White
TRUE,2,5+8,850,1371,-521,A40,2,Resign,Black
TRUE,2,5+8,1369,854,515,A00,1,Resign,White
TRUE,2,5+8,858,1368,-510,A40,1,Resign,Black
TRUE,2,5+8,1366,863,503,A00,1,Resign,White
TRUE,2,5+8,868,1364,-496,A40,1,Resign,Black
TRUE,2,5+8,1362,873,489,A00,1,Resign,White
TRUE,2,5+8,878,1361,-483,A40,2,Resign,Black
TRUE,2,5+8,1359,884,475,E00,1,Resign,White
TRUE,2,5+8,890,1357,-467,A40,2,Resign,Black
TRUE,2,5+8,1355,897,458,A00,2,Resign,White
TRUE,2,5+8,904,1353,-449,C20,2,Resign,Black
TRUE,2,5+8,1351,912,439,A04,2,Resign,White
TRUE,2,5+8,920,1348,-428,D00,2,Resign,Black
TRUE,2,5+8,1346,930,416,A00,1,Resign,White
TRUE,2,5+8,940,1343,-403,D00,2,Resign,Black
TRUE,2,5+8,1341,952,389,A00,1,Resign,White
TRUE,2,5+8,965,1338,-373,C20,2,Resign,Black
TRUE,2,5+8,1335,981,354,B01,2,Resign,White
TRUE,2,5+8,981,1335,-354,D00,2,Resign,Black
TRUE,2,5+8,1332,1001,331,B00,2,Resign,White
TRUE,2,5+8,1025,1328,-303,D00,2,Resign,Black
TRUE,2,5+8,1324,1058,266,B00,2,Resign,White
TRUE,2,5+8,1106,1319,-213,D00,2,Resign,Black
TRUE,2,5+8,1319,1106,213,C00,2,Resign,White
TRUE,2,5+8,1197,1312,-115,A00,2,Resign,Black
TRUE,2,5+8,1302,1500,-198,C00,2,Resign,White
TRUE,80,10+5,1420,1443,-23,C65,6,Resign,Black
TRUE,75,12+8,1429,1461,-32,D30,4,Resign,White
TRUE,94,10+0,1384,1447,-63,D30,8,Resign,Black
TRUE,37,8+0,1490,1463,27,C50,9,Resign,White
TRUE,48,12+10,1370,1487,-117,C44,4,Resign,White
TRUE,82,5+5,1464,1425,39,A21,3,Resign,White
TRUE,144,5+5,1506,1294,212,A21,3,Mate,Black
TRUE,77,5+5,1499,1364,135,A21,3,Resign,White
TRUE,159,5+5,1487,1527,-40,A21,3,Mate,White
TRUE,77,5+5,1476,1452,24,A13,2,Mate,White
TRUE,81,5+5,1467,1408,59,A10,2,Resign,White
TRUE,56,5+5,1489,1453,36,A01,2,Mate,Black
TRUE,83,5+5,1510,1346,164,A21,3,Out of Time,White
FALSE,28,7+2,1206,1517,-311,C62,6,Resign,Black
TRUE,45,5+5,1487,1542,-55,A10,2,Mate,White
TRUE,55,5+5,1524,1436,88,A22,4,Mate,White
TRUE,133,5+5,1519,1288,231,A13,2,Mate,White
TRUE,158,5+5,1545,1498,47,A01,2,Out of Time,Black
TRUE,63,5+5,1538,1423,115,A21,3,Resign,White
TRUE,56,5+5,1568,1408,160,A01,4,Mate,Black
TRUE,87,5+5,1563,1351,212,A21,3,Mate,White
TRUE,29,5+5,1554,1479,75,A11,2,Resign,White
FALSE,49,5+5,1559,1451,108,A34,3,Mate,White
FALSE,17,5+5,1551,1459,92,A34,3,Resign,White
TRUE,61,5+5,1558,1414,144,A22,4,Out of Time,White
TRUE,75,5+5,1544,1354,190,A21,3,Resign,White
TRUE,64,5+5,1535,1447,88,A10,2,Resign,White
TRUE,88,5+5,1568,1469,99,A01,2,Mate,Black
TRUE,40,5+5,1583,1461,122,A10,2,Resign,Black
TRUE,61,5+5,1571,1437,134,A13,2,Resign,White
TRUE,15,5+5,1565,1393,172,A21,3,Out of Time,White
FALSE,66,5+5,1566,1317,249,A21,4,Resign,Black
TRUE,83,5+5,1558,1389,169,A34,3,Mate,White
TRUE,66,5+5,1547,1543,4,A01,2,Resign,White
TRUE,74,5+5,1560,1531,29,A10,1,Mate,Black
TRUE,141,5+5,1562,1493,69,A21,3,Draw,Draw
FALSE,54,5+8,1487,1107,380,C00,3,Mate,Black
TRUE,122,4+6,1248,1500,-252,C40,4,Resign,Black
TRUE,58,5+8,1310,1304,6,B01,2,Out of Time,Black
TRUE,105,5+8,1500,1202,298,B07,2,Draw,Draw
TRUE,38,5+8,1689,1432,257,C60,6,Resign,Black
TRUE,68,10+10,1528,1500,28,A00,2,Resign,Black
TRUE,63,5+8,1447,1389,58,C20,3,Resign,White
TRUE,59,5+5,1278,1104,174,C55,6,Resign,White
TRUE,72,15+5,1403,1291,112,C20,2,Mate,Black
TRUE,53,25+4,1387,1562,-175,B00,2,Mate,White
TRUE,14,40+8,1344,1388,-44,A43,3,Draw,Draw
TRUE,19,8+7,1412,1399,13,C55,6,Mate,White
TRUE,116,20+5,1403,1387,16,C20,3,Mate,Black
TRUE,49,4+18,1321,1401,-80,C46,5,Resign,White
TRUE,114,5+8,1368,1391,-23,D01,4,Resign,Black
TRUE,57,11+8,1404,1346,58,B10,2,Resign,Black
TRUE,36,20+0,1408,1652,-244,B06,2,Resign,Black
TRUE,19,10+5,1488,1417,71,D10,6,Resign,White
TRUE,101,15+15,1404,1476,-72,B01,2,Resign,White
FALSE,58,7+8,1331,1270,61,C26,4,Resign,Black
TRUE,95,10+5,1447,1413,34,C37,7,Mate,White
TRUE,71,10+5,1506,1422,84,C40,4,Mate,White
TRUE,118,10+0,1451,1409,42,C55,6,Mate,Black
TRUE,52,10+0,1465,1396,69,C40,3,Mate,Black
TRUE,23,10+8,1198,1413,-215,D00,3,Mate,White
TRUE,72,7+6,1425,1387,38,C20,4,Mate,Black
TRUE,62,11+1,1435,1481,-46,C00,3,Resign,Black
TRUE,103,15+10,1424,1425,-1,B20,2,Resign,White
TRUE,112,15+0,1432,1513,-81,C20,3,Resign,Black
TRUE,80,8+8,1336,1424,-88,C55,6,Resign,Black
TRUE,26,7+8,1444,1412,32,C45,8,Resign,Black
TRUE,61,7+8,1570,1419,151,C26,4,Resign,White
TRUE,93,25+9,1511,1416,95,C55,6,Draw,Draw
TRUE,18,7+3,1521,1401,120,C44,4,Mate,Black
TRUE,39,10+5,1377,1402,-25,D00,4,Draw,Draw
TRUE,22,29+30,1437,1389,48,D31,6,Resign,Black
TRUE,3,6+20,1427,1399,28,C40,3,Out of Time,White
TRUE,44,10+1,1404,1631,-227,B06,2,Resign,Black
TRUE,76,10+10,1610,1388,222,C36,7,Resign,Black
TRUE,72,10+10,1393,1589,-196,C20,3,Mate,Black
TRUE,52,10+5,1389,1788,-399,B20,2,Mate,Black
TRUE,37,30+0,1640,1393,247,C55,6,Resign,White
TRUE,8,15+10,1404,1390,14,B00,2,Resign,Black
TRUE,84,7+6,1293,1390,-97,C55,6,Out of Time,Black
TRUE,103,25+4,1268,1405,-137,C20,3,Mate,White
TRUE,33,180+180,1908,1479,429,C20,3,Resign,White
TRUE,13,180+180,1364,2081,-717,D02,3,Draw,Draw
FALSE,24,180+180,1788,1245,543,B00,5,Resign,White
FALSE,35,180+180,1245,1011,234,A40,1,Resign,White
FALSE,20,10+8,1245,1148,97,C41,5,Out of Time,Black
FALSE,95,10+8,1148,1245,-97,C42,4,Draw,Draw
FALSE,56,5+5,1930,2068,-138,C58,15,Resign,Black
FALSE,75,3+8,1913,2042,-129,C01,5,Resign,Black
FALSE,36,3+8,1921,2009,-88,C67,8,Mate,Black
TRUE,24,5+10,1152,1550,-398,C26,4,Resign,Black
TRUE,83,4+12,1967,1152,815,A04,6,Mate,White
TRUE,55,5+8,1619,1155,464,C44,5,Mate,White
TRUE,96,5+8,1159,1501,-342,C44,5,Mate,Black
TRUE,93,6+9,1146,1055,91,C41,4,Mate,White
TRUE,46,10+0,1562,1149,413,A40,2,Resign,White
FALSE,12,15+5,1195,1000,195,A00,1,Resign,White
TRUE,8,10+10,1176,1148,28,C20,3,Draw,Draw
TRUE,33,10+8,1099,1166,-67,C40,4,Resign,White
TRUE,4,6+6,1282,1180,102,C40,3,Resign,White
TRUE,11,6+6,1274,1194,80,C40,4,Resign,White
TRUE,9,10+10,1457,1202,255,C40,4,Resign,White
TRUE,11,10+0,1510,1208,302,A00,1,Resign,White
TRUE,21,5+8,1508,1214,294,C40,4,Resign,White
TRUE,13,10+8,1283,1232,51,C40,4,Resign,White
TRUE,40,11+8,1257,1199,58,B01,2,Resign,Black
TRUE,54,15+8,1290,1119,171,B01,2,Resign,Black
TRUE,16,10+0,1885,1291,594,C40,4,Resign,White
TRUE,11,5+7,1375,1311,64,C40,4,Resign,White
TRUE,73,25+1,1331,1394,-63,C20,3,Resign,Black
TRUE,8,5+8,1339,1646,-307,B01,2,Resign,Black
TRUE,24,20+0,1377,1418,-41,C20,3,Mate,Black
TRUE,17,15+0,1860,1381,479,C40,4,Resign,White
TRUE,15,17+8,1661,1392,269,A40,2,Resign,White
FALSE,24,9+0,1165,1765,-600,B20,2,Resign,Black
TRUE,29,60+5,1670,1432,238,C41,4,Mate,White
TRUE,57,30+0,1290,1449,-159,C41,5,Mate,White
TRUE,19,30+0,1442,1297,145,C44,9,Mate,White
TRUE,63,20+0,1478,1453,25,C20,3,Resign,White
TRUE,64,17+8,1759,1438,321,C41,8,Resign,Black
TRUE,23,15+10,1426,1408,18,C02,9,Resign,White
TRUE,100,40+8,1409,1790,-381,B20,3,Resign,Black
TRUE,2,20+0,1409,1723,-314,C20,2,Resign,White
TRUE,64,15+7,1423,1552,-129,C00,3,Mate,Black
TRUE,85,45+0,1711,1427,284,C42,5,Resign,White
TRUE,53,10+0,1626,1433,193,A45,2,Resign,White
TRUE,88,21+0,1252,1427,-175,C41,6,Resign,Black
TRUE,17,10+2,1423,1744,-321,B20,3,Draw,Draw
TRUE,41,15+15,1775,1426,349,C42,4,Resign,White
TRUE,46,30+0,1431,1658,-227,C44,4,Resign,Black
TRUE,61,20+0,1578,1438,140,C42,5,Mate,White
TRUE,93,30+0,1507,1448,59,C26,5,Resign,White
TRUE,29,20+0,1456,1562,-106,B30,4,Resign,Black
TRUE,51,45+0,1402,1462,-60,D35,7,Mate,White
TRUE,62,40+2,1469,1636,-167,C45,8,Resign,Black
TRUE,59,15+5,1449,1731,-282,C44,8,Mate,White
TRUE,39,30+0,1436,1478,-42,B02,7,Resign,White
TRUE,118,15+5,1787,1427,360,A00,5,Draw,Draw
TRUE,104,20+8,1501,1436,65,C41,4,Resign,White
TRUE,24,10+10,1439,1821,-382,B22,3,Resign,Black
TRUE,58,30+0,1419,1428,-9,C41,5,Mate,Black
TRUE,73,8+9,1435,1598,-163,B01,6,Resign,Black
TRUE,41,15+15,1497,1445,52,A45,3,Resign,White
TRUE,10,15+5,1531,1454,77,C41,7,Resign,White
TRUE,35,15+5,1439,1545,-106,C00,3,Mate,White
TRUE,21,10+5,1567,1447,120,E00,4,Resign,White
TRUE,47,10+30,1953,1448,505,C41,6,Resign,White
TRUE,91,30+0,1553,1457,96,E10,5,Resign,White
TRUE,41,10+10,1462,1697,-235,B01,4,Resign,Black
TRUE,159,15+5,1526,1447,79,C42,5,Resign,Black
TRUE,53,15+5,1431,1539,-108,C50,6,Mate,White
TRUE,96,45+5,1435,1725,-290,C40,4,Resign,Black
TRUE,19,6+4,1583,1426,157,C24,4,Resign,White
TRUE,102,25+10,1694,1430,264,C41,8,Resign,White
TRUE,67,15+10,1420,1886,-466,B10,2,Draw,Draw
TRUE,26,10+10,1436,1432,4,C26,5,Resign,White
TRUE,141,5+20,1428,1531,-103,C00,3,Draw,Draw
TRUE,131,20+0,1726,1432,294,C34,5,Resign,White
TRUE,78,90+8,1627,1438,189,C41,8,Resign,White
TRUE,58,15+0,1889,1440,449,D35,9,Resign,White
TRUE,63,15+15,1427,1447,-20,B01,2,Resign,White
FALSE,22,20+0,842,1076,-234,A00,1,Mate,Black
FALSE,35,20+0,1076,842,234,B00,2,Mate,White
TRUE,19,15+0,966,869,97,C20,3,Mate,White
FALSE,9,16+0,1017,869,148,C00,2,Draw,Draw
FALSE,16,16+0,869,1028,-159,A00,2,Out of Time,Black
FALSE,45,16+0,1028,869,159,C00,4,Mate,White
FALSE,10,16+0,869,1028,-159,A00,1,Mate,Black
FALSE,21,16+0,1028,869,159,B06,2,Out of Time,White
TRUE,21,15+0,1015,897,118,B06,2,Out of Time,White
TRUE,4,15+0,927,1055,-128,A01,1,Resign,Black
FALSE,87,180+0,1507,927,580,B00,2,Mate,White
FALSE,65,15+0,1665,927,738,A40,2,Mate,White
TRUE,39,30+0,1435,1653,-218,A00,1,Resign,Black
FALSE,38,5+8,1397,1500,-103,A00,1,Resign,Black
TRUE,3,14+0,1828,1500,328,B07,2,Resign,White
FALSE,30,3+8,1303,1500,-197,B07,2,Out of Time,Black
TRUE,29,15+0,1247,1224,23,B05,8,Resign,Black
TRUE,35,5+8,1311,1320,-9,C34,6,Resign,White
TRUE,39,14+0,1398,1412,-14,C50,7,Resign,White
TRUE,51,20+15,1348,1183,165,B02,2,Mate,White
FALSE,84,10+8,1170,800,370,C40,4,Resign,Black
TRUE,27,10+20,1381,1575,-194,C70,10,Resign,White
TRUE,43,7+15,1500,1219,281,B06,6,Mate,White
FALSE,19,12+8,899,1139,-240,C20,4,Resign,White
TRUE,27,10+0,1224,1289,-65,C41,5,Resign,White
TRUE,40,15+0,1207,1367,-160,C44,4,Resign,White
TRUE,89,15+0,1359,1214,145,C42,5,Resign,White
TRUE,22,8+0,1340,1197,143,D00,3,Mate,Black
TRUE,84,6+8,1207,1232,-25,C60,5,Mate,Black
FALSE,55,5+8,1082,1500,-418,C42,5,Resign,White
TRUE,33,12+5,1429,1212,217,C40,4,Resign,White
TRUE,65,11+3,1177,1217,-40,C40,4,Resign,White
TRUE,32,11+3,1231,1162,69,C41,4,Resign,Black
TRUE,28,11+3,1173,1221,-48,D02,4,Resign,Black
TRUE,52,11+3,1235,1157,78,C01,4,Resign,Black
TRUE,49,12+3,1253,1247,6,A00,1,Resign,White
TRUE,69,5+5,1044,1181,-137,C68,7,Resign,White
TRUE,83,10+0,1391,1263,128,C68,7,Resign,White
TRUE,114,10+5,1231,1264,-33,C40,4,Draw,Draw
TRUE,126,15+0,1305,1250,55,A00,2,Mate,Black
TRUE,30,5+8,1415,1245,170,C44,4,Resign,Black
TRUE,78,13+7,1401,1237,164,C20,3,Mate,Black
TRUE,49,5+8,1399,1238,161,C40,4,Out of Time,White
TRUE,101,15+1,1400,1246,154,C20,3,Mate,White
TRUE,51,5+8,1232,1266,-34,B01,4,Mate,White
TRUE,73,8+0,1215,1326,-111,B01,4,Mate,White
TRUE,66,9+7,1320,1198,122,C20,4,Mate,Black
TRUE,84,8+2,1364,1182,182,D20,5,Resign,Black
TRUE,46,10+0,1197,1151,46,C41,4,Mate,Black
TRUE,85,8+4,1197,1023,174,C40,4,Mate,White
FALSE,55,10+8,1171,1070,101,C40,4,Mate,White
TRUE,51,15+15,1185,1125,60,C41,4,Mate,White
TRUE,93,10+8,1170,1192,-22,C00,3,Mate,White
TRUE,31,8+5,1155,1170,-15,C41,4,Mate,White
FALSE,51,14+2,1500,1410,90,B01,6,Resign,White
TRUE,54,8+5,1607,1580,27,C40,4,Mate,Black
TRUE,38,6+5,1739,1606,133,C62,6,Resign,Black
TRUE,30,7+8,1487,1673,-186,C00,3,Out of Time,Black
TRUE,98,15+15,1496,1500,-4,C00,5,Resign,Black
TRUE,50,25+15,1622,1500,122,B40,6,Resign,Black
TRUE,23,30+8,1500,1568,-68,D21,6,Resign,White
TRUE,56,15+15,1502,1500,2,B07,7,Out of Time,Black
TRUE,33,20+13,1375,1500,-125,B02,4,Draw,Draw
TRUE,48,19+3,1500,1575,-75,A83,7,Resign,White
TRUE,68,25+2,1197,1500,-303,C50,8,Resign,Black
TRUE,37,15+0,1500,1370,130,D12,8,Resign,White
FALSE,75,25+10,1565,1549,16,D00,3,Resign,White
FALSE,34,13+0,1320,1554,-234,A20,2,Mate,Black
FALSE,57,20+0,1525,1524,1,B08,8,Mate,White
FALSE,68,15+0,1497,1493,4,D58,14,Mate,Black
FALSE,54,60+15,1259,1478,-219,B06,4,Resign,Black
FALSE,60,10+0,1665,1421,244,C68,7,Out of Time,Black
FALSE,48,20+0,1390,1319,71,A80,2,Resign,White
FALSE,75,20+0,1329,1350,-21,B10,5,Resign,Black
FALSE,30,15+0,1005,1350,-345,D20,5,Resign,Black
TRUE,113,15+8,1308,1205,103,C21,3,Resign,White
TRUE,55,30+30,1286,1280,6,A02,1,Mate,White
TRUE,75,30+30,1260,1313,-53,A00,1,Mate,White
TRUE,78,15+0,1327,1490,-163,C00,3,Mate,Black
TRUE,20,20+0,1299,1301,-2,B01,4,Resign,Black
TRUE,62,10+0,1314,1520,-206,C44,5,Out of Time,Black
TRUE,48,10+10,1211,1500,-289,A00,1,Mate,Black
TRUE,66,5+5,1576,1256,320,D30,4,Resign,Black
TRUE,75,8+0,2003,1316,687,A40,2,Out of Time,White
TRUE,62,15+0,1359,1170,189,C44,4,Out of Time,Black
TRUE,44,30+5,1219,1339,-120,A02,1,Mate,Black
TRUE,39,5+8,1303,1353,-50,E14,7,Mate,White
TRUE,94,5+8,1381,1256,125,B01,4,Mate,Black
TRUE,41,5+8,1373,1271,102,B02,3,Resign,White
TRUE,6,5+8,1306,1396,-90,B01,2,Out of Time,Black
TRUE,68,9+0,1312,1814,-502,C30,5,Out of Time,Black
TRUE,55,8+0,1282,1129,153,A00,1,Mate,White
TRUE,101,15+15,1466,1318,148,D00,3,Mate,White
TRUE,34,16+0,1337,1672,-335,B20,3,Mate,Black
TRUE,21,16+0,1668,1360,308,B07,5,Mate,White
TRUE,82,5+8,1453,1427,26,C21,5,Mate,Black
TRUE,51,3+35,2117,1458,659,B03,9,Mate,White
TRUE,48,5+10,1498,1276,222,C22,7,Mate,Black
TRUE,13,5+5,1500,1350,150,A27,5,Resign,White
TRUE,75,7+11,1459,1500,-41,C20,3,Out of Time,White
TRUE,35,15+0,1449,1462,-13,A53,4,Mate,White
TRUE,108,16+4,1472,1501,-29,C41,5,Out of Time,Black
TRUE,144,30+15,1481,1516,-35,B20,3,Mate,Black
TRUE,53,10+5,1472,1435,37,C40,3,Mate,White
TRUE,52,20+5,1483,1455,28,C71,8,Resign,Black
TRUE,59,10+10,1401,1496,-95,B21,3,Resign,White
TRUE,78,7+7,1456,1487,-31,B20,3,Mate,Black
TRUE,74,11+0,1548,1476,72,B20,2,Mate,Black
TRUE,104,15+0,1486,1484,2,C44,4,Mate,Black
TRUE,82,10+5,1401,1478,-77,B30,4,Mate,Black
TRUE,88,15+10,1532,1466,66,B30,4,Resign,Black
TRUE,61,15+5,1456,1441,15,C60,6,Mate,White
TRUE,73,14+14,1445,1454,-9,C62,6,Resign,White
TRUE,77,30+0,1509,1454,55,A45,2,Resign,White
TRUE,122,20+0,1442,1454,-12,B20,3,Draw,Draw
TRUE,157,10+20,1440,1465,-25,B20,3,Mate,White
TRUE,67,5+8,1500,1472,28,B21,12,Mate,White
TRUE,23,7+7,1464,1362,102,C65,6,Out of Time,White
TRUE,50,15+2,1475,1462,13,A00,3,Resign,Black
TRUE,49,10+10,1457,1487,-30,B56,10,Mate,White
TRUE,33,5+8,1478,1422,56,C45,7,Out of Time,White
TRUE,89,10+10,1507,1488,19,B20,3,Mate,White
TRUE,37,15+15,1540,1489,51,B45,9,Mate,White
TRUE,110,30+0,1499,1486,13,A01,1,Mate,Black
TRUE,46,15+5,1509,1540,-31,C62,6,Resign,Black
TRUE,77,15+0,1487,1521,-34,A00,1,Out of Time,White
TRUE,18,10+5,1477,1504,-27,B30,4,Resign,Black
TRUE,117,20+5,1402,1507,-105,B21,3,Draw,Draw
TRUE,55,14+14,1498,1446,52,B20,3,Resign,White
TRUE,72,14+14,1505,1628,-123,C65,6,Resign,Black
TRUE,58,16+0,1510,1480,30,C61,6,Resign,Black
TRUE,75,12+5,1502,1394,108,B20,3,Resign,White
TRUE,14,30+0,1455,1493,-38,B20,2,Resign,Black
TRUE,34,20+0,1507,1482,25,B21,3,Resign,Black
TRUE,48,12+10,1434,1473,-39,A18,5,Mate,Black
TRUE,110,10+10,1475,1470,5,B20,3,Mate,Black
TRUE,54,10+10,1487,1427,60,B30,5,Resign,Black
FALSE,35,25+1,1500,1487,13,A40,2,Mate,White
TRUE,37,10+10,1478,1423,55,B30,5,Out of Time,White
TRUE,52,30+0,1504,1467,37,B20,2,Mate,Black
TRUE,71,10+3,1457,1448,9,C41,5,Resign,White
TRUE,151,15+10,1462,1468,-6,B20,3,Mate,White
TRUE,60,5+8,1480,1419,61,C70,8,Mate,Black
TRUE,86,15+3,1391,1472,-81,B25,4,Resign,Black
TRUE,77,20+0,1462,1424,38,C41,5,Mate,White
TRUE,8,7+10,1551,1159,392,B02,2,Resign,White
FALSE,62,5+5,1057,1450,-393,A06,3,Mate,Black
TRUE,37,5+7,1577,1217,360,B02,2,Mate,White
FALSE,130,180+8,1272,1186,86,A00,1,Draw,Draw
TRUE,32,10+8,1337,1391,-54,D00,3,Mate,Black
TRUE,19,20+2,1500,1500,0,D00,3,Mate,White
FALSE,54,20+10,1500,1099,401,C20,4,Resign,Black
TRUE,67,11+1,1277,1500,-223,C20,2,Mate,White
FALSE,175,8+7,1896,1619,277,C30,4,Mate,White
FALSE,55,5+5,1481,1750,-269,B43,9,Resign,White
FALSE,47,5+8,1426,1458,-32,D41,18,Mate,White
FALSE,52,5+8,1512,1485,27,C36,7,Resign,Black
FALSE,137,5+8,1503,1637,-134,C50,5,Draw,Draw
FALSE,147,5+8,1629,1510,119,C44,5,Resign,White
FALSE,48,5+8,1506,1633,-127,C46,5,Draw,Draw
FALSE,60,8+0,1524,1765,-241,C50,8,Resign,Black
FALSE,131,8+0,1760,1529,231,C42,6,Out of Time,White
FALSE,42,8+0,1534,1755,-221,C50,9,Resign,Black
TRUE,56,30+0,1533,1593,-60,D07,7,Resign,White
TRUE,37,30+0,1547,1356,191,C41,9,Resign,Black
TRUE,55,6+8,1537,1560,-23,C50,8,Resign,White
TRUE,36,30+0,1564,1814,-250,C40,4,Out of Time,Black
TRUE,23,30+0,1548,1729,-181,C45,8,Mate,White
TRUE,40,30+0,1563,1469,94,C00,3,Resign,Black
TRUE,85,30+0,1551,1573,-22,B02,4,Mate,White
TRUE,48,30+0,1549,1109,440,B00,4,Resign,White
TRUE,7,30+0,1536,1232,304,B01,4,Resign,White
TRUE,35,30+0,1518,1762,-244,C45,7,Mate,White
TRUE,19,5+5,1500,1337,163,C45,10,Resign,Black
TRUE,56,30+0,1514,1255,259,C45,7,Resign,White
FALSE,100,30+0,1260,1389,-129,C28,7,Resign,Black
FALSE,46,30+0,1389,1260,129,C45,7,Resign,Black
TRUE,65,30+0,1509,1253,256,C41,5,Mate,White
TRUE,48,30+0,1520,1534,-14,B88,12,Resign,Black
TRUE,25,30+0,1509,1499,10,C45,7,Resign,White
TRUE,39,30+0,1506,1133,373,C44,5,Resign,White
TRUE,177,30+0,1502,1718,-216,C41,6,Draw,Draw
TRUE,88,30+0,1509,1639,-130,B54,6,Resign,Black
TRUE,53,30+0,1500,1451,49,C00,5,Mate,White
TRUE,16,30+0,1512,1503,9,C40,4,Resign,Black
TRUE,29,30+0,1489,1589,-100,B00,2,Out of Time,White
TRUE,28,30+0,1496,1646,-150,C45,7,Out of Time,Black
TRUE,56,30+0,1507,1512,-5,C00,3,Resign,Black
TRUE,73,30+0,1517,1569,-52,B07,4,Resign,Black
TRUE,70,30+0,1524,1668,-144,C45,7,Resign,Black
TRUE,49,30+0,1515,1437,78,C44,5,Resign,White
TRUE,7,30+0,1508,1373,135,B01,6,Out of Time,White
TRUE,44,30+0,1522,1461,61,B53,7,Resign,Black
TRUE,98,30+0,1523,1494,29,C45,7,Draw,Draw
TRUE,61,30+0,1536,1487,49,C42,5,Resign,Black
TRUE,50,30+0,1542,1763,-221,C40,4,Resign,Black
TRUE,57,30+0,1524,1714,-190,C44,5,Resign,White
TRUE,39,30+0,1521,1150,371,B00,4,Resign,White
TRUE,42,30+0,1540,1267,273,B25,4,Mate,Black
TRUE,28,30+0,1549,1647,-98,C41,8,Resign,Black
TRUE,81,10+8,1976,1755,221,C02,8,Mate,White
TRUE,66,20+1,1768,1662,106,C55,6,Resign,Black
TRUE,132,5+8,1500,1652,-152,B40,4,Resign,Black
FALSE,59,5+8,1398,1500,-102,C20,3,Resign,White
FALSE,41,5+8,1500,1500,0,C23,3,Mate,White
FALSE,42,5+8,1400,1500,-100,D00,3,Resign,Black
FALSE,85,5+8,1452,1500,-48,C41,5,Resign,White
FALSE,37,5+8,1458,1500,-42,B02,4,Draw,Draw
TRUE,51,10+5,1906,1857,49,D21,6,Resign,White
TRUE,73,10+5,1897,1027,870,B17,8,Resign,White
TRUE,81,8+8,1500,1814,-314,A13,8,Resign,White
TRUE,37,8+0,1456,1193,263,C44,5,Mate,White
TRUE,46,8+0,1231,1177,54,C20,3,Resign,Black
TRUE,94,5+8,1777,1640,137,C53,9,Out of Time,Black
TRUE,85,5+8,1944,1674,270,D02,4,Mate,White
TRUE,95,5+8,1777,1785,-8,B00,5,Mate,White
TRUE,106,10+0,1726,1560,166,B00,5,Resign,Black
TRUE,58,5+8,1151,1500,-349,D00,3,Mate,Black
TRUE,10,5+5,1381,1500,-119,D00,3,Resign,White
TRUE,14,5+8,1646,1381,265,A50,4,Resign,White
TRUE,48,5+8,1500,1637,-137,C21,4,Mate,Black
FALSE,38,5+5,1972,2174,-202,B30,4,Mate,Black
TRUE,85,10+0,1603,1641,-38,A40,1,Mate,White
TRUE,68,10+0,1647,1805,-158,A45,3,Resign,Black
TRUE,13,10+0,1798,1654,144,C27,3,Resign,White
TRUE,101,10+0,1617,1666,-49,A00,1,Resign,White
TRUE,58,10+0,1383,1662,-279,C40,4,Resign,Black
TRUE,54,10+0,1567,1655,-88,C40,4,Resign,Black
TRUE,72,10+0,1754,1641,113,A00,1,Resign,Black
TRUE,73,10+0,1809,1647,162,C40,4,Resign,White
TRUE,86,10+0,1576,1638,-62,C30,3,Out of Time,Black
TRUE,118,10+0,1437,1634,-197,B12,3,Out of Time,Draw
TRUE,54,10+0,1652,1622,30,A40,1,Resign,Black
TRUE,134,10+0,1566,1612,-46,C40,4,Out of Time,Black
TRUE,96,10+0,1604,1523,81,A45,3,Resign,White
TRUE,70,10+0,1532,1595,-63,C20,3,Out of Time,Black
TRUE,51,10+0,1735,1602,133,C40,4,Resign,White
TRUE,75,10+0,1508,1594,-86,B12,3,Resign,Black
TRUE,45,10+0,1645,1603,42,C40,4,Resign,White
TRUE,63,10+0,2222,1604,618,A40,1,Resign,White
TRUE,75,10+0,1666,1613,53,C40,4,Resign,White
TRUE,56,10+0,1597,1603,-6,C20,3,Resign,Black
TRUE,50,10+0,1582,1592,-10,A40,1,Resign,Black
TRUE,66,10+0,1537,1583,-46,C40,4,Resign,Black
TRUE,87,10+0,1704,1590,114,A40,1,Resign,White
TRUE,47,10+0,1612,1601,11,C40,4,Resign,White
TRUE,37,10+0,1692,1609,83,B12,3,Resign,White
TRUE,138,10+0,1650,1597,53,C40,4,Out of Time,Black
TRUE,35,10+0,1816,1602,214,D31,6,Resign,White
TRUE,74,10+0,1617,1593,24,D00,3,Resign,Black
TRUE,48,10+0,1563,1583,-20,C23,3,Out of Time,Black
TRUE,46,10+0,1492,1574,-82,C40,4,Resign,Black
TRUE,84,10+0,1589,1563,26,D02,4,Resign,Black
TRUE,22,10+0,1717,1547,170,C27,3,Out of Time,Black
FALSE,40,10+0,1372,1410,-38,C40,4,Resign,Black
TRUE,89,10+0,1566,1558,8,A40,1,Resign,White
FALSE,70,10+0,1375,1410,-35,C40,4,Resign,Black
TRUE,82,10+0,1500,1551,-51,A40,1,Out of Time,Black
TRUE,56,10+0,1558,1674,-116,D03,5,Mate,Black
TRUE,141,10+0,1666,1566,100,C20,3,Resign,White
TRUE,89,10+0,1594,1576,18,C20,3,Mate,White
TRUE,82,10+0,1614,1564,50,C40,4,Mate,Black
TRUE,94,10+0,1535,1555,-20,C40,4,Resign,Black
TRUE,46,10+0,1645,1541,104,A40,1,Resign,Black
TRUE,55,10+0,1696,1548,148,A00,1,Resign,White
TRUE,124,10+0,1486,1539,-53,C20,3,Mate,Black
TRUE,45,10+0,1557,1549,8,B12,3,Resign,White
TRUE,89,10+0,1577,1559,18,C23,3,Resign,White
TRUE,112,10+0,1570,1566,4,A40,1,Resign,Black
TRUE,116,10+0,1578,1559,19,A00,1,Out of Time,Black
TRUE,53,5+5,1484,1500,-16,B10,5,Mate,White
FALSE,30,7+2,2179,1593,586,B12,5,Resign,White
TRUE,94,7+2,1698,1612,86,B10,2,Mate,Black
TRUE,74,7+2,1870,1676,194,D10,4,Resign,White
TRUE,50,5+10,1502,1500,2,B10,2,Mate,Black
TRUE,73,8+0,1432,1500,-68,C41,4,Resign,White
TRUE,58,5+8,1500,1629,-129,C41,4,Resign,Black
TRUE,54,8+5,1396,1500,-104,E00,5,Resign,Black
TRUE,43,10+5,1607,1500,107,C21,5,Resign,Black
TRUE,54,2+12,1530,1500,30,C41,5,Mate,Black
FALSE,60,5+8,1306,1500,-194,B50,4,Resign,Black
TRUE,34,5+5,1626,1500,126,C50,9,Resign,Black
TRUE,67,5+5,1500,1626,-126,C62,6,Resign,White
TRUE,44,8+9,1584,1500,84,E14,7,Resign,Black
TRUE,25,8+9,1500,1584,-84,B45,9,Resign,White
FALSE,52,7+2,1229,1500,-271,A00,1,Mate,Black
FALSE,41,7+2,1500,1229,271,C59,16,Mate,White
FALSE,44,10+0,1434,1538,-104,A00,1,Mate,Black
TRUE,69,15+10,1533,1586,-53,A00,1,Mate,White
TRUE,44,180+0,1678,1416,262,B00,6,Resign,Black
TRUE,65,5+8,1550,1564,-14,B02,3,Mate,White
TRUE,50,8+0,1169,1500,-331,D07,7,Resign,Black
FALSE,44,180+180,1500,1500,0,C20,3,Resign,Black
TRUE,116,5+5,1302,1611,-309,B06,2,Mate,Black
TRUE,69,5+5,1598,1359,239,A13,2,Resign,White
TRUE,80,5+5,1500,1581,-81,B06,7,Out of Time,Black
FALSE,46,10+6,1280,1500,-220,C20,3,Resign,Black
FALSE,39,10+6,1500,1280,220,B07,2,Resign,White
TRUE,15,8+30,1673,1500,173,B07,3,Mate,White
TRUE,23,25+0,1356,1135,221,A40,2,Resign,White
TRUE,59,25+0,1349,1141,208,C00,3,Mate,White
TRUE,56,25+0,1148,1336,-188,A00,1,Resign,Black
TRUE,3,25+0,1500,1133,367,A04,2,Resign,Black
TRUE,52,25+0,1138,1377,-239,A00,1,Out of Time,Black
TRUE,68,25+0,1144,1372,-228,A00,1,Resign,Black
TRUE,2,25+0,1146,1572,-426,A00,1,Out of Time,Black
TRUE,37,25+0,1491,1150,341,A04,2,Resign,White
TRUE,33,25+0,1453,1154,299,A40,2,Resign,White
TRUE,38,25+0,1161,1341,-180,A00,1,Resign,Black
TRUE,35,25+0,1854,1162,692,C00,3,Mate,White
TRUE,74,25+0,1357,1155,202,C00,3,Draw,Draw
TRUE,95,25+0,1620,1157,463,C00,2,Resign,White
TRUE,45,25+0,1164,1345,-181,A00,1,Resign,Black
TRUE,76,25+0,1168,1468,-300,A00,1,Resign,Black
TRUE,27,25+0,1573,1170,403,C00,3,Resign,White
TRUE,81,25+0,1242,1181,61,A00,1,Resign,White
TRUE,50,25+0,1196,1130,66,A00,1,Resign,Black
TRUE,27,25+0,1199,1591,-392,A00,1,Resign,Black
TRUE,38,25+0,1201,1632,-431,A00,1,Resign,Black
TRUE,8,25+0,969,1195,-226,C00,3,Mate,Black
TRUE,7,25+0,1178,1339,-161,A00,1,Mate,White
TRUE,37,25+0,1468,1182,286,C00,3,Mate,White
TRUE,92,25+0,1191,1303,-112,A00,1,Resign,Black
TRUE,55,25+0,1294,1201,93,C00,3,Mate,White
TRUE,12,25+0,1252,1187,65,C00,3,Out of Time,Black
TRUE,95,25+0,1378,1194,184,A00,1,Mate,White
TRUE,110,25+0,1431,1173,258,C00,3,Mate,Black
TRUE,103,25+0,1203,1185,18,C00,3,Mate,White
TRUE,71,25+0,1236,1197,39,C01,4,Out of Time,White
TRUE,122,25+0,1024,1152,-128,A00,1,Mate,Black
TRUE,40,25+0,1160,1303,-143,A00,1,Resign,Black
FALSE,45,25+0,1278,1057,221,A04,2,Out of Time,White
TRUE,35,25+0,1148,1114,34,A00,1,Resign,White
TRUE,86,25+0,1327,1126,201,A40,2,Mate,Black
TRUE,55,25+0,1632,1128,504,B00,4,Mate,White
TRUE,39,25+0,1414,1104,310,C00,2,Resign,Black
TRUE,61,25+0,1347,1110,237,C00,3,Mate,White
TRUE,82,25+0,957,1101,-144,A40,2,Resign,Black
TRUE,19,25+0,1300,1108,192,A40,2,Out of Time,White
TRUE,12,25+0,1116,1292,-176,A00,1,Resign,Black
TRUE,21,25+0,1569,1108,461,C00,3,Resign,White
TRUE,60,25+0,1111,1521,-410,A00,1,Out of Time,Black
TRUE,35,25+0,1312,1118,194,C00,3,Out of Time,White
TRUE,21,25+0,1567,1120,447,C00,3,Resign,White
TRUE,53,15+0,1905,1843,62,B00,2,Mate,White
TRUE,40,15+0,1852,1896,-44,A40,2,Resign,Black
TRUE,59,10+0,1888,1793,95,B01,4,Resign,White
TRUE,43,5+5,1879,1826,53,B03,12,Resign,White
TRUE,43,5+8,1921,1889,32,A04,2,Mate,White
TRUE,63,5+5,1881,1777,104,C30,4,Mate,White
TRUE,57,3+8,1823,1894,-71,C00,3,Mate,White
TRUE,91,6+5,1891,1904,-13,C00,3,Resign,White
TRUE,61,9+0,1895,1858,37,B21,3,Out of Time,White
TRUE,103,10+0,1879,1906,-27,A40,2,Resign,White
TRUE,57,7+5,1882,1959,-77,C00,3,Resign,White
TRUE,60,2+10,1896,1871,25,C02,7,Resign,Black
TRUE,142,10+0,2072,1855,217,A40,2,Mate,Black
TRUE,99,10+0,1788,1868,-80,A00,4,Mate,White
TRUE,45,8+0,1856,1895,-39,C37,12,Resign,White
TRUE,72,10+0,1756,1849,-93,C00,3,Resign,Black
TRUE,53,5+8,1839,1805,34,C31,5,Resign,White
TRUE,61,8+0,1812,1829,-17,C00,3,Resign,Black
TRUE,50,8+0,1841,1801,40,B21,3,Mate,Black
TRUE,73,8+0,1833,1752,81,C30,7,Out of Time,White
TRUE,85,8+4,2069,1837,232,C10,5,Mate,White
TRUE,69,10+0,1953,1844,109,C00,5,Mate,White
TRUE,43,5+8,1838,1979,-141,B10,2,Mate,White
TRUE,73,5+8,1976,1845,131,C00,3,Mate,White
TRUE,59,5+5,1835,1812,23,C00,3,Resign,White
TRUE,73,5+5,1826,1792,34,C36,7,Mate,White
TRUE,36,5+8,1835,1887,-52,C34,6,Mate,Black
TRUE,99,10+0,2121,1838,283,A40,2,Resign,White
TRUE,78,10+0,1752,1830,-78,A00,1,Resign,Black
TRUE,67,5+5,1816,1841,-25,C00,3,Mate,White
TRUE,89,10+0,1837,1852,-15,A13,4,Mate,White
TRUE,87,8+2,1844,1769,75,B01,4,Out of Time,White
TRUE,111,10+0,1926,1852,74,C02,5,Mate,White
TRUE,66,8+0,1791,1843,-52,A00,1,Mate,Black
TRUE,71,5+5,2093,1854,239,B01,6,Resign,White
TRUE,72,11+1,1619,2145,-526,A45,2,Resign,Black
TRUE,60,10+0,1497,2129,-632,C48,8,Mate,Black
TRUE,58,10+0,2096,1901,195,B13,5,Out of Time,Black
TRUE,68,10+0,1920,2087,-167,D02,5,Resign,Black
TRUE,54,5+8,2004,2073,-69,C47,8,Mate,Black
TRUE,113,10+0,2084,2066,18,B70,10,Mate,White
TRUE,149,5+5,2074,1908,166,C41,4,Resign,White
TRUE,64,5+5,1788,2067,-279,B02,5,Mate,Black
TRUE,59,5+5,2060,1792,268,B12,7,Resign,White
TRUE,74,2+10,1819,2052,-233,B03,6,Resign,Black
TRUE,47,10+0,2047,1710,337,B05,8,Resign,White
TRUE,117,10+5,2136,2062,74,D02,4,Mate,White
TRUE,30,5+7,2081,2096,-15,B30,4,Out of Time,Black
TRUE,59,25+0,2063,2027,36,B06,4,Out of Time,White
TRUE,117,5+21,2048,1924,124,C44,6,Resign,White
FALSE,31,19+4,1804,1997,-193,C47,9,Resign,White
TRUE,55,10+0,2051,2072,-21,C70,6,Resign,White
TRUE,67,5+21,2057,1923,134,C44,6,Resign,White
TRUE,82,5+21,1922,2040,-118,C50,9,Resign,Black
TRUE,144,30+1,2063,2038,25,C70,8,Draw,Draw
TRUE,53,30+1,2003,2078,-75,C44,5,Resign,White
TRUE,52,5+10,1996,1618,378,C44,5,Resign,White
TRUE,138,6+8,1804,2013,-209,D00,4,Draw,Draw
TRUE,46,10+4,1834,1994,-160,C70,8,Resign,Black
TRUE,85,9+0,1867,1968,-101,C50,11,Resign,Black
TRUE,43,15+10,1653,1711,-58,B06,4,Resign,White
TRUE,85,10+5,1663,1706,-43,C62,6,Resign,Black
TRUE,49,15+5,1692,1674,18,C00,3,Resign,White
TRUE,91,8+10,1709,1685,24,D31,6,Mate,White
TRUE,69,15+0,1631,1698,-67,C00,3,Mate,White
TRUE,87,8+10,1708,1772,-64,A40,4,Resign,Black
TRUE,114,8+10,1724,1545,179,D20,5,Resign,Black
TRUE,56,8+10,1723,1713,10,C00,3,Resign,Black
TRUE,34,15+8,1642,1703,-61,D00,2,Mate,Black
TRUE,49,8+10,1689,1770,-81,D11,5,Mate,White
TRUE,59,10+10,1763,1698,65,A20,2,Resign,White
TRUE,86,17+17,1693,1477,216,C41,5,Resign,White
TRUE,85,8+5,1664,1706,-42,C02,8,Resign,White
TRUE,70,10+5,1500,1701,-201,C00,3,Mate,Black
TRUE,38,8+10,1704,1689,15,D10,4,Mate,Black
TRUE,46,15+15,1680,1677,3,D00,2,Resign,Black
TRUE,51,10+5,1757,1687,70,A01,4,Resign,White
TRUE,74,5+8,1666,1675,-9,D00,3,Resign,Black
TRUE,113,7+5,1663,1667,-4,C55,6,Resign,White
TRUE,13,10+5,1651,1641,10,B21,5,Out of Time,White
TRUE,46,10+5,1654,1638,16,C00,3,Mate,Black
TRUE,29,10+5,1680,1623,57,C01,5,Resign,Black
TRUE,59,15+9,1610,1617,-7,C02,7,Resign,White
TRUE,79,10+15,1754,1618,136,C02,6,Resign,White
TRUE,78,10+15,1713,1602,111,C00,2,Mate,Black
TRUE,36,15+10,1795,1581,214,C00,3,Mate,Black
TRUE,39,10+5,1658,1565,93,C01,5,Resign,Black
TRUE,79,15+10,1721,1573,148,D32,9,Resign,White
TRUE,73,15+15,1557,1614,-57,C38,9,Resign,White
TRUE,34,15+10,1423,1500,-77,C45,8,Resign,Black
TRUE,66,10+10,1566,1694,-128,C55,6,Resign,Black
FALSE,22,25+0,1432,1493,-61,C68,7,Mate,Black
TRUE,39,15+1,1656,1577,79,D00,2,Resign,White
TRUE,25,10+10,1557,1713,-156,B01,6,Resign,White
TRUE,51,7+8,1686,1567,119,C41,5,Resign,White
TRUE,95,5+8,1606,1579,27,C00,3,Resign,White
TRUE,45,10+10,1519,1597,-78,C20,3,Resign,White
TRUE,102,10+0,1619,1452,167,B00,2,Resign,Black
TRUE,35,10+10,1610,1500,110,C42,6,Mate,White
TRUE,33,8+5,1612,1626,-14,C02,9,Resign,White
TRUE,56,10+15,1633,1610,23,C00,3,Mate,Black
TRUE,117,10+15,1595,1583,12,C60,5,Mate,White
TRUE,63,10+5,1696,1607,89,C02,9,Mate,White
TRUE,62,10+5,1743,1586,157,C00,3,Resign,Black
TRUE,66,10+15,1630,1584,46,C00,3,Draw,Draw
TRUE,50,10+15,1609,1564,45,C02,7,Resign,Black
TRUE,113,15+0,1508,1586,-78,D00,3,Resign,White
TRUE,97,10+15,1573,1465,108,C40,4,Mate,White
FALSE,132,5+5,1459,1494,-35,B50,4,Resign,Black
TRUE,24,20+1,1061,1133,-72,C20,3,Out of Time,Black
TRUE,82,5+5,1210,1151,59,A40,3,Out of Time,Black
TRUE,13,10+0,1812,1797,15,C30,4,Mate,White
TRUE,66,15+60,1628,1581,47,C50,8,Resign,Black
TRUE,99,15+60,1577,1571,6,B01,4,Resign,White
TRUE,54,15+60,1638,1497,141,C01,5,Mate,Black
TRUE,46,15+60,1605,1403,202,C50,6,Resign,White
TRUE,90,15+60,1705,1348,357,A10,2,Resign,Black
TRUE,42,15+60,1691,1335,356,B01,4,Resign,White
TRUE,58,15+60,1253,1679,-426,B20,2,Resign,Black
TRUE,53,15+60,1238,1811,-573,B54,6,Mate,White
TRUE,47,15+60,1806,1199,607,C41,5,Resign,White
TRUE,54,15+60,1200,1802,-602,B20,2,Mate,Black
TRUE,104,15+60,1258,1793,-535,B20,3,Mate,Black
FALSE,99,15+60,1706,1287,419,C50,8,Draw,Draw
TRUE,81,15+60,1782,1325,457,C46,7,Resign,White
TRUE,57,15+60,1770,1321,449,B01,4,Resign,White
TRUE,58,15+60,1387,1739,-352,D00,2,Mate,Black
TRUE,33,15+60,1697,1405,292,C41,5,Resign,White
TRUE,65,15+60,1687,1108,579,C00,4,Mate,White
TRUE,80,15+5,1200,1670,-470,D00,2,Resign,Black
FALSE,33,7+2,1624,1620,4,C21,9,Resign,White
FALSE,6,7+2,1325,1620,-295,C24,4,Resign,Black
FALSE,71,7+2,1677,1620,57,C50,9,Mate,White
TRUE,65,15+60,1595,1416,179,C00,3,Mate,White
TRUE,94,30+8,1292,1500,-208,A00,1,Mate,Black
TRUE,61,20+0,1439,1454,-15,D02,3,Mate,White
TRUE,95,30+3,1523,1469,54,C41,5,Mate,White
TRUE,59,10+0,1724,1721,3,C50,9,Resign,White
TRUE,47,10+0,1687,1763,-76,C51,10,Resign,White
TRUE,119,15+15,1732,1700,32,B32,6,Resign,White
TRUE,41,10+0,1746,1772,-26,C00,3,Resign,White
TRUE,81,10+0,1773,1768,5,C55,6,Draw,Draw
TRUE,116,10+0,1624,1741,-117,C20,3,Out of Time,Black
TRUE,99,10+0,1772,1537,235,C42,10,Draw,Draw
TRUE,77,10+0,1783,1841,-58,D20,5,Resign,White
TRUE,81,10+0,1811,1581,230,C50,5,Resign,White
TRUE,96,10+0,1733,1833,-100,B40,4,Draw,Draw
FALSE,10,10+0,1625,1833,-208,B00,2,Resign,White
TRUE,98,15+5,1460,1808,-348,B46,10,Out of Time,Black
TRUE,18,10+0,1679,1695,-16,A00,1,Resign,Black
TRUE,95,10+0,1500,1539,-39,C00,3,Resign,White
TRUE,32,15+3,1336,1275,61,A16,3,Mate,Black
TRUE,43,10+3,1295,1311,-16,D20,6,Resign,Black
TRUE,81,10+5,1325,1379,-54,D20,6,Resign,Black
TRUE,31,10+2,1302,1293,9,D21,6,Mate,White
TRUE,27,10+5,1431,1320,111,D07,6,Resign,White
TRUE,42,12+10,1333,1347,-14,B00,3,Resign,White
TRUE,46,10+5,1345,1340,5,C15,7,Resign,White
TRUE,124,10+10,1444,1300,144,B12,7,Mate,Black
TRUE,46,10+10,1331,1374,-43,A40,2,Out of Time,Black
TRUE,85,5+8,1387,1368,19,B10,2,Resign,White
TRUE,39,10+5,1419,1425,-6,D02,4,Mate,White
TRUE,38,10+5,1263,1387,-124,D02,4,Out of Time,Black
TRUE,53,10+5,1433,1458,-25,B12,5,Resign,White
TRUE,63,10+5,1372,1393,-21,D11,5,Resign,White
TRUE,37,10+5,1332,1081,251,C13,8,Resign,White
TRUE,114,10+5,1309,1375,-66,D20,5,Draw,Draw
TRUE,52,15+5,2175,2208,-33,E56,14,Resign,Black
FALSE,7,15+10,2208,1500,708,C55,6,Draw,Draw
FALSE,56,20+0,2208,2526,-318,C63,10,Draw,Draw
TRUE,62,10+0,1348,2208,-860,A45,2,Mate,Black
TRUE,69,10+0,2207,1634,573,C41,7,Resign,White
TRUE,189,10+0,2206,1723,483,E80,9,Out of Time,White
TRUE,64,10+0,1725,2204,-479,B90,11,Resign,Black
TRUE,77,10+0,2201,1849,352,A04,3,Resign,White
TRUE,29,10+0,2192,2063,129,B07,6,Resign,White
TRUE,86,10+0,1902,2188,-286,B90,10,Resign,Black
TRUE,78,10+0,1620,2187,-567,B10,2,Mate,Black
TRUE,22,10+0,2189,2123,66,B13,11,Draw,Draw
TRUE,117,15+0,2182,1999,183,B01,8,Resign,White
TRUE,168,10+0,2188,2168,20,C88,15,Resign,Black
TRUE,27,10+0,1823,1600,223,C41,5,Resign,White
TRUE,66,10+0,1909,1639,270,A46,3,Mate,Black
TRUE,61,10+0,1853,1923,-70,A00,1,Out of Time,White
TRUE,69,10+0,2121,1929,192,B43,9,Resign,White
TRUE,74,10+0,1935,2124,-189,E11,7,Out of Time,Black
TRUE,94,10+0,1916,1924,-8,B40,5,Mate,Black
TRUE,75,10+0,1916,1791,125,A41,4,Resign,White
TRUE,92,10+0,1931,1749,182,A84,3,Out of Time,Black
TRUE,76,10+0,1643,1927,-284,A00,1,Mate,Black
TRUE,58,10+0,1801,1943,-142,B42,9,Resign,White
TRUE,119,10+0,1942,1466,476,D44,8,Mate,White
TRUE,70,10+0,1957,1820,137,E15,7,Resign,Black
TRUE,121,10+0,1933,1970,-37,A49,4,Out of Time,White
TRUE,75,10+0,2016,1980,36,A15,2,Resign,White
TRUE,109,10+0,1969,1971,-2,D11,6,Mate,White
TRUE,87,10+0,2168,1975,193,B09,11,Resign,White
TRUE,77,10+0,1968,1817,151,A00,2,Resign,White
TRUE,87,10+0,1961,1805,156,D78,12,Out of Time,White
TRUE,91,10+0,1746,1979,-233,B40,5,Mate,White
TRUE,50,10+0,1878,1971,-93,B41,8,Mate,Black
TRUE,29,10+0,2086,1979,107,B24,8,Mate,White
TRUE,117,10+0,1992,1941,51,E60,5,Resign,Black
TRUE,47,10+0,1981,1977,4,D30,4,Resign,White
TRUE,150,10+0,1880,1972,-92,A45,2,Resign,Black
TRUE,10,10+0,1971,1244,727,D15,7,Resign,White
TRUE,108,10+0,1452,1970,-518,B21,3,Resign,Black
TRUE,42,10+0,1976,2152,-176,A49,5,Resign,Black
TRUE,87,10+0,1970,1785,185,C01,5,Mate,White
TRUE,69,10+0,2107,1978,129,B20,3,Out of Time,White
TRUE,94,10+0,1981,2303,-322,A49,5,Resign,Black
TRUE,56,10+0,1941,1971,-30,B40,4,Resign,Black
TRUE,47,10+0,1953,2149,-196,E10,12,Resign,White
TRUE,113,10+0,2287,1956,331,B21,10,Out of Time,White
TRUE,71,10+0,1929,1876,53,B01,6,Resign,White
TRUE,68,15+15,1892,1761,131,D03,5,Resign,Black
TRUE,28,10+0,1898,2055,-157,A13,6,Resign,Black
TRUE,93,15+15,1886,1906,-20,A15,3,Resign,White
TRUE,56,10+0,1768,1878,-110,A34,5,Resign,Black
TRUE,31,10+0,1696,1896,-200,B01,6,Resign,White
TRUE,89,10+0,2160,1888,272,B01,6,Draw,Draw
TRUE,71,10+0,1881,1737,144,A04,2,Resign,White
TRUE,64,10+0,1888,1875,13,A12,5,Resign,Black
TRUE,64,10+0,1886,1876,10,A03,2,Resign,Black
TRUE,59,10+0,1777,1867,-90,D15,7,Resign,White
TRUE,63,10+0,1626,1862,-236,A01,2,Resign,Black
TRUE,69,10+0,1844,2056,-212,D60,13,Mate,White
TRUE,45,10+0,1810,1700,110,C53,9,Resign,Black
FALSE,25,10+0,2277,1810,467,E81,10,Resign,White
TRUE,104,7+2,1389,1307,82,C20,5,Mate,Black
FALSE,33,10+0,1678,1299,379,C21,10,Resign,White
TRUE,64,10+5,1152,1299,-147,C20,3,Mate,Black
TRUE,62,10+0,1303,1634,-331,C60,6,Out of Time,Black
TRUE,47,10+0,1278,1530,-252,C60,6,Mate,White
TRUE,30,10+0,1595,1281,314,C22,6,Resign,White
TRUE,24,10+0,1267,1344,-77,C68,8,Resign,White
TRUE,20,45+1,1332,1277,55,C50,8,Resign,White
FALSE,66,30+0,1213,1277,-64,C50,8,Resign,Black
FALSE,12,120+10,1277,1047,230,C40,3,Out of Time,Black
FALSE,63,120+10,1047,1277,-230,D00,3,Resign,Black
TRUE,82,30+0,1393,1285,108,D00,3,Resign,White
TRUE,87,30+0,1279,1090,189,B02,2,Resign,White
TRUE,19,8+0,1268,1255,13,C40,4,Resign,White
TRUE,59,15+10,1186,1283,-97,C20,3,Mate,White
FALSE,124,8+0,1283,1267,16,B30,5,Mate,Black
TRUE,96,10+4,1290,1270,20,A00,1,Resign,Black
TRUE,53,12+0,1331,1281,50,D00,4,Out of Time,White
TRUE,39,10+0,1304,1292,12,A00,1,Mate,White
TRUE,10,10+0,1305,1293,12,C00,3,Mate,Black
TRUE,51,10+0,1308,1317,-9,C22,8,Mate,White
TRUE,18,15+0,1296,1305,-9,C54,13,Resign,Black
FALSE,106,30+0,968,1305,-337,C50,8,Mate,Black
FALSE,38,15+15,1293,1466,-173,C41,5,Mate,Black
TRUE,59,7+2,1500,1299,201,C68,7,Mate,White
TRUE,111,7+2,1288,1232,56,B12,3,Mate,White
TRUE,28,7+2,1289,2108,-819,C77,9,Resign,Black
FALSE,101,7+2,1431,1289,142,C22,6,Out of Time,White
FALSE,15,7+2,1806,1289,517,C45,7,Mate,White
FALSE,42,7+2,1289,1311,-22,C41,5,Resign,White
FALSE,118,7+2,1431,1289,142,A40,3,Resign,Black
FALSE,34,7+2,1289,1484,-195,C50,6,Resign,Black
FALSE,60,7+2,1289,1810,-521,A42,5,Resign,Black
FALSE,66,7+2,1806,1289,517,C44,5,Resign,Black
FALSE,21,5+8,1289,1500,-211,C41,5,Out of Time,White
TRUE,73,15+1,1409,1297,112,C70,8,Mate,White
TRUE,159,15+1,1280,1485,-205,C55,6,Mate,White
FALSE,74,15+0,1280,1211,69,B01,4,Resign,White
FALSE,28,15+0,1211,1280,-69,A00,3,Mate,Black
TRUE,112,10+0,1281,1765,-484,C41,6,Mate,Black
TRUE,31,10+0,1893,1899,-6,B02,5,Resign,White
TRUE,63,10+0,1743,1910,-167,B50,4,Resign,White
TRUE,111,10+0,1990,1901,89,B40,4,Resign,Black
TRUE,42,10+0,1912,1958,-46,B80,13,Resign,Black
TRUE,39,10+0,1947,1923,24,B77,17,Resign,White
TRUE,121,10+0,1919,1640,279,C11,7,Resign,White
TRUE,12,10+0,1681,1914,-233,B50,4,Resign,Black
TRUE,47,10+0,1904,1841,63,B00,2,Mate,White
TRUE,15,10+0,1903,1183,720,C46,7,Resign,White
FALSE,115,5+5,1015,1818,-803,B23,4,Mate,White
TRUE,97,5+5,1818,1015,803,B50,4,Resign,White
FALSE,54,5+5,1015,1779,-764,D20,6,Resign,Black
FALSE,70,5+5,1779,1015,764,D10,5,Resign,Black
TRUE,31,5+5,1015,1779,-764,B01,4,Resign,Black
TRUE,60,10+0,1682,1015,667,D43,8,Mate,Black
FALSE,97,5+5,2305,1015,1290,B52,6,Resign,White
TRUE,22,5+5,1015,2305,-1290,B09,11,Resign,Black
TRUE,69,10+0,972,1484,-512,B23,3,Resign,White
TRUE,101,10+0,928,1442,-514,C01,5,Mate,White
TRUE,57,10+0,884,1415,-531,B00,2,Resign,White
TRUE,76,10+0,1187,845,342,B20,3,Mate,Black
TRUE,120,10+0,1450,789,661,B21,3,Resign,Black
TRUE,2,10+0,784,1006,-222,C20,2,Resign,Black
TRUE,2,10+0,827,806,21,B01,2,Resign,White
TRUE,2,10+0,1025,818,207,B01,2,Resign,White
TRUE,2,10+0,1027,831,196,B01,2,Resign,White
TRUE,2,15+0,837,1216,-379,C20,2,Resign,Black
TRUE,2,15+0,844,1214,-370,C20,2,Resign,Black
FALSE,2,15+0,844,1500,-656,C20,2,Resign,Black
FALSE,2,15+0,1500,844,656,B01,2,Resign,White
FALSE,2,15+0,844,1500,-656,C20,2,Resign,Black
TRUE,2,5+8,1454,845,609,B01,2,Resign,White
FALSE,2,10+0,1500,845,655,B01,2,Resign,White
TRUE,2,10+0,856,1121,-265,B02,2,Resign,Black
TRUE,2,10+0,889,850,39,C20,2,Resign,Black
TRUE,3,10+0,833,930,-97,A40,2,Resign,White
TRUE,2,10+0,955,965,-10,B01,2,Resign,White
TRUE,2,10+0,1004,999,5,B20,2,Resign,Black
TRUE,2,10+0,1042,1083,-41,C20,2,Resign,Black
TRUE,2,10+0,1245,1069,176,B20,2,Resign,White
TRUE,3,10+0,1121,1123,-2,B20,3,Resign,White
TRUE,3,10+0,1184,1187,-3,C00,3,Resign,White
TRUE,2,10+0,1253,1300,-47,C20,2,Resign,Black
TRUE,3,15+0,1418,1271,147,C40,3,Resign,White
TRUE,3,3+9,1405,1500,-95,D02,3,Resign,White
FALSE,66,5+5,1500,2305,-805,C32,6,Draw,Draw
TRUE,65,10+0,1508,1443,65,D00,3,Out of Time,White
TRUE,57,10+0,1158,1155,3,C41,7,Mate,White
TRUE,100,10+0,1158,1158,0,D00,3,Draw,Draw
FALSE,23,10+1,1158,1324,-166,C45,8,Resign,White
FALSE,31,0+180,1158,1324,-166,C45,8,Resign,Black
FALSE,7,0+180,1324,1158,166,C42,5,Resign,White
FALSE,6,0+180,1158,1324,-166,C44,5,Resign,Black
TRUE,26,10+0,1101,1148,-47,C22,7,Resign,Black
TRUE,16,10+0,1159,1165,-6,B57,8,Resign,Black
TRUE,14,10+0,1166,1295,-129,C41,8,Resign,Black
TRUE,78,10+0,1227,1164,63,C42,4,Draw,Draw
TRUE,4,10+0,1500,1168,332,C26,4,Resign,White
TRUE,85,10+0,1157,1156,1,B00,4,Resign,White
TRUE,7,10+0,1156,1157,-1,C20,3,Draw,Draw
TRUE,44,10+0,984,1151,-167,C26,4,Resign,Black
TRUE,61,10+0,1141,1127,14,C42,6,Mate,White
TRUE,47,10+0,1150,1223,-73,C41,7,Resign,Black
TRUE,27,10+0,1127,1166,-39,C40,4,Out of Time,White
TRUE,36,10+0,1177,1137,40,C42,5,Resign,White
TRUE,92,10+0,1155,1125,30,C42,4,Resign,Black
TRUE,36,8+0,1890,1838,52,D30,4,Resign,Black
TRUE,42,8+0,1905,2026,-121,A44,4,Resign,Black
TRUE,102,15+5,1678,1714,-36,C57,10,Resign,Black
TRUE,88,15+0,1702,1704,-2,A20,3,Mate,Black
TRUE,112,15+0,1713,1743,-30,D20,5,Out of Time,Black
TRUE,39,10+5,1703,1711,-8,D32,8,Resign,White
TRUE,63,10+5,1699,1713,-14,C55,6,Mate,White
TRUE,35,15+8,1702,1728,-26,D10,5,Resign,White
TRUE,43,20+0,1642,1685,-43,C50,8,Resign,Black
TRUE,120,15+0,1695,1679,16,D07,4,Mate,Black
TRUE,71,5+5,1700,1706,-6,D00,2,Mate,White
TRUE,90,20+15,1716,1722,-6,E76,9,Resign,Black
TRUE,29,20+0,1703,1771,-68,D85,8,Resign,White
TRUE,87,20+3,1740,1713,27,D02,4,Mate,White
TRUE,52,12+8,1721,1702,19,E20,8,Resign,Black
TRUE,53,10+8,1692,1674,18,E20,8,Mate,White
TRUE,83,11+5,1683,1628,55,A40,2,Resign,White
TRUE,67,11+5,1639,1674,-35,A00,1,Resign,Black
TRUE,94,20+0,1683,1734,-51,A50,3,Mate,Black
TRUE,137,15+0,1647,1695,-48,C70,8,Out of Time,White
TRUE,56,15+15,1582,1687,-105,C50,9,Resign,Black
TRUE,35,15+9,1680,1577,103,C00,3,Resign,White
TRUE,84,10+0,1690,1700,-10,A40,2,Mate,Black
TRUE,37,15+5,1744,1699,45,C55,8,Mate,White
TRUE,120,15+5,1708,1733,-25,A52,7,Mate,Black
TRUE,77,20+0,1702,1719,-17,A00,3,Mate,White
TRUE,91,15+12,1709,1722,-13,E20,6,Mate,White
TRUE,81,15+6,1768,1717,51,C70,8,Out of Time,White
TRUE,114,10+10,1730,1660,70,D06,4,Mate,Black
TRUE,38,10+5,1746,1719,27,C20,4,Out of Time,Black
TRUE,106,10+3,1730,1694,36,B30,4,Mate,Black
TRUE,58,10+3,1704,1720,-16,C55,6,Resign,Black
TRUE,111,15+5,1720,1720,0,C20,3,Mate,White
TRUE,59,15+0,1709,1725,-16,C51,7,Resign,White
TRUE,46,15+0,1736,1697,39,C24,4,Mate,Black
TRUE,122,15+0,1696,1738,-42,D31,5,Draw,Draw
TRUE,39,15+0,1728,1706,22,C42,5,Mate,White
TRUE,77,15+0,1694,1740,-46,D31,5,Mate,White
TRUE,99,15+0,1730,1704,26,C24,4,Resign,White
TRUE,102,15+0,1714,1720,-6,D31,5,Out of Time,Black
TRUE,112,15+0,1725,1694,31,A40,2,Mate,Black
TRUE,38,10+5,1735,1760,-25,A40,2,Out of Time,Black
FALSE,96,8+0,2384,2199,185,B40,4,Out of Time,Black
TRUE,63,10+0,2212,2231,-19,B20,3,Resign,White
TRUE,349,10+0,2194,2240,-46,D30,13,Out of Time,White
TRUE,157,10+0,2162,2122,40,D31,7,Resign,White
TRUE,23,10+0,2426,2178,248,C50,9,Resign,White
TRUE,64,10+0,2196,2420,-224,D35,10,Resign,Black
TRUE,46,10+0,2413,2219,194,E51,10,Resign,White
TRUE,67,10+0,2247,2405,-158,D35,10,Resign,Black
FALSE,102,10+15,1559,1676,-117,B50,4,Resign,Black
FALSE,48,10+5,1357,1676,-319,B50,4,Resign,Black
TRUE,43,15+0,1658,1309,349,C40,4,Resign,White
FALSE,100,15+15,1658,1573,85,C07,7,Resign,Black
FALSE,130,5+8,1500,1658,-158,B50,4,Draw,Draw
FALSE,65,15+0,1978,1658,320,D30,4,Resign,White
FALSE,3,5+5,1658,1240,418,C40,3,Out of Time,White
FALSE,41,15+0,1705,1658,47,B50,5,Draw,Draw
FALSE,36,15+0,1658,1500,158,C60,5,Resign,White
FALSE,82,15+0,1500,1658,-158,B50,4,Out of Time,Black
FALSE,13,15+0,1658,1500,158,C41,4,Resign,White
FALSE,52,10+9,1403,1658,-255,A00,1,Resign,Black
FALSE,39,10+9,1658,1403,255,B00,2,Mate,White
FALSE,71,10+0,1658,1531,127,C50,9,Resign,Black
TRUE,106,15+0,1512,1596,-84,B23,3,Mate,Black
TRUE,90,15+0,1715,1660,55,C57,8,Resign,Black
TRUE,30,15+0,1345,1676,-331,D00,4,Resign,Black
TRUE,111,10+0,1500,1503,-3,C62,6,Mate,White
FALSE,32,15+0,1503,1500,3,B20,3,Resign,Black
TRUE,71,10+0,1875,1433,442,A00,2,Resign,White
FALSE,40,15+0,1523,1985,-462,A11,2,Resign,Black
FALSE,97,30+10,1774,1863,-89,B01,6,Resign,White
FALSE,117,30+10,1774,1250,524,C00,3,Draw,Draw
TRUE,62,8+1,1507,1770,-263,C50,9,Resign,Black
FALSE,14,10+25,2621,1770,851,C57,11,Resign,White
FALSE,101,10+10,1770,1447,323,D02,4,Mate,White
FALSE,69,10+10,1770,1494,276,A04,2,Mate,White
FALSE,55,10+10,1770,1832,-62,C50,9,Resign,White
FALSE,32,10+10,1770,1824,-54,D02,4,Resign,Black
FALSE,3,10+10,1250,1770,-520,B02,3,Resign,Black
FALSE,26,10+10,1076,1770,-694,C24,5,Resign,Black
FALSE,17,10+10,1770,1625,145,C50,9,Resign,White
FALSE,47,10+10,1440,1770,-330,C78,10,Mate,White
FALSE,85,10+10,1500,1770,-270,B56,10,Mate,White
FALSE,72,15+5,1770,1950,-180,A40,3,Resign,Black
TRUE,27,10+10,2273,2134,139,E97,14,Draw,Draw
FALSE,86,30+30,2452,1500,952,A08,4,Draw,Draw
FALSE,52,10+15,1500,2621,-1121,E60,5,Out of Time,Black
FALSE,97,15+15,1500,1500,0,A01,2,Draw,Draw
FALSE,52,10+5,1500,2209,-709,A06,2,Resign,Black
FALSE,63,10+0,2522,1500,1022,E20,6,Out of Time,White
FALSE,86,10+20,1500,2621,-1121,A01,2,Resign,Black
FALSE,143,5+15,2621,1500,1121,E11,8,Resign,White
FALSE,76,150+0,1500,1500,0,A03,2,Mate,Black
FALSE,82,20+20,1907,1500,407,D44,8,Mate,Black
FALSE,50,5+5,2438,1907,531,D12,8,Out of Time,Black
TRUE,28,15+15,1868,1886,-18,D15,7,Resign,Black
TRUE,135,15+15,1876,1648,228,D11,5,Mate,White
FALSE,105,20+20,1500,1876,-376,D10,5,Resign,White
FALSE,33,10+0,1500,1876,-376,C50,6,Resign,White
FALSE,11,10+0,1865,1562,303,B21,3,Resign,White
FALSE,80,5+20,1685,1562,123,A01,2,Draw,Draw
FALSE,51,10+5,1579,1562,17,B57,8,Resign,White
FALSE,54,15+0,1637,1562,75,B20,3,Resign,Black
FALSE,16,10+0,1562,1657,-95,B40,6,Resign,Black
FALSE,17,15+0,1703,1562,141,C57,9,Resign,White
FALSE,74,25+5,2231,1562,669,C44,6,Mate,Black
FALSE,119,10+0,1949,1562,387,C24,7,Draw,Draw
FALSE,11,10+0,1562,1682,-120,C50,6,Resign,Black
FALSE,127,13+3,1562,2207,-645,C50,5,Draw,Draw
FALSE,51,13+3,2207,1562,645,C22,7,Resign,White
FALSE,42,13+3,1562,2207,-645,A45,2,Resign,Black
FALSE,63,13+3,2207,1562,645,B06,6,Resign,White
FALSE,48,13+3,1562,2207,-645,E00,1,Resign,Black
FALSE,28,13+3,2207,1562,645,B20,3,Resign,White
FALSE,56,13+3,1562,2207,-645,A01,1,Resign,Black
FALSE,23,13+3,2207,1562,645,B20,3,Resign,White
FALSE,48,13+3,1562,2207,-645,E00,1,Resign,Black
FALSE,57,13+3,2207,1562,645,B90,11,Resign,White
FALSE,44,5+5,1562,1934,-372,E67,12,Resign,Black
FALSE,33,5+5,1934,1562,372,B90,11,Resign,White
FALSE,61,15+2,2210,1562,648,B06,6,Resign,White
FALSE,54,15+2,1562,2210,-648,A01,2,Mate,Black
FALSE,15,10+10,1708,1562,146,C57,9,Resign,White
FALSE,16,10+10,1562,1708,-146,A04,3,Resign,White
FALSE,57,8+0,1562,1784,-222,E00,1,Resign,White
FALSE,105,15+2,1562,2210,-648,A01,2,Resign,Black
FALSE,23,15+2,2210,1562,648,C47,9,Resign,White
FALSE,53,15+2,1562,2210,-648,A01,2,Resign,Black
FALSE,25,15+2,2210,1562,648,C22,7,Resign,White
FALSE,22,15+0,1539,1562,-23,C68,14,Resign,Black
FALSE,34,10+2,1562,2210,-648,A04,3,Mate,Black
FALSE,36,10+2,2210,1562,648,C33,5,Resign,White
FALSE,86,10+2,1562,2210,-648,A04,3,Resign,Black
FALSE,91,10+2,2210,1562,648,C46,5,Resign,White
FALSE,88,30+0,1710,1562,148,B86,11,Resign,Black
FALSE,38,15+0,1562,2314,-752,A01,2,Resign,Black
FALSE,67,15+0,2291,1562,729,B00,5,Resign,White
FALSE,52,15+0,1562,2291,-729,A01,2,Resign,Black
FALSE,29,15+0,2291,1562,729,C46,5,Resign,White
FALSE,62,15+0,1562,2291,-729,A01,3,Resign,Black
TRUE,142,25+0,1634,1334,300,C24,4,Resign,Black
TRUE,23,10+5,1522,1486,36,C53,9,Resign,White
TRUE,128,10+0,1495,1495,0,A04,2,Resign,Black
TRUE,130,15+0,1473,1484,-11,B07,5,Out of Time,Black
FALSE,119,8+3,1484,1500,-16,D02,4,Out of Time,White
FALSE,49,8+3,1484,1500,-16,A00,1,Mate,White
TRUE,129,10+0,1408,1487,-79,C02,7,Draw,Draw
TRUE,69,10+0,1469,1498,-29,A00,1,Mate,White
TRUE,67,10+0,1486,1538,-52,D00,3,Mate,White
FALSE,35,5+8,1618,1486,132,A45,2,Resign,White
FALSE,49,8+3,1500,1486,14,C40,4,Mate,White
TRUE,107,10+2,1373,1489,-116,B54,6,Draw,Draw
TRUE,14,10+8,1509,1478,31,B50,4,Resign,Black
TRUE,38,10+0,1468,1489,-21,D31,6,Resign,Black
TRUE,29,10+0,1479,1478,1,B32,6,Resign,White
TRUE,128,10+0,1470,1468,2,D31,5,Mate,Black
TRUE,52,10+0,1478,1468,10,C00,3,Mate,Black
TRUE,36,10+0,1457,1490,-33,D00,3,Resign,White
TRUE,63,10+0,1480,1467,13,C55,6,Resign,White
TRUE,137,10+0,1479,1497,-18,B01,4,Resign,White
TRUE,54,10+0,1487,1599,-112,C45,8,Resign,Black
TRUE,32,10+0,1496,1532,-36,C45,10,Resign,Black
TRUE,55,10+0,1500,1504,-4,A06,3,Resign,White
TRUE,90,10+0,1512,1581,-69,C45,8,Mate,Black
TRUE,53,10+0,1571,1521,50,C41,8,Resign,White
TRUE,64,10+0,1506,1511,-5,A00,1,Mate,Black
TRUE,37,10+0,1504,1522,-18,D02,4,Resign,White
TRUE,45,10+0,1594,1530,64,D00,3,Resign,White
TRUE,92,10+0,1540,1558,-18,B50,4,Mate,Black
TRUE,66,10+0,1440,1532,-92,D30,4,Out of Time,Black
TRUE,22,10+0,1655,1540,115,C41,5,Resign,White
TRUE,81,10+0,1528,1574,-46,B01,6,Out of Time,White
TRUE,155,10+0,1528,1530,-2,C24,4,Draw,Draw
TRUE,51,10+0,1519,1539,-20,C41,6,Mate,White
TRUE,68,10+0,1550,1556,-6,C41,5,Resign,Black
TRUE,64,10+0,1509,1550,-41,B01,4,Resign,White
TRUE,48,10+0,1561,1553,8,C40,3,Resign,Black
TRUE,72,10+0,1571,1574,-3,B10,2,Resign,Black
TRUE,107,10+0,1561,1570,-9,C00,3,Resign,White
TRUE,65,10+0,1559,1572,-13,A00,1,Mate,White
TRUE,104,10+0,1560,1578,-18,C00,3,Resign,White
TRUE,66,10+0,1571,1564,7,C44,5,Resign,Black
TRUE,127,10+0,1552,1583,-31,A00,1,Resign,White
TRUE,88,10+0,1595,1536,59,C50,6,Resign,Black
TRUE,42,10+0,1603,1584,19,D00,3,Resign,Black
TRUE,51,10+0,1583,1604,-21,B40,4,Draw,Draw
TRUE,95,10+0,1594,1594,0,C41,7,Resign,White
TRUE,59,10+0,1583,1584,-1,B40,4,Mate,White
FALSE,51,10+0,1500,1651,-151,C65,6,Resign,White
FALSE,46,5+8,1749,2119,-370,B12,5,Resign,Black
FALSE,21,5+8,2119,1991,128,C45,7,Out of Time,White
FALSE,58,5+8,1349,2119,-770,D12,8,Out of Time,Black
TRUE,38,10+0,846,2119,-1273,A04,2,Out of Time,Black
TRUE,72,10+0,2147,2113,34,C10,6,Mate,Black
TRUE,68,10+0,2044,2156,-112,D56,14,Draw,Draw
TRUE,132,10+0,2192,2103,89,B54,6,Mate,Black
TRUE,22,10+0,2178,1955,223,A05,4,Resign,White
TRUE,56,10+0,1928,2164,-236,E32,7,Resign,Black
TRUE,85,15+15,2203,2040,163,E15,8,Mate,White
TRUE,44,15+15,1833,2193,-360,E24,9,Resign,Black
TRUE,80,15+15,1980,2173,-193,D45,11,Out of Time,Black
TRUE,43,15+15,2147,2008,139,D87,16,Resign,White
TRUE,98,15+15,2104,2098,6,B19,15,Mate,Black
TRUE,43,15+15,2029,2117,-88,C48,7,Mate,White
TRUE,57,15+15,2120,2010,110,D43,8,Draw,Draw
TRUE,70,15+15,1706,1983,-277,D02,5,Mate,Black
TRUE,49,15+15,1906,1928,-22,C45,7,Resign,White
TRUE,107,15+15,1833,1719,114,A09,4,Resign,White
TRUE,52,15+15,1728,1662,66,B12,5,Mate,Black
TRUE,39,15+15,1500,1500,0,D45,10,Resign,White
FALSE,79,20+10,2438,1658,780,B41,9,Draw,Draw
FALSE,2,20+15,2411,1658,753,B20,2,Resign,White
TRUE,49,15+3,1792,1665,127,D04,5,Resign,White
TRUE,113,12+0,1731,1675,56,B22,3,Resign,White
TRUE,143,10+0,1663,1675,-12,B23,5,Out of Time,White
TRUE,100,15+8,1671,1771,-100,B10,5,Resign,Black
FALSE,166,30+0,1755,1671,84,A45,3,Mate,Black
FALSE,88,15+7,1671,1994,-323,C42,5,Resign,Black
TRUE,54,20+0,1548,1663,-115,B43,10,Resign,Black
FALSE,116,20+0,1353,1663,-310,C24,4,Mate,Black
TRUE,64,8+5,1348,1660,-312,C24,4,Resign,Black
FALSE,65,30+0,1755,1660,95,D00,2,Resign,White
FALSE,54,30+0,1660,1755,-95,B11,8,Resign,Black
FALSE,29,30+0,1755,1660,95,D00,2,Resign,White
TRUE,51,15+8,1643,1840,-197,B10,5,Out of Time,White
TRUE,125,15+1,1630,1705,-75,C41,8,Mate,White
TRUE,59,5+8,1942,1633,309,D11,7,Resign,White
FALSE,72,20+10,1633,1500,133,C69,9,Resign,Black
TRUE,45,5+7,1614,1911,-297,B01,8,Resign,White
FALSE,66,5+8,1788,1614,174,C02,11,Resign,Black
FALSE,101,20+0,1665,1614,51,A45,3,Mate,White
FALSE,1,10+25,2621,1614,1007,A40,1,Resign,White
TRUE,63,10+5,1647,1624,23,D02,5,Resign,White
TRUE,92,20+0,1649,1624,25,A45,3,Draw,Draw
FALSE,108,8+6,1938,1736,202,C92,17,Draw,Draw
FALSE,28,15+10,1264,1736,-472,D02,5,Resign,Black
TRUE,14,10+0,1737,1725,12,C45,7,Resign,Black
TRUE,40,20+5,1715,1711,4,B33,8,Resign,White
FALSE,4,15+10,1715,1263,452,B27,4,Resign,White
FALSE,161,15+10,1263,1715,-452,D02,4,Draw,Draw
FALSE,21,7+7,1715,1263,452,C10,6,Mate,White
FALSE,37,10+2,1715,1500,215,B27,4,Mate,White
TRUE,38,10+0,2020,1846,174,C21,6,Resign,Black
TRUE,75,10+0,2148,2028,120,E98,17,Resign,White
TRUE,108,10+0,2022,2016,6,E61,6,Mate,Black
TRUE,41,10+0,2014,1536,478,B01,6,Resign,White
TRUE,80,10+0,2027,1993,34,B30,4,Out of Time,Black
TRUE,65,10+0,1875,2045,-170,B23,3,Resign,White
TRUE,33,10+0,2041,1740,301,B50,4,Resign,White
TRUE,53,10+0,1741,2062,-321,B50,4,Resign,White
TRUE,84,10+0,2083,1762,321,B30,4,Mate,Black
TRUE,49,10+0,2082,1517,565,C21,9,Resign,White
TRUE,20,10+0,1369,2082,-713,A48,5,Resign,Black
TRUE,62,10+0,1243,2082,-839,B20,3,Resign,Black
TRUE,51,10+0,2080,2093,-13,B92,16,Resign,White
TRUE,53,20+15,2087,1909,178,C23,4,Resign,White
TRUE,33,20+15,2081,1906,175,B40,4,Resign,White
TRUE,92,15+15,1906,2075,-169,B20,3,Resign,Black
TRUE,27,15+15,2068,1912,156,C55,6,Mate,White
TRUE,31,15+10,1966,2083,-117,B21,10,Resign,White
TRUE,63,10+10,1948,2087,-139,E61,9,Draw,Draw
TRUE,89,15+10,2104,1903,201,B00,2,Resign,Black
TRUE,70,25+25,1903,2099,-196,A45,3,Resign,Black
TRUE,72,25+20,2016,2113,-97,B21,5,Resign,White
TRUE,72,25+20,2105,1989,116,C53,9,Resign,White
TRUE,64,25+25,2108,2028,80,B00,5,Draw,Draw
TRUE,41,25+25,2014,2122,-108,B86,11,Resign,White
TRUE,58,25+25,2115,1999,116,B23,5,Resign,White
TRUE,70,25+25,2130,1999,131,B00,2,Resign,Black
TRUE,33,25+25,2000,2146,-146,B20,3,Resign,White
TRUE,41,25+25,2138,2027,111,B13,5,Resign,White
TRUE,33,25+25,2234,2146,88,B93,11,Resign,White
TRUE,50,25+25,2059,2137,-78,B52,6,Resign,Black
TRUE,104,25+25,1982,2131,-149,A00,1,Mate,Black
TRUE,51,25+25,2025,2146,-121,B06,5,Resign,White
TRUE,37,25+25,1988,2139,-151,B22,3,Resign,Black
TRUE,48,25+25,1994,2132,-138,E90,11,Resign,Black
TRUE,118,25+25,2250,2116,134,B50,5,Resign,Black
TRUE,116,10+0,2135,1784,351,C53,9,Out of Time,Black
TRUE,96,10+0,1833,2131,-298,B50,4,Resign,Black
TRUE,53,25+25,2116,2229,-113,B84,14,Resign,White
TRUE,45,25+25,2002,2108,-106,B52,6,Resign,Black
TRUE,51,25+25,2096,2120,-24,C53,9,Resign,White
TRUE,25,10+0,2097,2108,-11,E24,9,Resign,White
TRUE,82,10+0,2121,2086,35,B13,5,Resign,Black
TRUE,68,10+0,1659,2119,-460,B50,4,Mate,Black
TRUE,37,10+0,2114,1867,247,C55,7,Resign,White
TRUE,73,10+0,2113,1578,535,B00,2,Mate,White
TRUE,64,10+0,1742,2111,-369,B86,11,Mate,Black
TRUE,79,10+0,2101,2043,58,B13,5,Mate,White
TRUE,83,10+0,2097,1826,271,C41,7,Mate,White
TRUE,54,10+0,2049,2088,-39,B94,11,Resign,Black
FALSE,2,45+0,1500,1233,267,B20,2,Resign,White
FALSE,25,5+14,1233,1664,-431,C45,7,Resign,Black
FALSE,22,10+5,1902,1233,669,B23,3,Resign,White
TRUE,73,10+0,1474,1621,-147,B20,3,Mate,White
TRUE,71,30+5,1613,1506,107,C44,5,Resign,White
FALSE,72,10+10,2621,1613,1008,C43,8,Resign,Black
TRUE,173,10+0,1449,1629,-180,B70,10,Mate,White
TRUE,67,10+0,1619,1614,5,C41,7,Resign,White
TRUE,57,15+10,1611,1501,110,C44,7,Out of Time,White
TRUE,154,15+10,1510,1603,-93,B72,11,Mate,Black
TRUE,99,10+0,1881,1607,274,B70,10,Mate,White
TRUE,87,10+0,1602,1607,-5,B20,3,Draw,Draw
TRUE,24,8+0,1500,1610,-110,B72,11,Draw,Draw
TRUE,103,10+0,1606,1557,49,B01,4,Mate,White
TRUE,38,10+0,1553,1607,-54,B50,4,Draw,Draw
TRUE,92,10+0,1620,1564,56,C40,4,Mate,Black
FALSE,85,10+25,2621,1600,1021,B78,20,Mate,White
TRUE,64,10+0,1610,1635,-25,B95,12,Mate,Black
TRUE,149,10+0,1644,1621,23,A00,1,Mate,White
TRUE,106,10+0,1634,1573,61,B13,5,Mate,Black
TRUE,77,10+0,1635,1599,36,C41,5,Draw,Draw
TRUE,48,10+0,1695,1645,50,B21,3,Mate,Black
TRUE,23,10+0,1553,1687,-134,C41,8,Resign,Black
TRUE,89,10+0,1694,1536,158,C26,5,Out of Time,White
TRUE,51,10+0,1699,1706,-7,D06,4,Mate,White
TRUE,76,10+0,1715,1796,-81,C26,5,Resign,Black
TRUE,56,10+0,1611,1706,-95,A06,3,Resign,Black
TRUE,60,10+0,1718,1727,-9,B11,4,Mate,Black
TRUE,62,10+0,1713,1706,7,D02,5,Resign,Black
TRUE,43,10+0,1559,1462,97,D02,4,Mate,White
TRUE,37,10+0,1355,2052,-697,C00,3,Resign,White
TRUE,49,15+0,1251,1500,-249,C65,7,Mate,White
FALSE,54,15+0,1500,1251,249,C57,8,Mate,Black
TRUE,39,10+0,1401,1354,47,B03,5,Resign,White
TRUE,114,10+0,1500,1566,-66,C68,9,Mate,Black
TRUE,173,10+0,1827,1941,-114,A01,4,Out of Time,White
TRUE,76,10+0,1944,1823,121,B12,5,Draw,Draw
TRUE,118,10+0,1828,1937,-109,A01,5,Resign,Black
TRUE,126,10+0,1917,1828,89,B18,11,Draw,Draw
TRUE,20,10+0,1840,1805,35,A01,5,Resign,Black
TRUE,53,10+0,1872,1849,23,B10,2,Resign,White
TRUE,63,10+0,1836,1942,-106,A01,2,Mate,White
TRUE,28,10+0,1934,1844,90,D06,4,Resign,White
TRUE,59,10+0,1855,1823,32,A01,2,Resign,Black
TRUE,49,10+0,1843,1893,-50,A01,3,Resign,White
TRUE,57,10+0,1832,1808,24,A01,1,Mate,White
TRUE,50,10+0,1896,1819,77,B00,3,Resign,Black
TRUE,55,10+0,1817,1838,-21,A01,5,Mate,White
TRUE,106,10+0,1825,1914,-89,A01,2,Mate,Black
TRUE,104,10+0,1904,1812,92,B11,6,Mate,Black
TRUE,93,10+0,1838,1822,16,B18,8,Resign,White
TRUE,62,10+0,1892,1809,83,B12,7,Resign,Black
TRUE,10,10+0,1817,1920,-103,A01,5,Resign,Black
TRUE,95,10+0,1985,1823,162,B10,2,Out of Time,White
TRUE,137,10+0,1902,1831,71,B12,7,Resign,White
TRUE,24,10+0,1840,1893,-53,A01,5,Resign,Black
TRUE,117,10+0,1830,1803,27,A01,1,Resign,White
TRUE,85,10+0,1820,1808,12,A01,3,Out of Time,White
TRUE,86,10+0,1819,1810,9,B12,5,Resign,Black
TRUE,60,10+0,1821,1799,22,B10,2,Resign,Black
TRUE,137,10+0,1787,1809,-22,A01,1,Out of Time,White
TRUE,105,10+0,1781,1798,-17,B13,5,Out of Time,White
TRUE,60,10+0,1810,1762,48,A01,5,Resign,Black
TRUE,108,10+0,1763,1811,-48,B12,7,Draw,Draw
FALSE,118,15+0,1748,2084,-336,C41,5,Resign,Black
FALSE,61,15+0,1748,1818,-70,B13,5,Resign,White
FALSE,129,15+0,1748,1818,-70,B13,5,Draw,Draw
FALSE,135,15+0,1732,1748,-16,A00,1,Out of Time,White
TRUE,151,15+0,1712,1797,-85,B07,5,Resign,White
TRUE,170,15+0,1746,1674,72,C44,4,Resign,Black
TRUE,46,15+0,1705,1737,-32,C41,7,Resign,Black
TRUE,164,15+0,1817,1693,124,A45,2,Draw,Draw
TRUE,93,15+0,1652,1648,4,C55,6,Resign,White
TRUE,8,15+0,1561,1556,5,C50,6,Resign,Black
TRUE,35,15+0,1594,1734,-140,C50,8,Resign,Black
TRUE,117,15+0,1562,1736,-174,C00,3,Draw,Draw
TRUE,13,15+0,1729,1620,109,A00,1,Resign,White
TRUE,28,15+0,1699,1788,-89,B13,5,Resign,Black
TRUE,29,15+0,1777,1887,-110,C55,7,Resign,White
TRUE,179,15+0,1500,1801,-301,C23,3,Mate,White
TRUE,52,10+0,2169,2166,3,A04,2,Resign,Black
TRUE,82,10+0,2166,2153,13,B00,4,Resign,Black
TRUE,85,10+0,2150,1784,366,B20,3,Resign,White
TRUE,64,10+0,2156,2137,19,C01,4,Resign,Black
TRUE,35,10+0,2125,2072,53,D00,4,Resign,White
TRUE,54,10+0,2211,2109,102,B06,7,Resign,Black
TRUE,49,10+0,2106,1725,381,A03,2,Resign,White
TRUE,129,10+0,2113,2120,-7,D00,2,Mate,White
TRUE,29,10+0,2100,2276,-176,E10,12,Resign,White
TRUE,67,10+0,2095,1831,264,A57,9,Resign,White
TRUE,64,10+0,1982,2085,-103,C53,9,Resign,Black
TRUE,120,10+0,1868,2079,-211,D34,16,Resign,Black
TRUE,43,10+0,2077,1509,568,D10,6,Mate,White
TRUE,30,10+0,1573,2076,-503,B07,6,Resign,Black
FALSE,136,7+2,1458,1407,51,E73,12,Resign,Black
TRUE,73,10+2,1357,1500,-143,A35,6,Draw,Draw
TRUE,40,9+2,1500,1576,-76,A22,4,Out of Time,Black
TRUE,44,8+0,1918,1888,30,D10,5,Resign,Black
TRUE,117,8+0,1874,1951,-77,C11,13,Resign,White
TRUE,38,8+0,1990,1859,131,D43,8,Resign,Black
TRUE,51,8+0,1841,2036,-195,C11,13,Mate,White
TRUE,81,8+3,2465,2041,424,E15,10,Out of Time,White
TRUE,64,15+15,2079,2032,47,E20,8,Resign,Black
TRUE,139,10+0,1990,2119,-129,C00,5,Resign,White
TRUE,83,8+0,2125,2115,10,C00,3,Resign,White
TRUE,46,5+5,2163,2198,-35,E32,7,Resign,Black
TRUE,74,15+2,2240,2074,166,C05,12,Resign,Black
TRUE,90,5+5,2111,2299,-188,E97,14,Mate,Black
TRUE,62,8+0,2082,1796,286,D31,6,Resign,White
TRUE,32,5+8,2049,1960,89,C00,5,Resign,Black
TRUE,70,15+0,1738,1500,238,C02,9,Mate,Black
FALSE,68,10+3,1500,1500,0,E32,7,Out of Time,Black
FALSE,94,10+3,1500,1500,0,C00,3,Resign,Black
FALSE,103,10+3,1500,1500,0,E32,12,Draw,Draw
TRUE,17,11+0,1564,1500,64,C46,5,Mate,White
TRUE,39,7+2,1569,1772,-203,C46,6,Resign,Black
TRUE,138,10+0,1539,1559,-20,D20,5,Out of Time,Black
TRUE,65,10+0,1693,1661,32,B06,4,Resign,White
TRUE,69,10+0,1679,1785,-106,D01,4,Mate,White
TRUE,116,10+0,1799,1665,134,C00,3,Out of Time,Black
TRUE,75,10+0,1636,1677,-41,D00,3,Mate,White
TRUE,57,10+0,1686,1723,-37,A40,2,Resign,Black
TRUE,49,10+0,1713,1696,17,B01,2,Resign,White
TRUE,78,10+0,1707,1702,5,E80,9,Mate,Black
FALSE,12,10+0,1288,1674,-386,B20,2,Resign,White
FALSE,38,10+0,1674,1748,-74,A04,2,Resign,Black
FALSE,67,10+0,2340,1874,466,B06,4,Resign,White
FALSE,55,10+0,1874,2103,-229,C42,9,Resign,White
TRUE,70,15+0,1901,1861,40,B06,4,Resign,Black
FALSE,43,15+0,2065,1861,204,B06,4,Resign,White
TRUE,59,10+0,1852,1781,71,A40,2,Resign,White
FALSE,47,10+15,1852,1758,94,D00,3,Resign,White
FALSE,10,10+15,1758,1852,-94,A84,3,Resign,Black
TRUE,103,8+0,1572,1680,-108,B20,3,Out of Time,White
TRUE,53,10+0,1672,1574,98,B01,4,Resign,White
TRUE,63,8+0,1661,1630,31,C00,4,Out of Time,White
TRUE,38,10+0,1500,1654,-154,B50,4,Resign,Black
TRUE,28,15+15,1160,1166,-6,C50,5,Resign,Black
TRUE,35,15+15,1174,1385,-211,D06,4,Resign,Black
TRUE,115,10+0,1154,1195,-41,C44,5,Mate,White
FALSE,51,10+25,2344,2150,194,E20,8,Resign,White
FALSE,49,40+40,2150,2501,-351,E30,7,Draw,Draw
FALSE,64,10+5,2401,2150,251,B33,17,Resign,Black
FALSE,57,10+15,2150,2406,-256,E70,7,Draw,Draw
FALSE,38,20+20,1500,2150,-650,B56,10,Draw,Draw
FALSE,69,5+40,2447,2150,297,E10,6,Resign,White
FALSE,40,10+15,2621,2150,471,C43,7,Resign,Black
FALSE,137,5+10,1500,2150,-650,C50,8,Draw,Draw
FALSE,82,15+0,2216,2150,66,B33,17,Resign,Black
FALSE,40,5+5,2216,2150,66,A45,2,Resign,Black
FALSE,58,10+10,2621,2150,471,A06,3,Out of Time,Black
FALSE,59,10+15,2406,2150,256,A70,13,Resign,White
TRUE,69,30+15,2398,2139,259,C53,9,Draw,Draw
FALSE,48,10+0,1384,2139,-755,C77,9,Mate,Black
FALSE,69,10+0,2139,1384,755,D50,7,Mate,White
FALSE,42,10+15,2621,2139,482,C59,16,Resign,Black
TRUE,27,10+0,2046,1929,117,B01,10,Resign,Black
TRUE,115,15+0,1594,1525,69,B01,4,Mate,White
TRUE,42,4+10,1475,1586,-111,C22,7,Out of Time,Black
TRUE,73,4+10,1577,1484,93,C41,5,Resign,White
FALSE,1,15+30,2403,1746,657,B00,1,Out of Time,White
FALSE,5,30+30,2454,1746,708,C00,3,Out of Time,White
TRUE,2,20+0,1586,1333,253,D00,2,Resign,Black
TRUE,53,10+0,1639,1596,43,E00,4,Resign,White
TRUE,57,10+0,1598,1940,-342,B22,3,Resign,Black
FALSE,39,12+13,2061,1598,463,D07,5,Mate,White
TRUE,50,10+0,1612,1529,83,C65,6,Resign,Black
TRUE,55,10+0,1698,1621,77,C45,10,Resign,White
TRUE,35,10+0,1619,1188,431,B01,4,Mate,White
TRUE,104,10+0,1599,1608,-9,C40,4,Resign,Black
FALSE,83,10+25,1608,2621,-1013,B22,3,Out of Time,White
TRUE,131,8+0,2145,2251,-106,A13,2,Draw,Draw
TRUE,120,10+0,2039,2102,-63,A22,5,Resign,Black
TRUE,47,10+0,2092,2048,44,B33,10,Resign,White
TRUE,48,10+0,2109,1966,143,B70,11,Resign,Black
TRUE,52,10+0,1866,2104,-238,C55,9,Resign,Black
TRUE,83,10+0,2117,2087,30,B01,4,Resign,Black
TRUE,107,10+0,2113,1838,275,C42,5,Resign,White
TRUE,39,10+0,2104,1980,124,C06,15,Mate,White
TRUE,64,10+0,1988,2095,-107,C45,8,Resign,Black
TRUE,42,10+0,1872,2089,-217,C50,8,Mate,Black
TRUE,145,10+0,2083,1876,207,C00,4,Resign,White
TRUE,48,10+0,1775,2079,-304,C21,6,Resign,Black
TRUE,43,10+0,2077,1694,383,B01,4,Resign,White
TRUE,62,10+0,1628,2075,-447,C55,9,Resign,Black
TRUE,32,10+0,2244,2082,162,D00,3,Resign,White
TRUE,83,10+0,2080,1639,441,C62,6,Mate,White
TRUE,70,10+0,2100,1827,273,C40,9,Resign,Black
TRUE,58,10+0,1702,2098,-396,C50,8,Resign,Black
TRUE,52,10+0,2111,2084,27,C70,8,Resign,Black
TRUE,182,10+0,1746,2108,-362,C50,9,Mate,Black
TRUE,56,10+0,1527,2108,-581,A00,1,Mate,Black
TRUE,48,10+0,2126,1906,220,B21,5,Resign,Black
TRUE,54,10+0,1917,2121,-204,C33,5,Resign,Black
TRUE,66,30+30,1687,2119,-432,D51,10,Resign,Black
TRUE,64,10+2,1170,1662,-492,B01,2,Mate,Black
TRUE,51,5+5,1261,1237,24,A00,1,Resign,White
TRUE,71,10+5,1100,1306,-206,A04,3,Mate,White
FALSE,49,10+5,1590,1100,490,C41,7,Mate,White
FALSE,34,10+5,1100,1590,-490,A06,3,Mate,Black
TRUE,88,5+5,1302,875,427,C20,3,Out of Time,Black
TRUE,11,7+5,1234,1335,-101,D02,4,Draw,Draw
TRUE,11,7+5,1522,1500,22,C42,6,Mate,White
FALSE,7,15+0,1542,1535,7,A00,1,Draw,Draw
FALSE,122,16+20,1340,1542,-202,C50,6,Mate,Black
TRUE,19,16+20,1334,1550,-216,C50,6,Draw,Draw
TRUE,123,16+20,1314,1571,-257,C50,6,Mate,White
TRUE,25,16+20,1566,1319,247,C50,8,Mate,White
TRUE,22,16+20,1324,1560,-236,C50,6,Mate,Black
TRUE,79,16+20,1554,1329,225,A40,2,Mate,White
TRUE,105,16+0,1548,1335,213,C40,4,Resign,White
TRUE,22,16+0,1341,1542,-201,C50,6,Mate,Black
TRUE,84,20+0,1258,1561,-303,C23,3,Resign,White
TRUE,44,20+0,1347,1554,-207,A00,1,Mate,Black
TRUE,15,5+5,1554,849,705,C20,3,Resign,White
TRUE,23,15+25,1552,1075,477,C40,4,Mate,White
TRUE,50,5+8,1196,1549,-353,B06,2,Mate,Black
TRUE,81,5+8,1545,1199,346,C40,4,Resign,White
TRUE,46,5+8,1202,1542,-340,C20,3,Resign,Black
TRUE,71,120+180,1540,1091,449,B01,2,Mate,White
TRUE,64,10+1,1351,1533,-182,C20,4,Resign,Black
TRUE,68,8+0,2166,2318,-152,B12,7,Resign,Black
TRUE,93,8+0,2308,2173,135,B53,7,Resign,White
TRUE,74,8+0,2180,2298,-118,B12,7,Resign,Black
FALSE,90,15+15,2403,2014,389,C14,13,Out of Time,Black
TRUE,63,10+0,1968,1626,342,C65,6,Resign,White
TRUE,65,10+0,1637,1640,-3,B27,6,Resign,Black
TRUE,17,10+0,1630,1649,-19,D06,4,Out of Time,White
TRUE,37,10+0,1643,1466,177,B90,11,Resign,White
TRUE,55,10+0,1590,1656,-66,C45,10,Resign,White
TRUE,73,10+0,1671,1560,111,B10,2,Resign,Black
TRUE,35,10+0,1658,1683,-25,C34,6,Resign,White
TRUE,145,10+0,1670,1716,-46,C57,9,Mate,White
TRUE,56,10+0,1145,1669,-524,D00,5,Mate,Black
TRUE,39,10+0,1655,1733,-78,C57,9,Resign,White
TRUE,146,10+0,1659,1979,-320,A40,2,Out of Time,Black
TRUE,99,10+0,1650,1563,87,D02,4,Mate,White
TRUE,57,10+0,1579,1641,-62,C45,10,Resign,Black
TRUE,110,10+0,1649,1761,-112,C00,3,Mate,Black
TRUE,51,10+0,1791,1633,158,C45,10,Resign,Black
TRUE,94,10+0,1569,1624,-55,A00,1,Mate,Black
TRUE,45,10+0,1613,1593,20,C55,6,Resign,White
TRUE,33,10+0,1523,1605,-82,D02,3,Resign,Black
TRUE,54,10+0,1792,1588,204,C46,7,Resign,Black
TRUE,66,10+0,1600,1584,16,C54,17,Resign,Black
TRUE,93,10+0,1589,1563,26,B02,6,Resign,White
TRUE,79,10+0,1593,1885,-292,B90,11,Resign,Black
TRUE,78,10+0,1587,1582,5,A00,1,Resign,Black
TRUE,44,10+0,1592,1628,-36,C00,3,Resign,Black
FALSE,77,15+15,1185,1179,6,C00,3,Mate,White
FALSE,117,10+0,1153,1185,-32,B50,4,Draw,Draw
TRUE,44,15+15,1196,1264,-68,D00,3,Resign,Black
TRUE,39,15+15,1186,1098,88,D00,3,Resign,White
TRUE,53,10+0,1459,1191,268,B50,4,Out of Time,White
TRUE,73,15+15,1146,1158,-12,B52,6,Resign,Black
TRUE,61,10+0,1332,1167,165,D11,7,Out of Time,White
TRUE,49,15+15,1160,946,214,D00,3,Mate,White
FALSE,10,5+8,1024,1160,-136,A06,3,Resign,Black
FALSE,38,10+0,1160,1217,-57,D20,5,Resign,Black
TRUE,24,10+0,1166,1422,-256,D20,7,Resign,Black
TRUE,45,10+0,1473,1170,303,A45,2,Resign,White
FALSE,50,15+5,1191,1146,45,A00,1,Resign,White
FALSE,47,10+0,1146,984,162,A04,2,Resign,Black
TRUE,16,10+0,1081,1133,-52,B01,2,Mate,Black
TRUE,46,10+0,1151,1118,33,C40,4,Resign,Black
TRUE,71,10+0,1133,1161,-28,C41,4,Mate,White
TRUE,63,10+0,952,1159,-207,B20,2,Mate,White
TRUE,49,10+0,1194,1175,19,B23,3,Resign,White
TRUE,7,10+0,1227,1192,35,B20,3,Resign,White
TRUE,49,10+0,1217,1210,7,A45,3,Mate,White
TRUE,134,10+0,1228,1262,-34,B01,8,Mate,Black
TRUE,18,10+0,1244,1263,-19,C42,4,Resign,Black
TRUE,99,10+0,1229,1133,96,C57,8,Resign,White
TRUE,131,10+0,1334,1246,88,B54,6,Mate,White
TRUE,60,10+0,1269,1269,0,B01,4,Resign,Black
TRUE,104,10+0,1393,1234,159,E61,4,Mate,Black
TRUE,44,10+0,1214,1594,-380,C41,7,Resign,Black
FALSE,58,10+20,1214,2621,-1407,B56,10,Resign,Black
TRUE,41,10+0,1793,1216,577,C01,5,Resign,White
TRUE,154,10+0,1224,1530,-306,B27,3,Mate,Black
TRUE,56,10+0,1226,1848,-622,C46,6,Mate,Black
TRUE,49,10+0,2191,1174,1017,C10,6,Resign,White
TRUE,57,10+0,1139,1221,-82,D20,5,Mate,White
TRUE,111,10+0,1503,1146,357,A45,3,Resign,White
TRUE,46,10+0,1156,1111,45,C02,7,Mate,Black
TRUE,70,10+0,1136,1227,-91,B01,4,Resign,Black
TRUE,75,10+0,1212,1169,43,C41,5,Out of Time,White
TRUE,41,10+0,1353,1192,161,C00,3,Resign,White
TRUE,32,10+0,1237,1237,0,C50,6,Mate,Black
TRUE,86,10+0,1285,1309,-24,C40,4,Out of Time,Black
TRUE,27,10+0,1220,1252,-32,D02,5,Mate,White
TRUE,51,10+0,1313,1285,28,C01,5,Resign,White
TRUE,28,10+0,1197,1197,0,C02,5,Resign,Black
TRUE,89,10+0,1323,1310,13,B01,6,Resign,White
TRUE,33,10+0,1500,1471,29,C62,6,Resign,Black
FALSE,50,15+0,1913,1147,766,A00,1,Resign,White
FALSE,24,15+0,1147,1913,-766,C50,8,Resign,Black
FALSE,86,5+5,1670,2621,-951,B56,10,Resign,Black
FALSE,74,5+60,1670,2621,-951,B56,10,Resign,Black
TRUE,72,10+0,1730,1656,74,A00,1,Mate,Black
TRUE,92,10+0,1662,1844,-182,C41,5,Out of Time,Black
TRUE,48,10+0,1440,1647,-207,C20,3,Resign,Black
TRUE,73,10+0,1655,1762,-107,B00,2,Resign,Black
TRUE,66,10+0,1636,1939,-303,C55,6,Resign,White
TRUE,122,10+0,1366,1644,-278,D01,5,Draw,Draw
TRUE,124,10+0,1656,1612,44,B32,7,Out of Time,Black
TRUE,70,10+0,1549,1648,-99,D00,2,Resign,Black
TRUE,39,10+0,1641,1488,153,B54,6,Mate,White
TRUE,39,10+0,1428,1659,-231,C68,8,Resign,White
TRUE,110,10+0,1632,1648,-16,D00,4,Out of Time,Black
TRUE,52,10+0,1643,1457,186,C50,6,Resign,White
TRUE,87,10+0,1582,1656,-74,C23,3,Out of Time,White
TRUE,50,10+0,1651,1437,214,C55,6,Resign,White
TRUE,63,10+0,1646,1436,210,C50,6,Resign,White
TRUE,121,10+0,1632,1692,-60,B00,2,Mate,White
TRUE,36,10+0,1653,1624,29,D10,5,Resign,White
TRUE,82,10+0,1638,1552,86,C55,6,Resign,Black
TRUE,128,10+0,1610,1627,-17,C70,8,Resign,Black
TRUE,57,10+0,1616,1586,30,C50,5,Mate,White
TRUE,61,10+0,1607,1542,65,B40,6,Resign,White
TRUE,75,10+0,1616,1618,-2,C44,5,Out of Time,White
TRUE,64,10+0,1491,1624,-133,C23,3,Resign,Black
TRUE,60,10+0,1573,1614,-41,C46,7,Out of Time,Black
TRUE,93,10+0,1462,1631,-169,C21,4,Out of Time,White
TRUE,44,10+0,1638,1413,225,B13,5,Draw,Draw
TRUE,92,10+0,1178,1636,-458,C53,12,Resign,Black
TRUE,92,10+0,1649,1597,52,B06,4,Out of Time,Black
TRUE,95,10+0,1639,1588,51,C42,5,Resign,White
TRUE,56,10+0,1630,1560,70,B33,11,Resign,White
TRUE,32,10+0,1477,1622,-145,C50,7,Mate,Black
TRUE,89,10+0,1601,1998,-397,C50,6,Out of Time,White
TRUE,77,10+0,2135,1602,533,A02,1,Resign,White
TRUE,31,10+0,1584,1786,-202,B34,9,Resign,White
TRUE,59,10+0,1844,1589,255,D10,5,Resign,White
TRUE,138,10+0,1579,1986,-407,C55,6,Out of Time,Draw
TRUE,26,10+0,1446,1572,-126,D10,5,Resign,Black
TRUE,92,10+0,1881,1935,-54,B30,4,Resign,Black
TRUE,60,10+0,2011,1865,146,D02,3,Mate,Black
TRUE,60,10+0,1875,1921,-46,C42,5,Resign,Black
TRUE,70,10+0,1924,1861,63,D02,3,Mate,Black
FALSE,75,60+40,2310,1861,449,A00,4,Draw,Draw
TRUE,24,10+0,1875,1809,66,C00,5,Resign,Black
TRUE,62,10+0,1342,1874,-532,A00,1,Mate,Black
TRUE,39,10+0,1495,1896,-401,D06,4,Mate,White
TRUE,52,10+0,1905,2022,-117,B40,4,Mate,Black
TRUE,125,10+0,1804,1895,-91,C00,4,Resign,Black
TRUE,34,10+0,1899,2207,-308,C00,5,Resign,Black
TRUE,32,10+0,2005,1908,97,B10,2,Resign,White
TRUE,48,10+0,1688,1899,-211,D37,7,Resign,Black
FALSE,61,20+10,1899,2061,-162,B06,2,Resign,White
FALSE,106,15+10,2137,1899,238,A00,5,Resign,Black
FALSE,54,20+30,2449,1899,550,A00,1,Resign,Black
TRUE,68,10+0,1932,1886,46,B21,3,Out of Time,Black
TRUE,137,10+0,1908,1898,10,C41,8,Mate,White
TRUE,59,10+0,1897,1303,594,B02,4,Mate,White
TRUE,85,10+0,1524,1906,-382,A40,1,Draw,Draw
FALSE,103,5+15,2387,1906,481,D30,4,Mate,White
FALSE,32,5+15,2387,1906,481,A40,2,Resign,White
TRUE,113,10+0,1898,1790,108,C26,4,Out of Time,White
TRUE,46,10+0,1907,1983,-76,C20,3,Resign,Black
TRUE,52,10+0,1516,1905,-389,A41,2,Mate,Black
FALSE,146,25+10,1977,1816,161,A30,2,Resign,Black
TRUE,104,10+0,1716,1972,-256,B76,14,Mate,Black
TRUE,97,10+0,1963,1857,106,A11,2,Resign,White
TRUE,55,10+0,1953,1894,59,A10,2,Resign,White
TRUE,84,10+0,1753,1947,-194,B27,4,Mate,Black
TRUE,60,10+0,1912,1936,-24,A00,2,Out of Time,Black
TRUE,57,10+0,1925,1880,45,A15,2,Mate,White
TRUE,72,10+0,1629,1921,-292,B36,8,Resign,Black
TRUE,69,10+0,1917,1621,296,A20,2,Resign,White
TRUE,147,10+0,1904,1902,2,A36,8,Mate,White
TRUE,86,10+0,1573,1901,-328,A34,3,Resign,Black
TRUE,149,10+0,1894,1717,177,B23,3,Mate,White
TRUE,37,10+0,1911,1894,17,A02,1,Draw,Draw
TRUE,41,10+0,1286,1893,-607,B21,6,Resign,Black
TRUE,60,10+0,1898,2125,-227,A16,3,Resign,Black
TRUE,138,10+0,1904,2122,-218,A20,2,Resign,Black
TRUE,111,10+0,1929,1916,13,B27,4,Resign,White
TRUE,107,10+0,1903,1914,-11,A15,2,Mate,White
TRUE,28,10+0,1919,1889,30,B39,14,Mate,Black
TRUE,64,10+0,1403,1887,-484,A43,2,Mate,Black
TRUE,139,10+0,1736,1893,-157,A43,2,Draw,Draw
TRUE,82,10+0,1906,1890,16,A10,1,Mate,Black
TRUE,78,10+0,1434,1912,-478,A04,2,Resign,Black
TRUE,71,10+0,1919,1682,237,A01,1,Draw,Draw
TRUE,23,10+0,1594,1942,-348,B22,3,Mate,White
TRUE,45,10+0,1979,1954,25,B27,4,Resign,White
TRUE,117,10+0,1947,1771,176,A15,2,Mate,White
TRUE,111,10+0,2195,1952,243,A04,2,Resign,White
TRUE,149,10+0,1937,1975,-38,A15,2,Resign,White
TRUE,94,10+0,1949,1986,-37,A10,1,Resign,Black
TRUE,47,10+0,1948,1397,551,C41,5,Mate,White
TRUE,115,10+0,1690,1970,-280,B27,4,Resign,White
TRUE,97,10+0,1969,1320,649,A20,2,Mate,White
FALSE,31,5+5,1500,1500,0,C41,5,Mate,White
TRUE,16,10+0,1430,1311,119,C41,5,Resign,Black
TRUE,44,10+0,1443,1381,62,D20,5,Resign,Black
TRUE,54,10+0,1454,1421,33,D30,6,Resign,Black
TRUE,43,10+0,1444,1465,-21,A00,1,Resign,White
TRUE,34,10+0,1387,1457,-70,E90,9,Resign,Black
TRUE,122,10+0,1417,1447,-30,D00,3,Resign,Black
TRUE,51,10+0,1436,1439,-3,D46,12,Mate,White
TRUE,62,10+0,1455,1081,374,C57,10,Resign,Black
TRUE,30,10+0,1318,1448,-130,C57,10,Resign,Black
TRUE,79,10+0,1437,1446,-9,B15,9,Out of Time,White
TRUE,32,10+0,1448,1436,12,D02,4,Resign,Black
TRUE,78,10+0,1308,1441,-133,C26,5,Resign,Black
FALSE,99,10+5,1500,2621,-1121,A45,3,Out of Time,White
FALSE,23,10+0,2350,1500,850,B25,4,Resign,White
FALSE,28,30+30,2217,1500,717,C55,7,Resign,Black
TRUE,42,10+0,1719,1679,40,D35,6,Resign,White
TRUE,42,10+0,1689,1670,19,B32,8,Mate,Black
TRUE,59,10+0,1672,1701,-29,B21,3,Resign,White
TRUE,80,10+0,1695,1923,-228,B94,11,Resign,Black
TRUE,31,10+0,1706,1698,8,B30,4,Resign,Black
TRUE,107,10+0,1687,1717,-30,D30,7,Out of Time,White
TRUE,18,2+15,1728,1723,5,B40,8,Resign,Black
TRUE,72,10+1,1648,1719,-71,B30,4,Mate,Black
FALSE,45,5+8,1719,1765,-46,C41,7,Resign,White
TRUE,66,15+15,1648,1710,-62,D02,4,Resign,Black
TRUE,93,10+0,1696,1722,-26,D00,3,Resign,White
TRUE,90,10+0,1732,1768,-36,C45,13,Resign,Black
TRUE,23,10+0,1833,1740,93,C55,6,Resign,White
TRUE,118,10+0,1433,1737,-304,D00,3,Out of Time,Black
TRUE,103,10+0,1729,2008,-279,B32,7,Draw,Draw
TRUE,23,10+0,1722,1605,117,B32,8,Resign,White
TRUE,91,15+15,1713,1659,54,C55,6,Mate,White
TRUE,56,10+0,1605,1698,-93,A00,1,Mate,Black
TRUE,71,10+0,1690,1613,77,C00,3,Mate,White
TRUE,48,10+0,1622,1681,-59,A00,1,Mate,Black
TRUE,80,10+0,1702,1681,21,C46,6,Resign,Black
TRUE,33,10+0,1568,1696,-128,B32,8,Resign,White
TRUE,84,10+0,1707,1699,8,C00,3,Out of Time,Black
TRUE,51,10+0,1453,1724,-271,C55,6,Resign,White
TRUE,47,10+0,1735,1733,2,C60,5,Resign,Black
TRUE,74,5+12,1744,1801,-57,B43,9,Resign,Black
TRUE,77,5+8,1854,1730,124,C45,7,Resign,Black
TRUE,54,10+0,1705,1719,-14,C62,6,Resign,Black
TRUE,75,10+0,1709,1716,-7,B00,5,Out of Time,White
TRUE,89,10+0,1694,1825,-131,C41,5,Out of Time,White
TRUE,62,10+0,1651,1684,-33,C20,3,Resign,Black
TRUE,49,10+0,1706,1695,11,B20,2,Resign,White
TRUE,67,10+0,1683,1717,-34,C41,5,Resign,White
TRUE,73,10+0,1707,1693,14,D00,2,Resign,White
TRUE,43,10+0,1758,1702,56,D02,4,Resign,White
TRUE,70,10+0,1713,1709,4,B38,11,Resign,Black
TRUE,28,10+0,1724,1734,-10,B32,7,Resign,Black
TRUE,16,10+0,1730,1882,-152,B30,4,Resign,Black
TRUE,53,8+0,1601,1510,91,C00,3,Resign,White
TRUE,21,8+0,1615,1518,97,C00,3,Resign,White
TRUE,40,8+0,1504,1623,-119,C41,4,Resign,White
TRUE,54,8+0,1516,1454,62,B00,2,Resign,Black
TRUE,36,8+0,1509,1505,4,A00,1,Mate,Black
TRUE,60,8+0,1325,1499,-174,A40,2,Resign,Black
TRUE,35,8+0,1494,1313,181,C00,3,Mate,White
TRUE,54,8+0,1506,1452,54,C40,4,Resign,Black
TRUE,34,8+0,1554,1494,60,C00,2,Resign,Black
TRUE,64,8+0,1488,1309,179,C65,8,Resign,White
TRUE,37,8+0,1501,1421,80,C53,9,Resign,Black
TRUE,51,8+0,1473,1513,-40,C00,3,Resign,White
FALSE,3,8+0,1314,1513,-199,C00,3,Resign,White
TRUE,135,8+0,1655,1509,146,C00,3,Draw,Draw
TRUE,99,8+0,1492,1691,-199,C70,8,Resign,White
TRUE,65,8+0,1447,1505,-58,A40,4,Resign,White
TRUE,43,8+0,1495,1474,21,C60,6,Mate,White
TRUE,80,8+0,1503,1570,-67,B00,2,Mate,Black
TRUE,51,8+0,1497,1351,146,C41,7,Mate,White
TRUE,100,8+0,1555,1484,71,A04,2,Resign,Black
TRUE,44,8+0,1489,1473,16,A00,1,Mate,Black
TRUE,77,8+0,1469,1604,-135,C62,6,Draw,Draw
TRUE,66,8+0,1370,1461,-91,A40,2,Resign,Black
TRUE,120,8+0,1502,1448,54,A00,1,Mate,Black
TRUE,94,8+0,1435,1515,-80,C00,3,Resign,White
TRUE,51,8+0,1506,1444,62,A00,1,Resign,White
TRUE,127,8+0,1431,1520,-89,C40,4,Mate,White
TRUE,96,8+0,1511,1439,72,A40,2,Resign,White
FALSE,78,30+10,1512,2085,-573,E90,11,Out of Time,Black
TRUE,88,10+0,1507,2084,-577,B82,11,Mate,Black
TRUE,113,10+0,2082,1509,573,C69,10,Mate,White
TRUE,21,15+0,2069,2030,39,B21,12,Resign,White
TRUE,20,15+6,2043,2104,-61,A22,4,Resign,Black
TRUE,60,10+15,2063,2010,53,A18,5,Resign,Black
TRUE,57,15+3,1970,2087,-117,A80,2,Resign,White
TRUE,57,10+15,2077,1899,178,A18,7,Resign,White
FALSE,52,15+0,1780,2015,-235,C00,3,Resign,Black
FALSE,152,10+0,1793,2015,-222,E77,8,Mate,Black
FALSE,18,10+0,2015,1793,222,B33,10,Resign,Black
FALSE,120,10+0,1793,2015,-222,E61,4,Mate,Black
FALSE,105,10+0,2015,1793,222,A40,2,Mate,White
FALSE,39,10+0,2524,1500,1024,C45,8,Draw,Draw
TRUE,18,10+0,1527,1882,-355,C20,3,Resign,Black
TRUE,4,10+0,1527,1882,-355,A02,1,Mate,Black
TRUE,54,7+2,1500,1901,-401,D10,5,Mate,Black
TRUE,4,10+0,1533,1897,-364,A02,1,Mate,Black
TRUE,5,10+0,1894,1539,355,A00,1,Mate,White
TRUE,26,10+0,1545,1890,-345,C20,3,Mate,Black
TRUE,4,10+0,1552,1887,-335,A02,1,Mate,Black
FALSE,115,5+60,1923,1887,36,D00,3,Draw,Draw
FALSE,26,15+0,1634,1821,-187,B01,6,Resign,Black
FALSE,66,15+0,1773,1821,-48,B01,4,Out of Time,Black
FALSE,108,5+8,1821,1842,-21,B90,11,Resign,Black
FALSE,154,15+3,1512,1821,-309,D04,6,Resign,Black
FALSE,21,25+0,1821,1832,-11,B13,5,Resign,White
FALSE,48,25+0,1832,1821,11,B12,7,Mate,Black
FALSE,89,25+0,1821,1832,-11,B12,5,Draw,Draw
FALSE,31,25+0,1832,1821,11,B12,7,Mate,White
FALSE,66,10+0,1500,1821,-321,D00,5,Mate,Black
FALSE,80,8+15,1821,1820,1,B01,5,Resign,White
FALSE,62,15+5,1500,1821,-321,B13,11,Resign,White
FALSE,120,11+0,1877,1821,56,B13,11,Mate,Black
TRUE,38,30+25,1902,1830,72,B11,8,Resign,White
FALSE,61,12+1,1830,1311,519,C45,8,Out of Time,White
FALSE,28,10+5,1824,1830,-6,B10,3,Resign,Black
FALSE,99,15+0,1548,1842,-294,B12,5,Resign,White
TRUE,49,15+3,1858,1730,128,C00,3,Resign,Black
TRUE,44,8+0,1891,1845,46,B01,6,Resign,Black
TRUE,55,25+0,1876,1856,20,B01,4,Resign,White
TRUE,92,15+5,1867,1883,-16,C45,8,Resign,Black
TRUE,27,10+0,1864,1449,415,B01,4,Resign,White
TRUE,98,15+10,1922,1851,71,D10,5,Resign,Black
TRUE,24,15+10,1861,1899,-38,B10,4,Mate,Black
TRUE,4,10+0,1527,1861,-334,A02,1,Mate,Black
TRUE,16,20+5,1878,1698,180,B01,6,Resign,Black
FALSE,85,10+5,1878,1906,-28,B87,14,Resign,White
TRUE,70,15+5,1660,1873,-213,B01,4,Mate,Black
FALSE,36,5+8,1707,1873,-166,B01,4,Resign,Black
TRUE,124,10+0,1806,1875,-69,D12,11,Draw,Draw
TRUE,61,8+0,1864,1842,22,B30,5,Resign,White
TRUE,66,8+0,1853,1853,0,B01,6,Out of Time,Black
TRUE,20,14+0,1882,1840,42,B01,6,Resign,Black
TRUE,49,10+5,1832,1696,136,B07,4,Resign,White
TRUE,42,10+5,1704,1824,-120,A20,2,Mate,Black
TRUE,47,15+15,1427,1444,-17,C70,8,Mate,White
TRUE,25,15+15,1354,1406,-52,B54,9,Resign,Black
TRUE,61,10+0,1437,1431,6,B07,4,Resign,White
TRUE,49,15+15,1411,1372,39,C40,4,Resign,White
TRUE,57,15+15,1428,1441,-13,C50,5,Mate,White
TRUE,58,10+0,1383,1412,-29,C20,3,Mate,Black
FALSE,30,15+2,1528,1500,28,D00,3,Resign,Black
TRUE,12,9+5,1543,1426,117,A41,2,Resign,Black
TRUE,34,9+5,1434,1535,-101,E61,6,Resign,Black
TRUE,81,9+5,1526,1442,84,D00,4,Resign,White
TRUE,107,9+5,1505,1898,-393,D00,3,Mate,White
TRUE,17,9+5,1895,1507,388,E61,6,Resign,White
TRUE,78,9+5,1451,1497,-46,A45,2,Resign,Black
TRUE,42,9+5,1460,1487,-27,A45,2,Mate,Black
TRUE,6,180+3,1459,1488,-29,A45,2,Draw,Draw
TRUE,61,7+3,1447,1501,-54,A00,1,Out of Time,White
TRUE,50,7+3,1457,1491,-34,B12,6,Resign,Black
TRUE,88,7+3,1467,1479,-12,A45,2,Resign,Black
TRUE,9,3+15,1785,1483,302,A00,1,Resign,White
TRUE,26,3+15,1487,1781,-294,A40,2,Resign,Black
TRUE,47,15+5,1491,1749,-258,A40,2,Resign,Black
TRUE,5,10+3,1482,1403,79,D00,3,Resign,White
TRUE,37,8+0,1218,1490,-272,A03,2,Draw,Draw
TRUE,109,5+20,1528,1500,28,B10,2,Resign,White
TRUE,59,10+1,1505,1732,-227,A40,2,Resign,Black
FALSE,46,30+0,1500,1505,-5,B12,6,Resign,Black
TRUE,50,15+5,1436,1495,-59,A04,3,Mate,Black
TRUE,40,5+17,1499,1800,-301,A45,2,Resign,Black
TRUE,53,10+0,1855,1502,353,B12,6,Out of Time,White
FALSE,15,15+0,1502,1530,-28,D00,3,Resign,White
FALSE,52,8+0,1502,1473,29,A40,6,Resign,White
FALSE,32,8+0,1502,1467,35,A40,2,Resign,Black
FALSE,99,10+0,1803,1502,301,B10,2,Resign,White
FALSE,19,10+0,1697,1502,195,E77,8,Resign,White
TRUE,89,10+0,1493,1416,77,A41,2,Mate,White
TRUE,71,15+0,1130,1048,82,C68,8,Mate,White
TRUE,43,9+8,994,1091,-97,C00,3,Mate,White
FALSE,48,10+0,1186,1091,95,B20,3,Mate,Black
TRUE,171,20+0,1071,891,180,C40,4,Mate,White
FALSE,34,20+0,1071,938,133,C41,5,Mate,Black
TRUE,63,9+4,987,1125,-138,C46,6,Mate,White
TRUE,79,10+0,1928,1529,399,C01,5,Resign,White
TRUE,48,10+0,1684,1734,-50,C00,3,Resign,Black
TRUE,76,10+0,1609,1726,-117,C00,3,Resign,Black
TRUE,54,10+0,1730,2003,-273,D35,6,Mate,Black
TRUE,131,10+0,1762,1742,20,C02,11,Mate,White
TRUE,48,20+0,1743,2269,-526,D07,4,Resign,Black
TRUE,89,20+0,2268,1744,524,C01,5,Resign,White
TRUE,88,10+0,1761,1578,183,D20,5,Mate,Black
FALSE,92,15+10,1820,1820,0,D35,6,Resign,Black
FALSE,58,20+60,1332,1820,-488,B90,11,Mate,Black
FALSE,52,5+5,1820,2621,-801,B50,6,Mate,Black
FALSE,65,30+10,2392,1820,572,B90,11,Resign,White
TRUE,73,10+0,1560,1403,157,B30,4,Mate,White
TRUE,57,10+0,1544,1771,-227,C50,8,Mate,White
TRUE,13,10+0,1798,1549,249,C48,7,Resign,White
TRUE,29,10+0,1555,1728,-173,C55,6,Resign,Black
TRUE,38,10+0,1568,1515,53,B01,6,Resign,Black
TRUE,44,10+0,1416,1585,-169,B20,2,Resign,White
TRUE,33,10+0,1796,1591,205,D30,4,Mate,White
TRUE,24,10+0,1607,1455,152,C40,4,Mate,Black
TRUE,16,10+0,1748,1591,157,B50,4,Out of Time,Black
TRUE,53,10+0,1588,1230,358,B30,4,Mate,White
TRUE,89,10+0,1576,1573,3,B01,4,Resign,White
TRUE,22,10+0,1570,1392,178,C55,6,Resign,White
TRUE,67,10+0,1570,1582,-12,B20,3,Out of Time,White
TRUE,113,10+0,1565,1730,-165,C00,2,Mate,White
TRUE,76,10+0,1470,1581,-111,B20,3,Resign,White
TRUE,55,10+0,1571,1505,66,C45,7,Resign,White
FALSE,55,10+0,1950,2212,-262,E00,1,Out of Time,White
FALSE,49,10+10,1950,1226,724,A04,2,Resign,White
FALSE,78,10+10,1950,1885,65,A08,4,Mate,Black
FALSE,29,10+10,1950,2204,-254,A04,2,Draw,Draw
FALSE,65,10+10,1950,1500,450,A06,2,Draw,Draw
FALSE,66,10+10,1950,1819,131,A07,4,Draw,Draw
FALSE,112,10+10,1950,1477,473,A04,2,Draw,Draw
FALSE,70,10+10,1950,1500,450,A07,3,Draw,Draw
TRUE,50,10+0,2036,1706,330,A08,6,Resign,Black
FALSE,40,10+0,1795,2036,-241,B54,6,Resign,Black
TRUE,33,15+0,2023,1671,352,A04,2,Mate,White
TRUE,30,15+0,1675,2008,-333,B57,8,Mate,Black
TRUE,53,15+0,1990,1678,312,A04,2,Mate,White
FALSE,30,20+60,1990,1465,525,A08,5,Draw,Draw
FALSE,11,60+0,1990,1756,234,A04,2,Draw,Draw
FALSE,3,60+0,1990,1779,211,A04,2,Draw,Draw
FALSE,67,10+10,1990,1447,543,A04,2,Draw,Draw
TRUE,41,45+45,1458,1980,-522,A00,4,Resign,Black
TRUE,28,45+45,1967,1500,467,A04,2,Resign,White
FALSE,52,10+10,1967,1295,672,A07,3,Resign,White
FALSE,30,10+0,2102,1967,135,B54,6,Resign,Black
FALSE,56,10+0,1657,2033,-376,E00,4,Resign,Black
FALSE,56,10+0,1541,2033,-492,B90,11,Mate,Black
FALSE,41,10+0,2033,1500,533,D00,3,Resign,White
FALSE,75,10+0,2033,1567,466,A40,2,Mate,White
FALSE,59,30+0,2033,1500,533,D00,3,Mate,White
FALSE,27,10+0,1502,2033,-531,A45,2,Resign,Black
TRUE,15,10+0,1516,1500,16,B00,2,Mate,White
FALSE,84,10+0,1637,1500,137,B20,3,Out of Time,Black
FALSE,29,5+8,1500,1336,164,A40,2,Resign,Black
FALSE,19,15+0,1544,1500,44,B32,5,Mate,White
FALSE,79,10+40,2447,1802,645,D37,7,Resign,White
FALSE,117,10+0,2522,1802,720,D35,6,Out of Time,White
FALSE,91,30+40,2452,1802,650,E18,14,Resign,White
FALSE,36,15+3,1802,2524,-722,E32,7,Draw,Draw
FALSE,109,15+15,1500,1802,-302,D74,13,Resign,White
FALSE,101,20+30,1500,1802,-302,B10,2,Resign,White
FALSE,56,5+60,1802,2468,-666,C65,8,Resign,Black
FALSE,67,20+30,2485,1802,683,D95,12,Resign,White
FALSE,66,20+60,2247,1802,445,A00,1,Draw,Draw
FALSE,64,40+40,2426,1802,624,A16,3,Draw,Draw
FALSE,81,20+60,2400,1802,598,A45,3,Draw,Draw
FALSE,32,10+10,2404,1802,602,A45,2,Draw,Draw
FALSE,49,5+60,2621,1802,819,D57,16,Resign,White
FALSE,10,20+60,2035,1802,233,B12,7,Resign,White
FALSE,77,15+0,2621,1802,819,D57,16,Resign,White
FALSE,34,30+30,1802,2500,-698,A52,7,Mate,Black
FALSE,39,40+10,1802,1500,302,E14,7,Resign,Black
FALSE,29,15+10,2236,1802,434,B12,6,Resign,White
FALSE,88,5+60,1802,1500,302,B56,10,Resign,Black
FALSE,53,5+60,1802,2305,-503,B18,8,Draw,Draw
FALSE,88,15+15,2400,1802,598,B15,10,Draw,Draw
FALSE,36,15+15,2400,1802,598,B17,8,Resign,White
FALSE,74,10+30,1802,2417,-615,B31,6,Resign,Black
FALSE,94,30+30,1802,2500,-698,C11,7,Resign,Black
FALSE,37,20+15,2422,1802,620,B17,8,Resign,White
FALSE,37,10+60,1802,1500,302,B33,11,Resign,Black
FALSE,91,5+60,1500,1802,-302,B54,6,Resign,White
FALSE,69,5+60,1802,1500,302,C41,7,Draw,Draw
FALSE,59,5+60,1500,1802,-302,D05,7,Resign,White
FALSE,58,10+60,1500,1802,-302,B14,10,Resign,White
FALSE,95,20+10,2500,1802,698,B11,4,Out of Time,White
FALSE,37,20+0,1802,2473,-671,B78,20,Resign,Black
TRUE,73,25+0,2169,2147,22,A28,7,Mate,White
TRUE,43,10+6,2153,2168,-15,C42,9,Resign,White
TRUE,56,10+6,2180,2134,46,A50,4,Resign,Black
TRUE,119,15+10,2132,2191,-59,B90,12,Draw,Draw
TRUE,27,10+5,2118,2151,-33,B21,12,Resign,White
TRUE,97,15+5,2167,2203,-36,C11,13,Resign,Black
TRUE,97,20+10,2142,2266,-124,A01,5,Resign,White
TRUE,76,10+10,2116,2124,-8,B22,8,Resign,Black
TRUE,30,20+3,2130,2103,27,C57,10,Mate,Black
TRUE,32,15+10,2107,2043,64,B09,10,Draw,Draw
TRUE,48,15+15,1935,2094,-159,D00,8,Resign,Black
TRUE,35,15+0,2069,2130,-61,B15,10,Mate,White
TRUE,25,10+5,2047,2035,12,D85,8,Resign,White
TRUE,53,10+0,1694,2041,-347,C74,9,Resign,Black
TRUE,58,15+0,2120,2008,112,C77,9,Resign,Black
TRUE,62,30+0,2030,2091,-61,C22,6,Resign,Black
TRUE,76,20+10,2162,1989,173,B23,4,Resign,Black
TRUE,16,15+5,1985,1540,445,D02,4,Resign,White
TRUE,127,25+10,2169,2002,167,B03,9,Resign,White
TRUE,30,8+3,2020,1952,68,A45,2,Resign,Black
TRUE,73,25+0,1918,1883,35,D15,7,Mate,White
TRUE,88,20+10,1868,1949,-81,E15,7,Resign,White
TRUE,52,20+5,1826,1769,57,B33,10,Resign,Black
TRUE,62,10+10,2034,1645,389,A45,2,Mate,Black
TRUE,13,10+10,1661,2030,-369,D22,8,Resign,Black
TRUE,52,10+30,1982,1512,470,B21,5,Resign,Black
TRUE,70,30+0,1530,1403,127,B20,3,Mate,Black
TRUE,52,10+0,1836,1905,-69,C02,8,Mate,Black
TRUE,99,10+0,1896,1842,54,D00,3,Resign,White
TRUE,39,10+0,1886,1885,1,D00,3,Mate,White
TRUE,31,10+0,1737,1901,-164,B40,6,Resign,White
TRUE,130,10+0,1910,1955,-45,D00,3,Resign,Black
TRUE,31,10+0,1843,1924,-81,C00,3,Resign,White
TRUE,62,10+0,1683,1919,-236,C00,2,Resign,Black
TRUE,30,10+0,1930,1912,18,A81,3,Resign,Black
TRUE,98,10+0,1912,1920,-8,C05,9,Out of Time,Black
TRUE,116,10+0,1975,1907,68,C02,9,Out of Time,Black
TRUE,36,10+0,1918,1914,4,A45,2,Resign,Black
TRUE,47,10+0,1818,1932,-114,C00,3,Resign,White
TRUE,116,10+0,1944,1906,38,A41,2,Resign,Black
TRUE,61,10+0,1976,1954,22,C01,9,Resign,White
TRUE,32,10+0,1963,2020,-57,A46,5,Resign,Black
TRUE,87,10+0,1956,1836,120,D00,3,Resign,White
TRUE,109,10+0,1953,1584,369,A40,2,Mate,White
TRUE,24,10+0,1698,1949,-251,A01,3,Resign,Black
TRUE,87,10+0,1917,1961,-44,A84,4,Resign,White
TRUE,101,10+0,1953,1886,67,A45,2,Out of Time,White
TRUE,103,10+0,1941,1977,-36,D00,3,Resign,White
TRUE,53,10+0,1931,1922,9,A45,2,Resign,White
TRUE,88,10+0,1847,1923,-76,C02,9,Resign,Black
TRUE,39,10+0,1884,1935,-51,C00,3,Mate,White
TRUE,31,10+0,2079,1941,138,C11,7,Resign,White
TRUE,121,10+0,1915,1943,-28,C00,3,Resign,White
TRUE,147,10+0,1914,1996,-82,A40,1,Mate,White
TRUE,38,10+0,1914,1903,11,C02,9,Resign,Black
TRUE,30,10+0,2014,1882,132,C25,4,Resign,Black
TRUE,100,10+0,1995,2014,-19,B01,6,Draw,Draw
TRUE,170,10+0,2060,1779,281,B23,5,Out of Time,Black
TRUE,81,10+0,2044,1984,60,C08,8,Resign,White
TRUE,101,10+0,1897,2109,-212,C02,10,Mate,White
TRUE,116,10+0,2145,1977,168,C57,10,Resign,Black
TRUE,30,10+0,1898,2134,-236,B00,2,Resign,Black
TRUE,130,10+0,2176,1917,259,A00,1,Mate,Black
TRUE,105,10+0,2156,2055,101,C00,5,Mate,White
TRUE,70,10+0,1888,2145,-257,B07,2,Mate,Black
TRUE,27,10+0,2129,1945,184,B11,4,Resign,White
TRUE,44,10+0,1763,2122,-359,B00,2,Resign,Black
TRUE,170,10+0,2149,1757,392,B23,5,Draw,Draw
TRUE,28,3+10,2255,2100,155,E20,8,Resign,Black
TRUE,57,10+10,2181,2132,49,A80,3,Resign,White
TRUE,89,10+0,1980,1860,120,C11,11,Mate,White
TRUE,133,10+0,1762,2220,-458,B28,5,Mate,White
TRUE,39,10+0,2213,1860,353,C00,3,Mate,White
TRUE,33,10+0,2182,2208,-26,B38,11,Resign,White
TRUE,38,10+0,1808,2175,-367,B22,8,Resign,Black
TRUE,49,10+0,2171,1668,503,B18,11,Mate,White
TRUE,38,10+0,1085,2171,-1086,B40,4,Mate,Black
TRUE,123,10+0,2087,2162,-75,C46,6,Mate,White
TRUE,49,8+0,2156,1700,456,B45,9,Mate,White
TRUE,138,10+0,2033,2121,-88,B40,4,Resign,Black
TRUE,94,10+0,2114,2162,-48,B18,11,Draw,Draw
TRUE,46,10+0,2203,2028,175,A45,3,Mate,Black
TRUE,43,10+0,1935,2064,-129,C11,11,Mate,White
TRUE,134,10+0,1971,2195,-224,C42,9,Resign,Black
TRUE,102,10+0,2054,1815,239,B20,2,Resign,Black
TRUE,56,10+0,1652,1716,-64,B40,4,Resign,Black
TRUE,127,10+0,1500,1575,-75,C50,6,Resign,White
FALSE,130,12+0,1776,1728,48,C54,11,Draw,Draw
FALSE,68,12+0,1728,1776,-48,D01,4,Mate,Black
FALSE,88,10+0,2036,1776,260,C21,6,Mate,Black
FALSE,54,10+0,1776,2036,-260,B10,2,Resign,Black
FALSE,128,9+0,1776,1718,58,B00,2,Out of Time,Black
FALSE,116,9+0,1718,1776,-58,C51,7,Mate,Black
FALSE,54,8+0,1718,1776,-58,C20,3,Mate,Black
FALSE,19,8+0,1776,1718,58,C20,4,Mate,White
FALSE,82,15+0,1697,1776,-79,A00,5,Mate,Black
TRUE,45,25+10,1348,1397,-49,D02,5,Resign,White
FALSE,74,10+5,1262,1397,-135,C77,9,Mate,Black
TRUE,9,5+8,1337,1411,-74,A00,1,Resign,White
TRUE,43,10+5,1348,1425,-77,D43,8,Resign,White
TRUE,7,20+0,1342,1440,-98,C20,5,Resign,White
TRUE,36,15+15,1799,1822,-23,B07,4,Resign,Black
TRUE,47,10+0,1471,1513,-42,D00,3,Resign,Black
TRUE,40,10+0,1523,1523,0,C46,5,Mate,Black
FALSE,53,10+0,1523,1387,136,B07,2,Resign,White
TRUE,55,10+0,1533,1572,-39,B01,4,Resign,Black
TRUE,84,10+0,1508,1523,-15,D00,3,Resign,Black
TRUE,64,10+0,1786,1527,259,D30,4,Resign,White
TRUE,38,10+0,1537,1537,0,C41,4,Resign,Black
TRUE,61,10+0,1527,1513,14,C41,4,Mate,White
TRUE,28,10+0,1534,1654,-120,B00,4,Resign,Black
TRUE,22,10+0,1545,1532,13,C44,4,Resign,Black
TRUE,43,10+0,1604,1554,50,C45,7,Resign,White
TRUE,57,10+0,1562,1564,-2,C23,3,Resign,White
TRUE,92,10+0,1506,1558,-52,C20,3,Out of Time,Black
TRUE,67,10+0,1547,1563,-16,C00,3,Resign,White
TRUE,21,10+0,1535,1580,-45,C40,4,Out of Time,White
TRUE,31,10+0,1525,1515,10,B27,4,Resign,White
TRUE,124,10+0,1532,1650,-118,C62,6,Mate,Black
TRUE,49,10+0,1538,1543,-5,C27,3,Mate,White
TRUE,40,10+0,1509,1554,-45,C21,9,Resign,White
TRUE,49,10+0,1546,1478,68,C60,6,Mate,White
TRUE,78,10+0,1542,1535,7,C53,9,Out of Time,Black
TRUE,58,10+0,1499,1526,-27,C23,3,Mate,Black
TRUE,69,10+0,1527,1477,50,C44,4,Draw,Draw
TRUE,155,10+0,1517,1496,21,C46,6,Mate,White
TRUE,47,10+0,1507,1505,2,C44,4,Resign,White
TRUE,15,10+0,1519,1517,2,C46,5,Mate,White
TRUE,95,10+0,1503,1528,-25,C20,3,Resign,White
TRUE,34,10+0,1539,1537,2,C61,6,Mate,Black
TRUE,52,10+0,1549,1556,-7,B32,8,Mate,Black
TRUE,52,10+0,1520,1539,-19,C34,6,Mate,Black
TRUE,47,10+0,1529,1551,-22,C62,6,Resign,White
TRUE,30,10+0,1564,1478,86,C62,6,Resign,Black
TRUE,37,10+0,1507,1576,-69,C23,3,Resign,White
TRUE,105,10+0,1567,1522,45,C41,4,Out of Time,White
TRUE,41,10+0,1568,1563,5,C00,3,Mate,White
TRUE,60,10+0,1578,1607,-29,C41,4,Mate,Black
TRUE,52,10+0,1563,1567,-4,C46,6,Resign,Black
TRUE,69,10+0,1559,1488,71,B06,2,Resign,White
TRUE,45,10+0,1500,1458,42,D30,4,Resign,White
TRUE,117,5+5,1362,1471,-109,C65,6,Resign,White
TRUE,55,5+5,1462,1403,59,B01,6,Mate,White
FALSE,47,10+25,2621,1715,906,C59,16,Out of Time,White
FALSE,30,10+25,2621,1715,906,C57,9,Resign,Black
FALSE,83,15+0,1715,1721,-6,B01,4,Resign,White
FALSE,47,10+25,2621,1715,906,D80,7,Resign,White
FALSE,17,10+25,1715,2621,-906,B50,6,Resign,Black
FALSE,104,10+15,1715,2621,-906,B50,6,Resign,Black
FALSE,41,10+0,1826,1648,178,A40,2,Resign,White
TRUE,116,10+0,1603,1570,33,C50,6,Mate,Black
TRUE,41,10+0,1590,1641,-51,C41,5,Mate,White
TRUE,43,10+0,1670,1599,71,D20,5,Mate,White
TRUE,52,10+0,1612,1560,52,C55,6,Resign,Black
TRUE,56,10+0,1569,1602,-33,B30,4,Resign,Black
TRUE,134,10+0,1580,1580,0,B20,3,Resign,Black
TRUE,59,10+0,1558,1546,12,C45,7,Out of Time,White
TRUE,74,10+0,1647,1543,104,E76,9,Resign,Black
TRUE,81,10+0,1531,1541,-10,B10,2,Mate,White
TRUE,168,10+0,1542,1578,-36,B54,5,Mate,Black
FALSE,29,5+8,1500,1883,-383,C20,3,Resign,Black
TRUE,132,10+0,1890,2139,-249,C30,4,Mate,Black
TRUE,55,10+0,2131,2018,113,B45,10,Resign,White
TRUE,95,10+0,2116,2252,-136,E34,8,Mate,White
TRUE,101,10+0,1891,1702,189,B21,3,Out of Time,White
TRUE,47,10+0,1697,1496,201,C00,4,Resign,White
TRUE,71,10+0,1686,1657,29,A42,5,Mate,White
TRUE,52,10+0,1542,1679,-137,B46,10,Resign,Black
TRUE,18,10+0,1286,1677,-391,B46,10,Resign,Black
TRUE,47,10+0,1672,1437,235,C67,8,Mate,White
TRUE,39,10+0,1664,1590,74,B01,4,Mate,White
TRUE,93,10+0,1592,1677,-85,B42,9,Out of Time,White
TRUE,69,15+5,1658,1689,-31,C60,6,Out of Time,White
TRUE,20,15+5,1702,1607,95,D02,4,Mate,Black
TRUE,45,10+0,1734,1713,21,B23,4,Resign,White
TRUE,50,10+0,1693,1702,-9,B20,3,Mate,Black
TRUE,53,10+0,1883,1708,175,A45,2,Resign,White
TRUE,56,10+0,1719,1710,9,C60,6,Resign,Black
TRUE,84,8+0,1950,1960,-10,D00,3,Resign,Black
TRUE,29,10+0,1864,1976,-112,B46,10,Mate,White
FALSE,72,15+0,2065,1976,89,B21,6,Resign,White
TRUE,63,7+4,1976,1988,-12,B40,10,Resign,White
TRUE,141,7+4,1976,1987,-11,C44,4,Resign,White
TRUE,92,8+0,2035,1961,74,A56,6,Mate,Black
TRUE,64,10+0,1975,1908,67,C48,8,Resign,Black
TRUE,90,10+0,1463,1974,-511,A06,3,Resign,Black
TRUE,70,10+0,1997,1480,517,C22,7,Mate,Black
FALSE,68,10+0,1950,1997,-47,B01,2,Resign,Black
TRUE,63,8+0,2229,2002,227,C02,10,Mate,White
TRUE,52,15+0,1468,1509,-41,C20,3,Mate,Black
FALSE,75,10+0,1904,1509,395,D02,4,Mate,White
FALSE,50,10+0,1509,1904,-395,B08,8,Resign,Black
TRUE,105,7+2,1502,1361,141,B30,4,Resign,White
TRUE,69,7+2,1913,1504,409,C68,7,Resign,White
TRUE,116,7+2,1509,1738,-229,C41,4,Mate,Black
TRUE,41,7+2,1369,1502,-133,C55,6,Resign,Black
TRUE,44,7+2,1454,1493,-39,D50,7,Mate,Black
FALSE,109,10+0,1427,1493,-66,C68,9,Mate,White
FALSE,17,10+0,1493,1781,-288,B30,5,Mate,White
FALSE,47,10+0,1427,1493,-66,C69,9,Mate,White
FALSE,20,10+0,1493,1781,-288,B07,4,Resign,Black
FALSE,15,10+0,1493,1427,66,C57,11,Resign,White
FALSE,45,10+0,1781,1493,288,C55,6,Resign,White
FALSE,45,10+5,1781,1493,288,D30,4,Resign,White
TRUE,46,20+0,1498,1482,16,C54,11,Resign,Black
TRUE,77,20+0,1461,1493,-32,C55,6,Resign,White
TRUE,43,10+0,1638,1500,138,C78,10,Resign,White
TRUE,81,10+0,1488,1527,-39,B02,5,Out of Time,White
TRUE,139,10+0,1501,1498,3,C55,6,Mate,White
TRUE,54,20+0,1547,1486,61,C68,7,Mate,Black
TRUE,60,10+0,1492,1658,-166,B30,4,Mate,Black
TRUE,36,10+0,1500,1605,-105,B23,3,Resign,Black
FALSE,1,5+60,2621,1384,1237,A40,1,Out of Time,White
FALSE,22,15+0,1384,2621,-1237,A00,1,Resign,Black
TRUE,90,8+0,1216,1555,-339,B20,3,Mate,Black
TRUE,44,10+0,1426,1946,-520,D03,5,Resign,Black
TRUE,55,10+0,1946,1259,687,A40,2,Mate,White
TRUE,56,10+0,1765,1939,-174,C02,9,Resign,Black
TRUE,33,10+0,1938,1352,586,D02,3,Resign,White
TRUE,31,10+0,1985,1949,36,C01,5,Resign,White
TRUE,34,10+0,1927,1938,-11,C00,5,Mate,Black
TRUE,109,10+0,1924,1998,-74,D85,13,Out of Time,White
TRUE,96,10+0,1717,1918,-201,A02,1,Resign,Black
TRUE,67,10+0,1910,1773,137,E61,6,Resign,White
TRUE,91,10+0,1902,1789,113,A57,6,Resign,White
TRUE,138,10+0,1663,1909,-246,D10,5,Draw,Draw
TRUE,88,10+0,1924,1850,74,E94,14,Resign,Black
TRUE,38,10+0,1350,1923,-573,C02,8,Mate,Black
TRUE,98,10+0,1811,1914,-103,C05,6,Resign,Black
TRUE,58,10+0,2128,1896,232,C00,5,Resign,Black
TRUE,50,10+0,1901,2123,-222,A40,3,Resign,Black
TRUE,43,10+0,1776,1917,-141,B25,4,Resign,White
TRUE,52,10+0,1930,1867,63,B40,8,Resign,Black
TRUE,108,3+30,2106,1993,113,B57,8,Mate,Black
FALSE,43,5+5,1993,1500,493,D31,5,Mate,White
FALSE,96,5+5,1500,1993,-493,C50,8,Mate,Black
TRUE,87,7+7,1987,1828,159,E67,12,Mate,White
TRUE,56,7+7,1835,1980,-145,A45,2,Resign,Black
TRUE,112,10+0,1688,1711,-23,A41,2,Resign,Black
TRUE,152,10+0,1646,1679,-33,A35,4,Out of Time,Black
TRUE,33,10+0,1716,1696,20,C20,3,Resign,White
TRUE,50,10+0,1709,1628,81,A51,4,Resign,Black
TRUE,58,10+0,1636,1701,-65,C02,10,Resign,Black
TRUE,45,10+0,1692,1645,47,D02,5,Resign,White
TRUE,120,10+0,1550,1685,-135,C02,10,Out of Time,Black
TRUE,37,10+0,1675,1654,21,A47,4,Resign,White
TRUE,90,60+0,1651,1674,-23,C45,7,Mate,Black
TRUE,69,10+5,1641,1632,9,B00,5,Resign,White
TRUE,120,8+10,1621,1630,-9,A01,2,Resign,Black
FALSE,109,10+10,1566,1597,-31,B90,10,Mate,White
TRUE,53,10+0,1551,1592,-41,C40,4,Mate,White
TRUE,81,10+0,1569,1564,5,C25,4,Out of Time,White
FALSE,85,10+0,1558,1691,-133,D06,4,Draw,Draw
TRUE,61,10+0,1731,1566,165,C55,7,Out of Time,White
TRUE,51,10+0,1813,1571,242,C44,5,Resign,White
TRUE,43,10+0,1559,1525,34,A41,3,Resign,White
TRUE,51,10+0,1697,1558,139,C57,11,Out of Time,White
TRUE,51,10+0,1777,1565,212,C34,6,Resign,White
TRUE,69,10+0,1553,1482,71,D20,4,Mate,White
TRUE,53,10+0,1648,1565,83,C50,8,Resign,White
TRUE,17,10+0,1529,1583,-54,C57,11,Mate,White
TRUE,39,10+0,1572,1451,121,D44,9,Mate,White
TRUE,78,10+0,1580,1799,-219,D30,4,Out of Time,Black
TRUE,62,10+0,1534,1553,-19,C34,6,Mate,Black
TRUE,49,10+0,1616,1568,48,D53,8,Mate,White
TRUE,27,10+0,1511,1553,-42,B90,11,Resign,Black
TRUE,36,10+0,1573,1541,32,C60,6,Mate,Black
FALSE,3,2+9,1500,1342,158,C20,3,Resign,White
TRUE,2,15+15,1500,1537,-37,C00,2,Resign,Black
TRUE,44,25+2,1853,1826,27,C50,6,Resign,Black
FALSE,35,25+2,1826,1853,-27,A46,5,Resign,White
TRUE,53,5+5,1921,1647,274,B12,5,Resign,White
TRUE,131,10+0,1396,1670,-274,A41,4,Mate,White
TRUE,50,10+0,1691,1499,192,C30,3,Resign,Black
TRUE,24,10+0,1708,1649,59,C02,7,Mate,Black
TRUE,36,10+0,1559,1699,-140,B20,3,Mate,Black
TRUE,15,10+0,1786,1775,11,C45,7,Resign,White
TRUE,49,10+0,1774,1786,-12,B72,11,Mate,White
FALSE,37,10+5,1500,1416,84,C78,10,Mate,White
FALSE,7,10+5,1431,1416,15,C50,6,Resign,Black
FALSE,42,30+30,1416,2361,-945,C31,5,Mate,Black
FALSE,83,10+5,2401,1416,985,B56,9,Mate,White
FALSE,59,10+5,2401,1416,985,C45,9,Mate,White
FALSE,29,30+30,2361,1695,666,B01,6,Resign,White
FALSE,18,30+10,2066,1695,371,B01,6,Resign,Black
TRUE,138,45+15,1720,1683,37,B01,6,Mate,Black
TRUE,57,45+0,1674,1579,95,C50,9,Resign,White
TRUE,38,45+0,1587,1666,-79,B01,6,Resign,Black
TRUE,42,45+4,1751,1675,76,C20,3,Resign,White
TRUE,22,45+4,1684,1742,-58,C40,4,Resign,Black
TRUE,23,45+4,1732,1694,38,B01,2,Resign,White
TRUE,36,45+15,1762,1681,81,B01,6,Resign,Black
TRUE,92,60+0,1690,1758,-68,C41,5,Mate,Black
TRUE,17,60+0,1749,1700,49,B01,2,Resign,White
TRUE,17,30+0,1689,1677,12,C50,6,Resign,White
FALSE,67,10+0,1689,1567,122,B00,2,Mate,White
TRUE,52,10+5,1698,1785,-87,C40,4,Resign,Black
TRUE,36,10+5,1664,1711,-47,A07,3,Resign,White
TRUE,45,10+10,1510,1729,-219,C20,3,Resign,White
FALSE,66,10+0,1500,1500,0,B00,2,Resign,Black
TRUE,45,15+15,1781,1750,31,C10,6,Mate,White
TRUE,75,18+18,1426,969,457,B00,3,Resign,White
TRUE,93,15+0,1455,971,484,A40,2,Resign,White
TRUE,50,10+5,972,1662,-690,A20,2,Resign,Black
TRUE,81,10+0,1927,2434,-507,B21,7,Out of Time,White
FALSE,64,60+0,2619,1927,692,D51,12,Resign,Black
TRUE,51,15+15,1814,1805,9,D02,4,Resign,White
FALSE,24,30+0,1500,1500,0,B28,5,Out of Time,Black
FALSE,51,30+0,1500,1500,0,C43,5,Mate,White
FALSE,76,10+0,1961,1500,461,D02,5,Resign,Black
FALSE,45,10+0,1500,1961,-461,B40,4,Resign,White
FALSE,101,15+15,1621,1247,374,B54,5,Resign,White
FALSE,63,15+15,1500,1621,-121,B12,7,Resign,White
FALSE,52,15+15,1621,1500,121,C88,13,Resign,Black
FALSE,80,15+15,1500,1621,-121,B34,9,Mate,Black
FALSE,11,15+15,1621,1500,121,C00,3,Resign,White
FALSE,59,15+15,1621,1813,-192,B12,5,Resign,Black
FALSE,84,15+15,1500,1621,-121,A48,8,Resign,Black
FALSE,43,15+15,2156,1621,535,A49,5,Resign,White
FALSE,103,15+15,1621,1093,528,A40,4,Mate,White
FALSE,92,15+15,1500,1621,-121,B54,6,Mate,Black
FALSE,29,15+15,1894,1621,273,A44,4,Resign,White
FALSE,33,15+15,1621,1894,-273,C14,12,Resign,Black
FALSE,14,15+15,1894,1621,273,D94,9,Resign,White
FALSE,17,15+15,1621,1894,-273,B30,4,Resign,Black
FALSE,14,15+15,1894,1621,273,B21,12,Resign,White
FALSE,22,15+15,1621,1894,-273,B76,17,Resign,Black
FALSE,32,15+15,1621,1903,-282,C40,6,Out of Time,Black
FALSE,52,15+15,1621,1500,121,B33,10,Resign,Black
FALSE,27,15+15,1903,1621,282,A84,4,Resign,White
FALSE,48,15+15,1621,1903,-282,B01,4,Resign,Black
FALSE,39,15+15,1903,1621,282,A84,4,Resign,White
FALSE,81,15+15,1621,1903,-282,C88,15,Resign,Black
FALSE,34,15+15,1621,1804,-183,B09,7,Resign,Black
FALSE,34,15+15,1903,1621,282,A84,4,Resign,White
TRUE,88,10+0,1847,1944,-97,D37,9,Resign,Black
TRUE,64,5+5,2040,2334,-294,B06,6,Resign,Black
FALSE,48,10+0,1973,2040,-67,B48,11,Draw,Draw
FALSE,115,10+0,1800,1973,-173,C70,8,Mate,White
FALSE,48,10+0,1973,2040,-67,B48,11,Draw,Draw
FALSE,19,15+0,1973,1505,468,D02,4,Resign,White
FALSE,51,10+0,1973,1765,208,A01,1,Resign,White
FALSE,82,10+0,2010,1973,37,A48,5,Out of Time,Black
FALSE,58,10+0,1973,1522,451,C41,5,Resign,White
TRUE,36,10+0,2091,1958,133,A01,2,Resign,Black
TRUE,116,10+0,1969,1969,0,B73,15,Out of Time,Black
TRUE,71,10+0,1953,2141,-188,C55,7,Resign,White
TRUE,62,10+0,1942,1942,0,C02,11,Resign,Black
FALSE,51,10+0,1942,1500,442,B01,4,Mate,White
FALSE,17,15+8,1942,1500,442,C07,7,Resign,White
TRUE,69,10+0,1929,1983,-54,B01,8,Resign,White
TRUE,44,10+0,1876,1919,-43,B70,10,Mate,Black
TRUE,32,10+0,1700,1925,-225,A40,2,Draw,Draw
TRUE,137,10+0,1773,1930,-157,B00,2,Draw,Draw
TRUE,53,10+0,1925,1696,229,C55,6,Resign,White
TRUE,53,10+0,1930,1762,168,C03,5,Draw,Draw
TRUE,124,10+0,1864,1921,-57,C00,3,Mate,Black
TRUE,24,10+0,1930,1988,-58,B40,10,Out of Time,Black
TRUE,83,5+5,2109,1936,173,E98,17,Resign,White
TRUE,80,10+0,1898,1926,-28,E71,9,Resign,Black
FALSE,73,30+0,1527,1608,-81,C69,9,Resign,White
FALSE,34,30+0,1588,1527,61,C45,8,Mate,Black
FALSE,42,30+0,1500,1527,-27,C20,3,Resign,Black
FALSE,58,30+0,1548,1527,21,C67,8,Mate,Black
FALSE,35,30+0,1527,1500,27,C40,3,Resign,White
FALSE,57,10+5,1527,1500,27,C66,12,Resign,White
FALSE,128,5+8,1527,1290,237,C41,4,Mate,Black
FALSE,93,10+2,1549,1527,22,C44,6,Resign,White
FALSE,61,25+5,1500,1527,-27,C46,5,Resign,White
FALSE,84,15+5,2237,1742,495,D10,5,Resign,Black
TRUE,78,5+8,2001,1395,606,B07,6,Out of Time,Black
TRUE,74,10+2,1826,1970,-144,B21,3,Resign,Black
TRUE,126,10+8,1696,1967,-271,A04,2,Resign,Black
FALSE,72,10+0,1842,1967,-125,A04,2,Resign,Black
TRUE,66,10+0,1816,1960,-144,D02,4,Mate,Black
TRUE,50,5+8,1730,1955,-225,B20,3,Resign,Black
TRUE,57,10+0,1942,1993,-51,C11,7,Resign,White
TRUE,52,10+0,1956,1864,92,B32,7,Resign,Black
TRUE,76,10+0,1866,1948,-82,B35,14,Resign,Black
TRUE,89,10+0,1935,1968,-33,C41,9,Out of Time,White
TRUE,25,10+0,1952,1946,6,D00,7,Resign,White
TRUE,62,5+15,1859,1938,-79,B20,3,Mate,Black
FALSE,30,7+2,1778,1938,-160,D01,4,Resign,Black
FALSE,67,7+2,1938,1778,160,B01,4,Resign,White
FALSE,37,7+2,1778,1938,-160,D01,4,Resign,White
FALSE,21,5+10,1938,1924,14,C44,11,Resign,Black
TRUE,66,15+0,1774,1954,-180,B22,3,Resign,White
FALSE,30,10+11,1804,1954,-150,B22,3,Resign,White
FALSE,55,15+2,1954,1955,-1,B34,9,Out of Time,White
TRUE,32,10+0,1801,1947,-146,D45,10,Resign,Black
FALSE,49,5+8,1947,1937,10,B41,10,Resign,White
TRUE,56,10+0,1968,1958,10,B23,3,Resign,White
TRUE,56,10+0,1970,1957,13,C15,6,Resign,Black
TRUE,38,10+0,2052,1956,96,A42,5,Resign,Black
TRUE,41,10+0,1946,1912,34,B32,7,Mate,White
TRUE,72,10+0,1841,1937,-96,B20,2,Resign,Black
TRUE,23,10+0,1927,1892,35,C44,11,Resign,White
TRUE,67,10+0,1910,2080,-170,C45,9,Resign,White
TRUE,76,10+5,1928,1723,205,C45,9,Resign,Black
TRUE,54,7+18,1826,1919,-93,B20,3,Resign,Black
TRUE,94,10+0,1882,1909,-27,B20,3,Out of Time,Black
TRUE,57,10+0,1907,1499,408,B06,2,Resign,White
TRUE,39,10+0,1899,1790,109,C44,7,Mate,White
FALSE,65,15+0,1713,1553,160,C50,8,Resign,White
FALSE,96,15+0,1713,1553,160,C50,8,Resign,White
FALSE,37,15+0,1553,1713,-160,C55,6,Resign,White
TRUE,97,15+15,1680,1572,108,C00,3,Resign,White
TRUE,135,15+15,1805,1721,84,C55,6,Mate,White
TRUE,98,15+15,1525,1605,-80,C62,11,Resign,Black
TRUE,44,15+15,1505,1559,-54,B07,6,Resign,White
TRUE,44,15+15,1408,1371,37,D46,11,Resign,Black
TRUE,93,15+15,1608,1500,108,C62,6,Resign,White
FALSE,80,6+5,1500,1500,0,C20,3,Resign,Black
TRUE,45,10+0,2065,2043,22,B77,18,Resign,White
TRUE,24,5+8,1928,1879,49,B32,7,Resign,Black
TRUE,96,10+0,1892,1846,46,B35,13,Out of Time,Black
TRUE,55,10+0,1936,1906,30,C50,6,Resign,White
TRUE,73,10+0,1285,1936,-651,E90,9,Out of Time,White
TRUE,19,10+0,1933,1564,369,C62,6,Mate,White
TRUE,48,10+0,1922,1917,5,E87,13,Resign,Black
TRUE,35,10+0,1911,1675,236,B57,15,Resign,White
TRUE,51,10+0,1895,1895,0,B78,19,Mate,White
TRUE,39,15+15,1889,1618,271,C41,7,Resign,White
FALSE,170,30+10,2006,1889,117,E70,7,Resign,Black
TRUE,51,10+0,1876,1807,69,C42,5,Out of Time,White
TRUE,58,5+5,1503,1873,-370,C48,7,Mate,Black
TRUE,45,10+0,1856,1858,-2,B41,8,Resign,White
TRUE,50,10+0,1838,1839,-1,C55,10,Resign,Black
TRUE,42,10+0,1505,1907,-402,B10,2,Resign,Black
TRUE,37,15+2,1620,1682,-62,E52,12,Resign,White
TRUE,85,15+0,1999,1988,11,E15,10,Resign,Black
TRUE,171,15+0,1976,2010,-34,C50,5,Mate,White
TRUE,63,15+0,2000,1986,14,E16,10,Resign,White
TRUE,84,15+10,1896,1992,-96,D30,7,Out of Time,Black
TRUE,65,15+10,1983,1904,79,D18,11,Resign,White
TRUE,113,8+0,1822,1992,-170,C50,5,Out of Time,White
TRUE,67,8+0,1986,1828,158,A40,4,Resign,White
TRUE,68,8+0,1996,2011,-15,D15,7,Resign,Black
TRUE,85,10+0,1990,1825,165,D06,4,Resign,White
TRUE,120,15+0,2001,2005,-4,D31,5,Out of Time,Black
TRUE,134,15+0,2017,1989,28,A03,2,Mate,Black
TRUE,110,10+2,2011,1989,22,A15,3,Draw,Draw
TRUE,51,10+2,2000,2000,0,D52,11,Resign,Black
TRUE,89,10+2,1988,2011,-23,D55,11,Resign,White
TRUE,43,10+2,1930,2016,-86,A28,6,Resign,White
TRUE,136,15+0,1945,2006,-61,C65,7,Resign,Black
TRUE,86,15+0,2020,1932,88,E46,9,Out of Time,Black
TRUE,96,15+0,1826,2015,-189,C65,6,Mate,Black
TRUE,56,15+0,2032,1810,222,D02,4,Resign,Black
TRUE,68,15+0,1814,2027,-213,C65,6,Resign,Black
FALSE,46,10+0,1983,2027,-44,C54,13,Resign,Black
TRUE,95,10+0,2017,1989,28,E20,5,Out of Time,White
TRUE,82,15+0,2029,1987,42,D02,4,Out of Time,Black
TRUE,49,1+30,2199,2035,164,E12,7,Mate,White
FALSE,102,10+0,2035,2045,-10,D00,3,Draw,Draw
TRUE,32,10+2,1924,2027,-103,A01,5,Out of Time,Black
TRUE,101,10+0,2021,1871,150,A40,2,Mate,White
TRUE,135,10+0,1941,2012,-71,C91,18,Resign,Black
TRUE,107,10+0,2002,1950,52,C00,5,Out of Time,White
TRUE,112,10+0,1960,1992,-32,C65,7,Out of Time,Black
TRUE,39,10+0,1925,1753,172,A40,2,Resign,White
TRUE,55,10+0,1686,1767,-81,C00,3,Resign,White
TRUE,49,10+0,1888,1775,113,C02,10,Resign,White
TRUE,26,10+0,1792,1619,173,D07,5,Resign,Black
TRUE,75,10+0,1787,1549,238,D35,9,Resign,White
TRUE,2,10+0,1567,1782,-215,A00,1,Resign,Black
TRUE,2,10+0,1776,1572,204,A00,1,Resign,White
TRUE,2,10+0,1578,1771,-193,A00,1,Resign,Black
TRUE,2,10+0,1789,1560,229,A00,1,Resign,Black
TRUE,2,10+0,1783,1565,218,A00,1,Resign,White
TRUE,27,10+0,1811,1794,17,C02,7,Resign,White
TRUE,148,10+0,1485,1802,-317,C00,3,Out of Time,Draw
TRUE,2,10+0,1570,1797,-227,A00,1,Resign,Black
TRUE,2,10+0,1792,1575,217,A00,1,Resign,White
TRUE,2,10+0,1787,1581,206,A00,1,Resign,White
TRUE,2,10+0,1781,1587,194,A00,1,Resign,White
TRUE,2,10+0,1776,1593,183,A00,1,Resign,White
TRUE,2,10+0,1599,1769,-170,A00,1,Resign,Black
TRUE,2,10+0,1763,1606,157,A00,1,Resign,White
TRUE,2,10+0,1613,1756,-143,A40,2,Resign,Black
TRUE,2,10+0,1749,1620,129,A00,1,Resign,White
TRUE,2,10+0,1604,1765,-161,A00,1,Resign,White
TRUE,28,10+0,1775,1786,-11,D10,5,Resign,Black
TRUE,2,10+0,1769,1625,144,A40,2,Resign,White
TRUE,2,10+0,1761,1632,129,A40,2,Resign,White
TRUE,2,10+0,1616,1777,-161,A00,1,Resign,White
TRUE,2,10+0,1771,1623,148,A40,2,Resign,White
TRUE,2,10+0,1763,1630,133,A40,2,Resign,White
TRUE,37,10+0,1639,1779,-140,C00,2,Resign,White
TRUE,24,10+0,1795,1618,177,D35,7,Resign,Black
TRUE,14,10+0,1811,1631,180,A00,1,Resign,Black
TRUE,39,10+0,1874,1833,41,C00,3,Resign,White
TRUE,152,10+0,1838,2053,-215,D10,5,Resign,Black
TRUE,74,10+0,1908,1825,83,C17,9,Resign,Black
TRUE,34,10+0,1838,1761,77,E76,9,Resign,Black
TRUE,115,10+0,1765,1829,-64,C00,3,Resign,Black
TRUE,117,10+0,1817,1856,-39,A58,9,Resign,White
TRUE,92,10+0,1821,2067,-246,E76,13,Resign,Black
TRUE,94,10+0,1788,1811,-23,A00,1,Resign,Black
TRUE,90,10+0,1682,1804,-122,A00,4,Resign,Black
TRUE,57,10+0,1792,1796,-4,E76,9,Resign,White
TRUE,56,10+0,1798,1685,113,D31,6,Resign,Black
TRUE,92,10+0,1693,1789,-96,C02,7,Mate,Black
TRUE,125,7+2,2018,1794,224,A84,5,Resign,White
TRUE,47,10+0,1701,1809,-108,C02,9,Resign,White
TRUE,72,10+0,1644,1802,-158,C01,5,Resign,Black
TRUE,43,10+0,1800,1881,-81,D31,5,Draw,Draw
TRUE,100,10+0,1811,1808,3,D25,7,Out of Time,Black
TRUE,44,10+0,1525,1538,-13,C55,7,Resign,Black
TRUE,40,10+0,1538,1513,25,D30,7,Mate,Black
TRUE,57,10+0,1585,1549,36,C45,8,Mate,White
TRUE,60,10+0,1519,1538,-19,B20,3,Resign,Black
TRUE,28,10+0,1549,1589,-40,C40,3,Resign,Black
TRUE,86,15+0,1512,1524,-12,C45,8,Resign,Black
TRUE,56,10+0,1528,1805,-277,B54,5,Resign,Black
TRUE,91,10+0,1796,1533,263,C44,6,Resign,White
TRUE,51,10+0,1486,1973,-487,D55,11,Mate,White
TRUE,20,10+0,1478,1625,-147,C58,11,Resign,Black
TRUE,57,10+0,1473,1196,277,B32,5,Resign,White
TRUE,102,10+0,1518,1458,60,C70,8,Resign,Black
TRUE,43,10+0,1445,1445,0,C41,5,Mate,White
TRUE,81,10+0,1535,1455,80,A01,2,Mate,White
TRUE,131,10+0,1641,1463,178,A16,3,Out of Time,White
TRUE,39,10+0,1569,1472,97,C45,10,Resign,White
TRUE,42,10+0,1489,1401,88,B01,4,Resign,Black
TRUE,11,10+0,1941,1491,450,A40,1,Mate,White
TRUE,152,10+0,1485,1661,-176,B76,14,Out of Time,Draw
TRUE,34,10+0,1489,1798,-309,B36,8,Resign,Black
TRUE,43,10+0,1806,1493,313,C62,6,Resign,White
TRUE,95,10+0,1509,1478,31,A45,2,Resign,Black
TRUE,73,10+0,1496,1389,107,D10,6,Resign,Black
TRUE,33,10+0,991,1495,-504,C22,6,Resign,Black
TRUE,31,10+0,1924,1497,427,C52,12,Resign,White
TRUE,84,10+0,1498,2044,-546,A43,3,Resign,Black
TRUE,57,10+0,1476,1746,-270,C57,10,Resign,White
TRUE,106,10+0,1489,1501,-12,C72,9,Resign,Black
TRUE,98,10+0,1358,1479,-121,A00,1,Out of Time,Black
TRUE,107,10+0,1470,1341,129,C54,11,Mate,White
TRUE,118,10+0,1485,1473,12,B12,5,Resign,Black
TRUE,83,10+0,1802,1489,313,A45,3,Resign,White
TRUE,101,30+0,1474,1489,-15,E92,13,Mate,White
TRUE,19,10+0,1562,1486,76,A45,3,Resign,White
FALSE,20,30+30,2700,1486,1214,B18,8,Resign,White
TRUE,63,10+0,1494,1502,-8,A00,2,Resign,White
TRUE,95,10+0,1529,1517,12,B13,5,Resign,White
TRUE,100,10+0,1529,1622,-93,C53,7,Out of Time,Black
TRUE,30,10+0,1532,1956,-424,B06,2,Resign,Black
TRUE,40,10+0,1532,1514,18,B00,3,Resign,Black
TRUE,42,10+0,1520,1794,-274,D50,7,Resign,Black
FALSE,120,5+60,1500,1885,-385,C03,5,Draw,Draw
TRUE,68,10+10,1047,1231,-184,C41,4,Mate,Black
FALSE,15,15+0,1226,1084,142,A16,3,Mate,White
FALSE,40,25+0,911,1226,-315,C41,5,Resign,Black
FALSE,23,10+0,1226,870,356,A40,2,Mate,White
FALSE,45,15+15,1073,1226,-153,A40,2,Mate,White
TRUE,36,15+10,1106,1218,-112,C41,5,Mate,Black
TRUE,49,10+0,1213,983,230,B15,7,Mate,White
TRUE,55,5+10,1081,1228,-147,C41,5,Mate,White
TRUE,43,17+0,1221,1095,126,A40,2,Mate,White
FALSE,22,20+5,1152,1221,-69,C00,3,Mate,Black
FALSE,32,10+0,1164,1221,-57,C41,5,Mate,Black
FALSE,77,10+0,1221,1173,48,A40,2,Resign,White
TRUE,41,10+0,1111,1236,-125,C41,5,Mate,White
FALSE,53,20+0,1236,1023,213,A45,2,Resign,White
FALSE,70,20+0,1023,1236,-213,C00,3,Mate,Black
FALSE,79,11+5,1236,964,272,A80,3,Mate,White
FALSE,34,30+0,1253,1236,17,C20,3,Resign,Black
FALSE,40,180+180,1236,1500,-264,D01,4,Mate,Black
TRUE,51,10+10,1231,997,234,B15,5,Resign,White
FALSE,17,25+15,1073,1231,-158,C41,5,Resign,White
FALSE,39,15+0,1311,1231,80,C41,5,Resign,White
TRUE,33,15+0,1221,1173,48,D00,4,Mate,White
TRUE,36,15+14,954,1240,-286,A00,2,Resign,White
TRUE,38,5+15,1096,1233,-137,C20,3,Mate,Black
FALSE,15,10+2,1218,1233,-15,C41,5,Mate,White
TRUE,37,10+3,1225,1104,121,A40,2,Resign,White
TRUE,41,10+0,1796,1838,-42,B21,3,Resign,White
TRUE,69,10+0,1946,1847,99,B50,4,Mate,White
TRUE,51,10+0,1841,1657,184,B72,11,Resign,White
TRUE,71,10+0,1677,1834,-157,B20,3,Resign,Black
FALSE,85,10+0,1834,1802,32,C45,8,Out of Time,White
TRUE,56,10+0,1844,1884,-40,B48,13,Out of Time,Black
TRUE,95,10+0,2058,1849,209,A49,5,Out of Time,White
TRUE,80,10+0,1863,1794,69,C41,7,Mate,Black
FALSE,69,10+0,1863,1760,103,B33,10,Mate,White
TRUE,83,10+0,1880,1851,29,E77,8,Resign,Black
TRUE,103,10+0,1837,1893,-56,B01,8,Resign,White
TRUE,151,10+0,1882,1848,34,E77,8,Mate,White
TRUE,120,10+0,1857,1938,-81,B36,8,Out of Time,Black
TRUE,129,10+0,1846,1879,-33,B33,11,Out of Time,White
TRUE,60,10+0,1775,1836,-61,A05,4,Out of Time,Black
FALSE,106,15+0,1188,1500,-312,C55,7,Mate,Black
TRUE,24,30+0,1198,1677,-479,C53,9,Resign,Black
FALSE,29,5+8,1198,1336,-138,C50,6,Resign,Black
TRUE,53,15+5,1514,1226,288,C42,5,Mate,White
FALSE,25,10+1,1402,1226,176,A04,2,Resign,White
TRUE,19,5+8,1494,1270,224,A01,2,Resign,White
TRUE,44,5+5,1371,1432,-61,C50,5,Resign,Black
FALSE,10,5+8,1500,1371,129,C42,5,Out of Time,Black
FALSE,28,10+30,1371,1615,-244,C41,5,Resign,Black
FALSE,7,15+2,1670,1500,170,C53,7,Draw,Draw
TRUE,67,15+2,1500,1490,10,B10,5,Resign,White
TRUE,73,20+0,1592,1478,114,A40,1,Draw,Draw
TRUE,50,10+10,1540,1582,-42,B12,7,Mate,Black
TRUE,20,30+30,1591,1673,-82,B23,4,Resign,Black
TRUE,53,10+10,1576,1375,201,D06,4,Mate,White
TRUE,40,30+30,1588,1583,5,B23,4,Mate,Black
TRUE,118,30+30,1764,1584,180,D10,5,Draw,Draw
TRUE,89,45+45,1573,1553,20,D37,12,Resign,White
TRUE,49,15+0,1398,1566,-168,B00,3,Resign,Black
TRUE,99,15+0,1434,1571,-137,D02,4,Draw,Draw
TRUE,29,25+0,1565,1346,219,A43,3,Resign,White
TRUE,109,45+45,1324,1585,-261,A16,3,Resign,White
TRUE,51,45+45,1583,1150,433,E21,7,Resign,White
FALSE,76,10+10,1712,1583,129,D00,3,Resign,Black
TRUE,98,30+30,1520,1573,-53,B12,7,Resign,Black
TRUE,11,10+5,1887,1295,592,B00,7,Resign,White
TRUE,54,10+5,1296,1886,-590,B50,4,Resign,Black
TRUE,42,10+5,1913,1275,638,A40,2,Resign,Black
TRUE,43,10+5,1908,1633,275,D00,4,Resign,White
TRUE,73,10+5,1931,1626,305,D00,3,Resign,Black
TRUE,154,10+1,1952,1725,227,D00,3,Out of Time,Black
TRUE,82,10+1,1451,1950,-499,B90,11,Mate,Black
TRUE,45,10+1,1855,1968,-113,A45,2,Resign,White
TRUE,69,15+10,2238,1972,266,A46,5,Resign,White
TRUE,129,10+3,1962,1889,73,B06,8,Mate,White
TRUE,57,5+10,1396,1131,265,D02,4,Mate,White
TRUE,19,10+10,1237,1565,-328,C57,9,Resign,White
TRUE,98,15+0,1753,1451,302,D02,4,Mate,Black
TRUE,35,15+0,1699,1457,242,D02,4,Mate,White
FALSE,41,10+0,1699,1500,199,C68,8,Mate,White
TRUE,75,25+0,1500,1545,-45,D02,3,Mate,White
TRUE,71,8+0,1803,1387,416,B13,5,Resign,White
TRUE,48,10+0,1559,1798,-239,A21,3,Resign,Black
TRUE,109,10+0,1787,1766,21,C02,7,Mate,White
TRUE,12,10+0,1598,1743,-145,C25,4,Mate,Black
TRUE,8,10+0,1605,1735,-130,C20,2,Mate,Black
TRUE,8,10+0,1614,1727,-113,C20,2,Mate,Black
TRUE,49,10+0,1509,1629,-120,C46,7,Mate,White
FALSE,20,5+20,1474,1500,-26,C41,7,Resign,Black
FALSE,12,20+60,1752,1500,252,C28,5,Draw,Draw
TRUE,108,20+5,2068,2228,-160,A42,7,Draw,Draw
TRUE,30,0+12,2072,2499,-427,E20,6,Resign,Black
TRUE,81,5+5,2089,2153,-64,E76,13,Resign,Black
TRUE,7,10+0,2192,2106,86,B07,4,Resign,White
TRUE,58,5+7,2263,2096,167,C41,12,Draw,Draw
TRUE,95,15+10,2209,2113,96,B07,4,Resign,White
TRUE,45,8+2,2085,2161,-76,E76,9,Resign,White
TRUE,36,8+0,2134,2071,63,C41,5,Resign,White
TRUE,71,8+2,2026,2224,-198,A41,3,Resign,White
TRUE,119,5+5,1985,2091,-106,A40,6,Mate,White
TRUE,75,10+0,1940,2045,-105,D45,9,Resign,White
FALSE,40,8+2,2028,1940,88,C41,8,Draw,Draw
TRUE,41,20+0,2153,1959,194,B07,4,Resign,White
TRUE,61,10+10,1934,1917,17,B07,4,Resign,Black
FALSE,51,10+0,1917,1804,113,A57,7,Resign,Black
TRUE,54,5+5,1966,1859,107,B07,4,Resign,Black
TRUE,87,10+5,1809,1802,7,E20,8,Mate,White
TRUE,62,15+0,1859,1728,131,B07,8,Resign,Black
TRUE,69,15+0,1783,1858,-75,A41,3,Resign,Black
TRUE,169,15+0,1868,1868,0,C41,6,Mate,White
TRUE,34,10+3,1634,1807,-173,B07,2,Resign,Black
TRUE,67,6+5,1991,1929,62,B07,4,Resign,White
TRUE,99,10+0,1500,1855,-355,E76,9,Resign,White
TRUE,13,10+0,1392,1333,59,A29,7,Resign,Black
TRUE,57,10+0,1392,1343,49,A00,1,Resign,White
TRUE,38,10+0,1353,1382,-29,C41,5,Resign,Black
FALSE,54,10+0,1102,1353,-251,D00,5,Mate,Black
FALSE,35,10+0,1353,1522,-169,C57,8,Mate,White
FALSE,79,10+0,1510,1353,157,C02,9,Mate,White
TRUE,69,10+0,1265,1367,-102,D20,4,Mate,White
TRUE,31,10+0,1434,1377,57,D01,4,Resign,White
TRUE,198,10+0,1246,1340,-94,C20,4,Resign,Black
TRUE,18,10+0,1347,1495,-148,C41,5,Resign,Black
TRUE,18,10+0,1355,1470,-115,C00,3,Resign,Black
TRUE,51,10+0,1359,1366,-7,C46,7,Mate,White
TRUE,45,10+0,1370,1228,142,C46,7,Draw,Draw
TRUE,36,10+0,1351,1374,-23,C46,7,Resign,White
TRUE,81,5+5,1141,1369,-228,C30,3,Resign,Black
TRUE,87,8+0,1363,1201,162,C50,5,Resign,White
TRUE,68,25+0,1283,1354,-71,D00,3,Mate,Black
TRUE,111,10+0,1347,1186,161,C46,7,Mate,White
TRUE,27,10+0,1334,1400,-66,C00,3,Mate,White
TRUE,19,10+0,1348,1322,26,C34,6,Resign,Black
TRUE,27,10+0,1329,1466,-137,B20,3,Resign,Black
TRUE,25,10+0,1295,1821,-526,C44,4,Mate,White
TRUE,102,10+0,1329,1282,47,D07,7,Resign,Black
TRUE,60,10+0,1285,1598,-313,C27,3,Mate,Black
TRUE,62,10+0,1099,1279,-180,D00,3,Mate,Black
TRUE,130,10+0,1275,1398,-123,B10,3,Draw,Draw
TRUE,61,10+0,1350,1285,65,D07,7,Mate,White
TRUE,63,10+0,1383,1286,97,C46,7,Mate,White
TRUE,50,10+0,1297,1313,-16,C50,5,Mate,Black
TRUE,26,10+0,1273,1286,-13,C50,8,Mate,Black
TRUE,33,10+0,1282,1018,264,C42,5,Mate,White
TRUE,17,10+0,1231,1295,-64,C57,11,Mate,White
TRUE,32,10+0,1306,1298,8,C50,8,Resign,Black
TRUE,92,10+0,1195,1298,-103,A00,1,Out of Time,Black
TRUE,47,10+0,1383,1307,76,C40,4,Mate,White
TRUE,25,10+0,1296,1284,12,B23,3,Resign,White
TRUE,71,10+0,1600,1300,300,C22,6,Mate,White
TRUE,57,10+0,1282,1492,-210,C41,4,Mate,White
TRUE,43,10+0,1386,1279,107,A00,1,Draw,Draw
TRUE,17,10+0,1264,1367,-103,C50,6,Mate,White
TRUE,71,10+0,1539,1514,25,C42,5,Resign,White
TRUE,23,10+0,1528,1544,-16,C23,3,Resign,White
TRUE,114,10+0,1539,1514,25,B20,3,Mate,Black
TRUE,54,10+0,1506,1529,-23,D21,6,Resign,Black
TRUE,114,10+0,1541,1528,13,B00,2,Out of Time,Black
FALSE,44,15+0,2158,2140,18,C65,6,Draw,Draw
FALSE,51,15+0,2140,2158,-18,C88,15,Resign,White
FALSE,33,15+0,2158,2140,18,C77,9,Resign,White
TRUE,64,30+30,2170,2110,60,A08,4,Resign,Black
FALSE,53,15+0,2170,1510,660,C41,8,Mate,White
FALSE,58,15+0,1510,2170,-660,A40,2,Mate,Black
FALSE,36,30+0,2170,1701,469,A45,3,Resign,Black
TRUE,83,10+0,2164,2014,150,D02,3,Resign,White
TRUE,71,35+2,2155,2078,77,B42,10,Resign,White
TRUE,114,10+15,2033,2148,-115,B00,2,Resign,Black
TRUE,56,10+5,2161,2077,84,A30,2,Resign,Black
TRUE,42,10+5,2086,2152,-66,E20,8,Resign,Black
TRUE,53,5+5,2145,2013,132,B11,8,Resign,White
TRUE,109,5+5,2311,2151,160,B90,11,Resign,White
TRUE,45,10+5,2210,2161,49,C54,11,Resign,White
FALSE,73,5+10,1646,1522,124,B01,4,Resign,White
TRUE,170,15+15,1636,1858,-222,C42,5,Draw,Draw
TRUE,41,15+15,1611,1640,-29,C50,5,Resign,White
TRUE,124,15+15,1646,1528,118,C40,4,Draw,Draw
TRUE,33,15+15,1715,1648,67,D02,5,Resign,White
TRUE,40,15+15,1650,1709,-59,B23,4,Resign,Black
TRUE,100,15+15,1554,1630,-76,A00,1,Resign,Black
TRUE,101,15+15,1763,1649,114,C66,8,Resign,White
TRUE,85,15+15,1615,1685,-70,B25,4,Resign,White
TRUE,81,15+15,1582,1626,-44,C02,7,Resign,White
TRUE,57,15+15,1543,1614,-71,C41,4,Mate,White
TRUE,31,15+15,1605,1576,29,C20,3,Resign,White
TRUE,66,15+15,1622,1543,79,B23,4,Resign,Black
TRUE,26,15+15,1546,1632,-86,C42,5,Draw,Draw
TRUE,80,15+15,1666,1770,-104,B06,5,Resign,Black
TRUE,92,15+15,1655,1604,51,C20,2,Resign,Black
TRUE,110,15+15,1522,1543,-21,C44,9,Mate,Black
TRUE,79,15+15,1443,1598,-155,B01,2,Resign,White
TRUE,15,15+15,1547,1522,25,C21,3,Mate,White
TRUE,68,15+15,1657,1609,48,C41,4,Resign,Black
TRUE,123,15+15,1500,1461,39,C46,6,Resign,White
TRUE,38,15+0,1444,1834,-390,A00,1,Mate,Black
TRUE,115,15+0,1831,1458,373,A00,1,Resign,White
TRUE,114,15+0,1476,1828,-352,A00,2,Mate,Black
TRUE,57,15+0,1824,1498,326,C00,3,Mate,White
TRUE,54,15+0,1527,1819,-292,A00,1,Mate,Black
TRUE,69,15+0,1814,1567,247,A00,1,Mate,White
TRUE,4,10+0,1834,1332,502,A00,1,Out of Time,Black
TRUE,132,10+0,1349,1832,-483,B02,3,Mate,Black
TRUE,55,10+0,1830,1369,461,A00,1,Mate,White
TRUE,54,10+0,1396,1827,-431,A00,1,Out of Time,Black
TRUE,125,10+0,1824,1433,391,A00,1,Mate,White
TRUE,72,10+0,1500,1821,-321,A00,1,Mate,Black
TRUE,58,30+30,1743,1800,-57,B21,12,Resign,Black
TRUE,71,30+30,1849,1752,97,A20,2,Mate,White
TRUE,55,15+15,1737,1833,-96,C33,5,Resign,White
TRUE,71,30+30,1731,1560,171,C33,5,Resign,White
TRUE,48,5+5,1628,1729,-101,B08,8,Out of Time,Black
TRUE,77,4+7,1724,1534,190,A40,2,Mate,White
TRUE,218,8+3,1632,1715,-83,C02,9,Resign,Black
TRUE,2,150+180,1039,1161,-122,C20,2,Out of Time,Black
TRUE,2,150+180,1055,1280,-225,A00,1,Resign,Black
TRUE,8,10+0,1086,1148,-62,A00,1,Resign,Black
TRUE,62,10+0,1091,1958,-867,A00,1,Mate,Black
FALSE,4,180+180,1091,1171,-80,A00,1,Resign,Black
FALSE,2,180+180,1091,1529,-438,A00,1,Resign,Black
FALSE,2,180+180,1091,1701,-610,A00,1,Resign,White
FALSE,2,30+0,1091,1500,-409,A00,1,Resign,Black
TRUE,5,8+8,1674,1095,579,A00,1,Resign,White
TRUE,15,10+0,1907,1095,812,C00,4,Resign,White
TRUE,26,10+0,1185,1171,14,A00,1,Mate,Black
TRUE,38,10+0,1193,1636,-443,A00,1,Mate,Black
TRUE,69,3+12,1733,1199,534,A41,3,Mate,White
TRUE,44,20+5,1236,1373,-137,A00,1,Mate,Black
FALSE,37,7+3,2047,1236,811,B07,3,Mate,White
TRUE,64,7+10,1264,1506,-242,A00,1,Mate,Black
TRUE,89,25+10,1859,1734,125,A53,4,Resign,White
TRUE,108,10+10,2305,2143,162,D55,11,Draw,Draw
TRUE,93,5+5,2204,2160,44,B21,3,Out of Time,White
TRUE,77,10+0,2132,2263,-131,A38,13,Mate,White
TRUE,53,8+0,2094,2416,-322,A08,6,Mate,White
FALSE,51,10+0,2445,2094,351,A10,2,Resign,White
TRUE,93,10+3,2060,2255,-195,A07,10,Resign,White
FALSE,39,5+5,2243,2060,183,B53,7,Resign,White
TRUE,52,8+3,1791,2516,-725,B50,4,Resign,White
TRUE,15,10+0,1083,985,98,B07,2,Mate,White
TRUE,33,15+0,1074,1197,-123,B01,4,Draw,Draw
TRUE,32,10+5,1085,1347,-262,B30,4,Mate,Black
FALSE,28,10+0,1085,1744,-659,C00,4,Resign,Black
TRUE,32,10+0,1002,1092,-90,A04,4,Draw,Draw
TRUE,40,12+9,1118,1205,-87,C57,8,Mate,Black
TRUE,95,10+1,1102,878,224,C00,4,Mate,White
TRUE,28,10+0,1154,1155,-1,C24,4,Mate,Black
TRUE,57,10+0,1273,1199,74,A00,1,Mate,White
TRUE,23,10+0,1331,1324,7,C57,8,Resign,Black
FALSE,45,180+0,1500,1420,80,A00,1,Draw,Draw
FALSE,6,30+0,1500,1628,-128,A00,1,Mate,Black
FALSE,52,30+0,1500,1302,198,A00,1,Resign,Black
FALSE,3,15+0,1500,1626,-126,A03,2,Draw,Draw
FALSE,7,15+0,1200,1500,-300,B12,6,Resign,White
FALSE,4,15+0,1454,1500,-46,B07,2,Draw,Draw
FALSE,31,15+0,1339,1500,-161,B00,2,Mate,White
TRUE,78,30+30,1758,1696,62,D45,11,Resign,Black
FALSE,91,8+0,1696,1500,196,D06,4,Mate,White
TRUE,120,30+30,1704,1815,-111,E15,10,Resign,Black
TRUE,48,30+30,1402,1700,-298,B01,6,Resign,Black
FALSE,93,15+15,1500,1700,-200,B01,6,Resign,White
FALSE,61,5+5,1700,1811,-111,D20,4,Out of Time,White
TRUE,17,10+0,1475,1455,20,C00,3,Resign,Black
TRUE,54,10+0,1478,1463,15,B70,10,Resign,Black
TRUE,29,10+0,1456,1403,53,C00,3,Resign,White
TRUE,121,10+0,1442,1181,261,C65,6,Mate,White
TRUE,37,10+0,1358,1433,-75,B52,6,Resign,Black
FALSE,68,5+15,1433,2621,-1188,B50,6,Resign,Black
TRUE,84,10+0,1443,1469,-26,C68,10,Mate,Black
TRUE,136,10+0,1308,1448,-140,B20,2,Out of Time,Draw
TRUE,106,10+0,1439,1341,98,C42,5,Resign,White
TRUE,70,10+0,1396,1429,-33,B20,3,Resign,Black
TRUE,44,10+0,1282,1421,-139,B20,2,Resign,Black
TRUE,51,8+0,1570,1585,-15,C42,5,Resign,White
TRUE,50,3+10,1605,1558,47,B01,8,Resign,Black
TRUE,39,10+0,1546,1600,-54,C41,5,Resign,White
TRUE,90,8+1,1579,1534,45,A00,1,Out of Time,Black
TRUE,91,15+0,1523,1535,-12,C55,6,Mate,White
TRUE,119,5+5,1534,1530,4,B29,5,Mate,White
TRUE,83,11+5,1539,1582,-43,B00,2,Resign,Black
TRUE,112,7+5,1538,1529,9,A45,2,Mate,Black
TRUE,134,5+8,1529,1531,-2,C41,6,Draw,Draw
TRUE,55,7+3,1559,1539,20,D00,4,Mate,White
TRUE,74,7+3,1549,1549,0,C41,6,Resign,Black
TRUE,122,5+5,1529,1550,-21,B40,4,Draw,Draw
TRUE,120,7+4,1553,1539,14,B21,3,Resign,Black
TRUE,60,10+0,1549,1527,22,B20,3,Resign,Black
TRUE,45,10+0,1553,1538,15,D02,4,Out of Time,White
TRUE,150,5+5,1540,1536,4,D00,4,Mate,Black
TRUE,61,8+3,1618,1545,73,B20,3,Resign,White
TRUE,95,5+8,1533,1573,-40,B02,6,Resign,White
TRUE,94,9+1,1538,1534,4,B25,4,Resign,Black
FALSE,76,10+2,2030,1841,189,B32,8,Resign,Black
FALSE,26,45+0,2030,1225,805,B00,2,Resign,Black
FALSE,42,20+0,1855,2030,-175,D02,4,Resign,White
FALSE,86,10+0,2030,2202,-172,B01,4,Resign,Black
FALSE,99,10+2,2030,1841,189,C41,4,Mate,White
FALSE,26,10+2,2030,1841,189,B01,8,Resign,Black
FALSE,52,45+0,2030,1641,389,C67,8,Resign,Black
FALSE,59,45+0,2030,2168,-138,C91,18,Resign,Black
FALSE,52,45+0,2030,1491,539,C80,10,Resign,Black
FALSE,34,45+0,2030,1767,263,B12,3,Resign,Black
TRUE,39,12+12,1486,1092,394,D06,3,Mate,White
TRUE,93,5+10,1417,1500,-83,C45,7,Resign,White
TRUE,29,15+1,1493,1342,151,D31,5,Mate,White
TRUE,66,15+1,1349,1486,-137,C44,4,Resign,Black
TRUE,84,20+0,1363,1501,-138,C57,8,Resign,White
TRUE,67,10+8,1491,1461,30,C00,3,Out of Time,White
TRUE,62,30+0,1420,1473,-53,C46,7,Mate,Black
TRUE,81,10+5,1490,1317,173,C50,6,Resign,Black
TRUE,63,25+0,1488,1067,421,A10,2,Mate,White
TRUE,96,40+0,1339,1481,-142,A00,1,Resign,Black
TRUE,8,15+5,1332,1498,-166,B20,3,Resign,White
TRUE,99,30+0,1500,1510,-10,C42,5,Mate,White
TRUE,44,45+30,1517,1661,-144,B20,3,Mate,Black
TRUE,47,45+30,1524,1654,-130,B50,4,Resign,Black
TRUE,15,3+8,1551,1535,16,C68,10,Resign,White
TRUE,88,3+8,1548,1540,8,C50,5,Resign,Black
FALSE,63,45+45,2131,1431,700,D00,4,Resign,White
TRUE,54,15+15,1426,1447,-21,C44,12,Resign,White
TRUE,50,15+15,1485,1403,82,B52,6,Mate,Black
TRUE,44,20+0,1401,1382,19,B20,3,Mate,Black
TRUE,37,20+0,1392,1608,-216,A22,5,Resign,Black
TRUE,21,20+0,1603,1402,201,C50,9,Resign,White
FALSE,149,10+5,1402,1341,61,C70,8,Mate,White
FALSE,94,15+10,1116,1402,-286,A30,2,Resign,Black
FALSE,61,15+10,1116,1402,-286,A03,2,Resign,White
FALSE,21,15+10,1116,1402,-286,B75,13,Resign,White
FALSE,50,15+10,1116,1402,-286,B57,8,Mate,Black
FALSE,30,15+10,1402,1116,286,A41,4,Resign,Black
FALSE,55,14+0,1402,1569,-167,A10,2,Mate,White
TRUE,57,10+0,1737,1408,329,A38,13,Resign,White
TRUE,48,10+0,1431,1426,5,A10,2,Resign,Black
TRUE,21,10+0,1455,1448,7,A10,2,Resign,Black
TRUE,35,10+0,1859,1460,399,B21,5,Resign,White
TRUE,43,10+0,1501,1484,17,A45,2,Resign,White
TRUE,111,10+0,1457,1449,8,A15,2,Mate,White
TRUE,49,10+0,1419,1544,-125,A20,2,Out of Time,White
FALSE,40,15+10,1419,1865,-446,A20,2,Out of Time,Black
TRUE,57,15+10,1433,1653,-220,A30,2,Resign,Black
TRUE,14,25+0,1781,1441,340,A09,4,Resign,White
TRUE,5,8+11,1473,1532,-59,C20,2,Out of Time,White
TRUE,19,8+11,1453,1561,-108,A00,1,Resign,White
TRUE,36,5+8,1509,1400,109,A40,2,Draw,Draw
FALSE,57,10+45,1340,1400,-60,A40,1,Mate,White
FALSE,134,10+45,1400,1340,60,A01,2,Mate,Black
TRUE,33,5+8,1500,1482,18,A40,3,Mate,White
TRUE,29,5+8,1412,1705,-293,A02,1,Out of Time,White
TRUE,102,5+10,1561,1500,61,A40,1,Out of Time,Black
TRUE,40,15+0,1468,1648,-180,C00,3,Resign,Black
TRUE,75,15+10,1631,1711,-80,C45,8,Resign,White
TRUE,9,15+0,1630,1130,500,B02,6,Resign,White
TRUE,76,15+10,1197,1628,-431,C00,2,Resign,Black
TRUE,76,12+6,1243,1625,-382,E77,8,Resign,Black
TRUE,86,20+0,1250,1622,-372,B40,4,Out of Time,Black
TRUE,73,30+30,1500,1633,-133,A15,3,Resign,White
TRUE,17,30+5,1624,1526,98,B33,11,Resign,White
TRUE,20,30+5,1537,1613,-76,C02,9,Resign,Black
TRUE,58,30+5,1602,1549,53,B33,11,Resign,White
TRUE,59,12+5,1595,1411,184,C02,10,Mate,White
TRUE,54,15+3,1117,1593,-476,E60,5,Mate,Black
TRUE,112,15+15,1290,1589,-299,C20,3,Mate,Black
TRUE,31,15+15,1585,1294,291,C40,3,Mate,White
TRUE,57,5+10,1348,1606,-258,C20,3,Resign,White
TRUE,77,15+0,1599,1424,175,C44,5,Resign,White
FALSE,38,15+5,1433,1599,-166,C50,9,Resign,Black
FALSE,65,15+5,1599,1315,284,B90,11,Out of Time,White
FALSE,30,15+5,1315,1599,-284,C46,7,Resign,Black
TRUE,88,30+0,1468,1590,-122,D91,9,Resign,Black
TRUE,97,14+0,1584,1359,225,B02,4,Mate,White
TRUE,62,15+10,1509,1587,-78,B07,6,Draw,Draw
TRUE,21,11+0,1311,1611,-300,C58,11,Resign,White
FALSE,47,20+0,1611,1299,312,B90,10,Resign,White
FALSE,35,10+1,1299,1611,-312,C55,7,Resign,Black
TRUE,80,15+10,1727,1606,121,C68,10,Draw,Draw
TRUE,45,15+10,1586,1742,-156,C45,8,Resign,White
TRUE,42,10+1,1288,1582,-294,A49,4,Mate,Black
TRUE,55,15+10,1559,1797,-238,C45,8,Resign,White
TRUE,56,15+10,1754,1537,217,C68,7,Resign,Black
TRUE,103,20+5,1515,1719,-204,C45,8,Resign,White
TRUE,34,12+0,1507,1318,189,B01,4,Resign,White
TRUE,32,8+4,1515,1710,-195,C45,8,Resign,Black
TRUE,85,15+10,1680,1516,164,C58,11,Resign,White
TRUE,100,15+10,1525,1674,-149,C45,8,Resign,Black
TRUE,34,10+0,1500,1497,3,C55,8,Resign,Black
TRUE,20,9+0,1577,1692,-115,C70,8,Draw,Draw
FALSE,61,20+0,1704,1380,324,B22,11,Resign,White
FALSE,47,30+0,1704,1380,324,C47,8,Resign,White
TRUE,61,30+30,1702,1266,436,B22,6,Resign,White
FALSE,59,15+0,1702,1380,322,C47,8,Resign,White
FALSE,26,15+0,1702,1380,322,C47,8,Resign,Black
FALSE,44,15+0,1702,1380,322,C47,8,Mate,Black
FALSE,59,20+0,1702,1380,322,B22,6,Resign,White
FALSE,39,20+0,1702,1380,322,B22,6,Resign,White
FALSE,47,20+0,1702,1380,322,B22,11,Mate,White
FALSE,53,20+0,1702,1380,322,B22,11,Resign,White
FALSE,50,10+0,1702,1380,322,B22,11,Mate,Black
TRUE,74,30+30,871,1701,-830,B20,3,Mate,Black
TRUE,49,20+0,1698,1384,314,C02,9,Resign,White
TRUE,78,30+30,1709,1735,-26,B00,2,Resign,Black
FALSE,45,20+20,1709,1384,325,B00,2,Mate,White
FALSE,55,20+20,1709,1384,325,B00,2,Resign,Black
FALSE,38,15+0,1384,1709,-325,B33,10,Resign,Black
FALSE,24,15+0,1709,1384,325,C10,6,Resign,White
FALSE,34,15+0,1384,1709,-325,B33,11,Resign,Black
TRUE,72,10+0,1721,1757,-36,B22,3,Out of Time,Black
TRUE,64,10+0,1524,1741,-217,A00,1,Resign,White
TRUE,57,10+0,1766,1753,13,B24,5,Resign,White
TRUE,51,10+0,1518,1774,-256,B20,2,Resign,White
TRUE,86,30+30,1905,1896,9,B50,5,Resign,Black
TRUE,37,10+10,1871,1940,-69,B22,3,Resign,White
TRUE,122,15+10,1977,2012,-35,E32,7,Resign,Black
TRUE,10,10+0,1971,1244,727,D15,7,Resign,White
TRUE,97,10+0,1213,1813,-600,A40,2,Mate,White
TRUE,117,10+30,1184,1506,-322,D02,4,Mate,White
TRUE,32,10+0,1186,1745,-559,A49,4,Resign,Black
TRUE,21,7+2,1569,1189,380,C55,9,Mate,White
TRUE,70,7+2,1199,1329,-130,D31,5,Mate,Black
FALSE,12,10+0,1288,1674,-386,B20,2,Resign,White
FALSE,38,10+0,1674,1748,-74,A04,2,Resign,Black
TRUE,45,8+0,2186,2169,17,A48,5,Resign,White
TRUE,111,8+0,2178,2073,105,D20,5,Out of Time,White
TRUE,205,8+0,2382,2173,209,D02,3,Draw,Draw
TRUE,61,8+0,2165,2066,99,A11,2,Resign,White
TRUE,207,8+0,2165,2158,7,B06,4,Draw,Draw
TRUE,62,8+0,2169,2153,16,C11,7,Resign,Black
TRUE,5,8+0,2141,2180,-39,A40,2,Resign,White
TRUE,85,8+0,2181,2140,41,A38,13,Draw,Draw
TRUE,106,8+0,2150,2171,-21,A40,2,Resign,Black
TRUE,102,8+0,2183,2138,45,A38,13,Resign,Black
TRUE,70,10+0,1499,1449,50,D00,5,Resign,Black
TRUE,66,10+0,1909,1639,270,A46,3,Mate,Black
TRUE,61,10+0,1853,1923,-70,A00,1,Out of Time,White
TRUE,69,10+0,2121,1929,192,B43,9,Resign,White
TRUE,74,10+0,1935,2124,-189,E11,7,Out of Time,Black
TRUE,94,10+0,1916,1924,-8,B40,5,Mate,Black
TRUE,75,10+0,1916,1791,125,A41,4,Resign,White
TRUE,92,10+0,1931,1749,182,A84,3,Out of Time,Black
TRUE,76,10+0,1643,1927,-284,A00,1,Mate,Black
TRUE,58,10+0,1801,1943,-142,B42,9,Resign,White
TRUE,119,10+0,1942,1466,476,D44,8,Mate,White
TRUE,70,10+0,1957,1820,137,E15,7,Resign,Black
TRUE,121,10+0,1933,1970,-37,A49,4,Out of Time,White
TRUE,75,10+0,2016,1980,36,A15,2,Resign,White
TRUE,109,10+0,1969,1971,-2,D11,6,Mate,White
TRUE,87,10+0,2168,1975,193,B09,11,Resign,White
TRUE,77,10+0,1968,1817,151,A00,2,Resign,White
TRUE,87,10+0,1961,1805,156,D78,12,Out of Time,White
TRUE,91,10+0,1746,1979,-233,B40,5,Mate,White
TRUE,50,10+0,1878,1971,-93,B41,8,Mate,Black
TRUE,29,10+0,2086,1979,107,B24,8,Mate,White
TRUE,117,10+0,1992,1941,51,E60,5,Resign,Black
TRUE,47,10+0,1981,1977,4,D30,4,Resign,White
TRUE,150,10+0,1880,1972,-92,A45,2,Resign,Black
TRUE,10,10+0,1971,1244,727,D15,7,Resign,White
TRUE,108,10+0,1452,1970,-518,B21,3,Resign,Black
TRUE,42,10+0,1976,2152,-176,A49,5,Resign,Black
TRUE,87,10+0,1970,1785,185,C01,5,Mate,White
TRUE,69,10+0,2107,1978,129,B20,3,Out of Time,White
TRUE,94,10+0,1981,2303,-322,A49,5,Resign,Black
TRUE,56,10+0,1941,1971,-30,B40,4,Resign,Black
TRUE,47,10+0,1953,2149,-196,E10,12,Resign,White
TRUE,113,10+0,2287,1956,331,B21,10,Out of Time,White
TRUE,91,10+0,1890,1887,3,B50,5,Mate,White
TRUE,70,10+0,1516,1887,-371,B00,3,Resign,Black
TRUE,55,10+0,1886,1223,663,C41,5,Mate,White
TRUE,101,10+0,2312,1888,424,A03,2,Resign,White
TRUE,76,10+0,1807,1879,-72,B10,2,Mate,Black
TRUE,41,10+0,1872,1733,139,B00,4,Mate,White
TRUE,50,10+0,1878,2062,-184,B01,8,Resign,Black
TRUE,84,10+0,1910,1864,46,B12,7,Resign,Black
TRUE,109,10+0,1855,1791,64,C53,9,Mate,White
TRUE,69,10+0,1838,1986,-148,C55,6,Mate,White
TRUE,44,10+0,1602,1828,-226,B13,5,Mate,Black
FALSE,70,15+0,1673,1828,-155,B20,2,Resign,Black
FALSE,45,150+0,1828,1500,328,B20,2,Resign,White
FALSE,27,150+0,1500,1828,-328,C66,8,Resign,White
TRUE,46,20+8,1848,1559,289,C41,4,Resign,Black
TRUE,53,10+0,1815,1878,-63,B30,4,Resign,White
TRUE,27,10+0,2193,1892,301,B12,7,Resign,White
TRUE,99,10+0,1777,1908,-131,B18,8,Out of Time,White
TRUE,85,10+0,1902,1706,196,B30,4,Mate,White
TRUE,67,10+0,1899,1512,387,C55,6,Mate,White
TRUE,96,10+0,1805,1890,-85,E20,6,Mate,Black
TRUE,82,10+0,1903,1896,7,B50,5,Resign,Black
TRUE,48,10+0,1677,1897,-220,B32,8,Resign,Black
TRUE,54,10+0,1900,2246,-346,B30,4,Resign,Black
TRUE,112,10+0,1460,1427,33,A45,2,Out of Time,Black
TRUE,33,10+0,1426,987,439,B02,4,Resign,White
TRUE,59,10+0,1421,1186,235,C42,5,Resign,White
TRUE,119,10+0,1417,1432,-15,C54,11,Mate,White
TRUE,123,10+0,1428,1150,278,B01,4,Resign,White
TRUE,46,10+0,1415,1418,-3,E15,8,Resign,Black
TRUE,45,10+0,1405,1486,-81,E20,5,Mate,White
TRUE,41,10+0,1383,1464,-81,D55,11,Mate,White
TRUE,55,10+0,1317,1383,-66,C45,8,Resign,White
TRUE,63,10+0,1375,1269,106,C40,4,Resign,White
TRUE,89,10+0,1363,1418,-55,D21,6,Mate,White
TRUE,71,10+0,1392,1373,19,C55,6,Resign,White
FALSE,75,30+30,2234,2361,-127,C88,13,Resign,White
TRUE,43,10+0,2232,1652,580,B33,10,Resign,White
TRUE,54,10+0,1826,2228,-402,D02,5,Resign,Black
TRUE,94,10+0,2052,2217,-165,C53,9,Out of Time,Black
TRUE,40,10+0,2211,1871,340,C65,6,Resign,White
TRUE,93,10+0,1814,2207,-393,D02,5,Resign,Black
TRUE,110,10+0,2025,2194,-169,B50,4,Mate,Black
TRUE,77,10+0,2193,1511,682,B56,11,Mate,White
TRUE,74,10+0,1516,2192,-676,B50,4,Mate,Black
TRUE,43,10+0,2189,1773,416,B32,8,Resign,White
TRUE,118,10+0,1969,2178,-209,C34,6,Resign,Black
TRUE,102,10+0,2023,2163,-140,A22,5,Resign,Black
TRUE,62,10+0,2147,2031,116,B34,9,Resign,White
TRUE,66,10+0,1657,2143,-486,C46,5,Resign,Black
TRUE,22,10+0,2141,1578,563,B12,7,Resign,White
TRUE,81,10+0,2140,1521,619,C62,6,Resign,White
TRUE,62,10+0,1834,2132,-298,C77,9,Resign,Black
TRUE,46,10+0,1529,2130,-601,D37,12,Resign,Black
TRUE,105,10+0,2048,2150,-102,B45,10,Resign,White
TRUE,48,10+0,1792,2146,-354,E20,6,Resign,Black
TRUE,60,10+0,2167,1978,189,A24,6,Resign,Black
TRUE,50,10+0,2161,1923,238,A16,7,Resign,White
TRUE,54,10+0,1656,2160,-504,B44,8,Resign,Black
TRUE,96,10+0,1541,2159,-618,B13,5,Mate,Black
TRUE,63,10+0,2152,1950,202,A21,3,Out of Time,White
TRUE,21,10+0,2159,1749,410,C69,9,Resign,White
TRUE,69,10+0,2376,2166,210,A57,9,Resign,White
TRUE,71,10+0,2151,2167,-16,A28,7,Resign,White
TRUE,56,10+0,2084,2140,-56,B21,3,Resign,Black
TRUE,38,10+0,2032,2129,-97,A58,9,Resign,Black
TRUE,51,10+0,2126,1794,332,B53,7,Resign,White
TRUE,57,10+0,2120,1887,233,C00,3,Out of Time,White
TRUE,26,10+0,1927,2112,-185,B40,5,Resign,Black
TRUE,179,10+0,1814,2122,-308,B20,3,Draw,Draw
TRUE,61,10+0,2102,2255,-153,A30,2,Resign,White
TRUE,67,10+0,2101,1587,514,B53,7,Out of Time,White
TRUE,22,10+0,1491,2100,-609,A31,5,Resign,Black
TRUE,15,10+0,2187,2111,76,B10,2,Resign,White
TRUE,77,10+0,2115,2021,94,B40,4,Draw,Draw
TRUE,216,8+0,2393,2438,-45,D35,6,Draw,Draw
FALSE,51,20+10,2438,2146,292,B00,5,Resign,White
FALSE,1,20+10,2438,1666,772,B00,1,Out of Time,White
FALSE,79,20+10,2438,1658,780,B41,9,Draw,Draw
FALSE,60,20+10,2438,1692,746,B13,5,Draw,Draw
FALSE,1,20+10,2438,1885,553,B00,1,Out of Time,White
FALSE,23,20+10,2438,946,1492,B00,2,Mate,White
TRUE,44,8+0,2351,2414,-63,E54,12,Resign,Black
TRUE,110,9+3,2230,2396,-166,D41,9,Resign,Black
TRUE,147,15+15,1958,1978,-20,A03,2,Draw,Draw
TRUE,72,15+15,1834,1963,-129,C00,3,Resign,Black
TRUE,65,15+15,1948,1809,139,E20,5,Resign,White
TRUE,127,15+15,1962,1973,-11,C15,7,Resign,White
TRUE,39,15+15,1822,2012,-190,C16,7,Mate,White
TRUE,117,15+15,1993,1887,106,E20,8,Out of Time,White
TRUE,56,15+15,2018,2063,-45,D52,13,Resign,Black
TRUE,52,15+15,1641,2011,-370,C01,5,Resign,Black
TRUE,67,15+15,2192,2030,162,D02,5,Resign,White
TRUE,128,15+15,2067,2040,27,A70,15,Resign,Black
TRUE,142,15+15,1782,2054,-272,E20,8,Resign,Black
TRUE,133,15+15,2034,1835,199,D10,5,Mate,White
TRUE,43,15+15,1959,1953,6,D37,9,Resign,White
TRUE,147,15+15,1922,1798,124,D52,11,Resign,White
TRUE,48,15+15,1911,1844,67,C01,7,Mate,Black
TRUE,50,15+15,1787,1757,30,C00,3,Resign,Black
TRUE,67,15+15,1710,1499,211,D43,8,Mate,White
FALSE,19,10+5,1519,1135,384,B00,7,Resign,White
FALSE,16,7+2,1752,1519,233,C00,3,Resign,White
FALSE,64,7+2,1519,1752,-233,C21,5,Mate,Black
FALSE,65,7+2,1519,1304,215,B07,4,Mate,White
FALSE,28,15+0,1519,1445,74,C21,9,Resign,White
TRUE,34,10+0,1165,1504,-339,C44,5,Resign,Black
TRUE,52,5+5,1800,1023,777,C41,4,Out of Time,Black
TRUE,48,10+5,1804,1789,15,B00,3,Mate,Black
TRUE,87,10+5,1777,1807,-30,C60,6,Out of Time,White
TRUE,60,10+0,1782,2015,-233,D45,13,Resign,Black
TRUE,52,10+0,1961,1788,173,D10,5,Resign,White
TRUE,46,10+0,1622,1781,-159,B10,2,Resign,Black
TRUE,31,10+0,1727,1760,-33,B12,7,Resign,Black
TRUE,55,10+0,1750,1737,13,D45,9,Resign,White
TRUE,82,10+0,1698,1753,-55,B11,4,Resign,White
TRUE,21,10+0,1762,1842,-80,A51,4,Resign,Black
TRUE,32,15+3,1336,1275,61,A16,3,Mate,Black
TRUE,43,10+3,1295,1311,-16,D20,6,Resign,Black
TRUE,81,10+5,1325,1379,-54,D20,6,Resign,Black
TRUE,31,10+2,1302,1293,9,D21,6,Mate,White
TRUE,27,10+5,1431,1320,111,D07,6,Resign,White
TRUE,42,12+10,1333,1347,-14,B00,3,Resign,White
TRUE,46,10+5,1345,1340,5,C15,7,Resign,White
TRUE,124,10+10,1444,1300,144,B12,7,Mate,Black
TRUE,46,10+10,1331,1374,-43,A40,2,Out of Time,Black
TRUE,85,5+8,1387,1368,19,B10,2,Resign,White
TRUE,39,10+5,1419,1425,-6,D02,4,Mate,White
TRUE,38,10+5,1263,1387,-124,D02,4,Out of Time,Black
TRUE,53,10+5,1433,1458,-25,B12,5,Resign,White
TRUE,63,10+5,1372,1393,-21,D11,5,Resign,White
TRUE,37,10+5,1332,1081,251,C13,8,Resign,White
TRUE,114,10+5,1309,1375,-66,D20,5,Draw,Draw
FALSE,116,10+0,2068,2100,-32,C00,5,Resign,Black
FALSE,67,10+0,2068,1906,162,C40,4,Resign,White
FALSE,35,10+0,1818,2068,-250,B50,5,Resign,White
FALSE,22,5+12,2004,2068,-64,E61,6,Draw,Draw
FALSE,66,10+0,1937,2068,-131,E92,13,Out of Time,Black
FALSE,130,7+10,1814,2068,-254,B22,3,Resign,Black
FALSE,109,5+5,2068,2035,33,B07,6,Resign,White
TRUE,25,10+0,1959,1944,15,B98,14,Resign,White
TRUE,143,10+0,1936,1812,124,C44,8,Resign,White
TRUE,139,10+0,1941,1775,166,B18,8,Out of Time,Draw
TRUE,49,10+0,1950,2027,-77,B28,5,Resign,Black
TRUE,62,10+0,1966,1777,189,B13,7,Resign,Black
TRUE,36,10+0,1783,1960,-177,D37,12,Resign,Black
TRUE,108,10+0,2052,1946,106,B90,11,Resign,Black
TRUE,105,10+0,1931,2067,-136,C01,7,Resign,White
TRUE,24,10+0,1939,2060,-121,C02,9,Resign,Black
TRUE,51,10+0,1998,1948,50,B21,3,Resign,White
TRUE,82,10+0,1033,1469,-436,D20,6,Mate,Black
TRUE,54,10+0,1038,1380,-342,B30,5,Mate,Black
TRUE,81,10+0,1521,1040,481,B01,4,Mate,White
TRUE,66,1+25,1014,1328,-314,C00,5,Resign,Black
FALSE,61,5+5,1129,1014,115,C02,5,Mate,White
TRUE,66,10+0,1029,1084,-55,C42,5,Mate,Black
TRUE,50,10+0,908,1055,-147,B01,2,Resign,White
FALSE,57,10+0,1055,1163,-108,C42,4,Resign,White
TRUE,41,15+15,1024,1281,-257,A04,2,Resign,White
FALSE,61,10+0,1024,1151,-127,C62,6,Mate,White
TRUE,70,10+0,1037,1167,-130,B01,2,Out of Time,Black
TRUE,93,10+0,1129,1052,77,E60,5,Mate,White
TRUE,42,10+0,1061,1030,31,B01,4,Resign,Black
TRUE,9,10+0,1080,1003,77,A49,4,Resign,Black
TRUE,53,10+0,979,1011,-32,A50,3,Resign,White
TRUE,52,5+8,985,1323,-338,C41,4,Resign,Black
TRUE,55,15+15,1011,953,58,D31,5,Resign,Black
TRUE,37,15+15,1177,1052,125,B01,2,Resign,White
TRUE,80,15+15,1073,1170,-97,D06,4,Mate,Black
TRUE,50,20+0,1097,1192,-95,D20,6,Resign,Black
TRUE,45,30+0,1256,1120,136,B01,2,Resign,White
TRUE,49,30+0,1248,1149,99,B01,2,Resign,White
FALSE,60,15+10,1149,2013,-864,D10,5,Resign,Black
FALSE,47,15+10,2013,1149,864,D07,4,Mate,White
FALSE,69,15+0,1405,1149,256,B00,5,Resign,White
FALSE,18,15+0,1149,1405,-256,C44,5,Resign,Black
TRUE,57,10+0,1855,1915,-60,B81,13,Mate,White
TRUE,34,10+10,1890,1734,156,C07,7,Draw,Draw
FALSE,45,10+0,1890,2002,-112,C50,6,Resign,White
TRUE,53,5+8,1810,1723,87,E76,11,Out of Time,White
TRUE,51,5+8,1727,1562,165,C00,4,Mate,White
TRUE,44,5+8,1634,1500,134,B20,2,Mate,Black
FALSE,41,5+8,1500,1500,0,A40,2,Resign,White
TRUE,27,10+0,1823,1600,223,C41,5,Resign,White
TRUE,64,9+2,2015,2043,-28,A43,5,Mate,Black
TRUE,81,9+2,2031,2026,5,B06,7,Resign,White
TRUE,63,10+0,2030,1400,630,B01,4,Mate,White
TRUE,49,15+2,1985,2044,-59,A70,15,Resign,White
FALSE,138,15+15,2214,2253,-39,A46,5,Mate,Black
TRUE,91,25+15,2202,2213,-11,D12,8,Mate,White
TRUE,34,5+5,2211,2300,-89,A43,4,Resign,Black
TRUE,93,5+5,2194,2384,-190,A43,5,Out of Time,White
TRUE,92,12+15,2131,2185,-54,D59,16,Resign,Black
TRUE,98,10+0,1573,2184,-611,D30,4,Resign,Black
TRUE,109,10+10,2170,2266,-96,E10,6,Resign,White
TRUE,78,10+10,2270,2167,103,D00,3,Draw,Draw
TRUE,80,8+0,2289,2152,137,B52,6,Out of Time,Black
TRUE,77,10+2,2142,2104,38,A49,4,Out of Time,White
TRUE,166,15+0,2008,2135,-127,A03,2,Out of Time,Black
TRUE,47,15+2,2126,2072,54,E14,7,Resign,White
TRUE,71,1+30,2136,2170,-34,D04,6,Resign,Black
TRUE,60,9+0,1952,2130,-178,B50,4,Resign,Black
TRUE,55,10+0,1940,1847,93,D11,7,Mate,White
TRUE,27,10+0,1934,1726,208,A40,6,Resign,White
TRUE,96,10+0,1994,1919,75,C52,14,Mate,Black
TRUE,81,10+0,1934,1881,53,E61,6,Resign,Black
TRUE,90,10+0,1784,1926,-142,D53,10,Resign,Black
TRUE,54,10+0,1843,1915,-72,D30,7,Resign,Black
TRUE,105,10+0,1906,1792,114,D53,8,Resign,White
TRUE,83,10+0,1899,1720,179,A40,1,Resign,White
TRUE,76,10+0,1335,1898,-563,D01,7,Mate,Black
TRUE,89,10+0,1893,1649,244,D11,5,Mate,White
TRUE,35,10+0,1887,1665,222,A46,3,Resign,White
TRUE,80,10+0,1765,1878,-113,D00,2,Mate,Black
TRUE,84,10+0,1715,1870,-155,D55,11,Resign,Black
TRUE,37,10+0,1866,1521,345,A40,1,Resign,White
TRUE,100,10+0,1646,1860,-214,C77,9,Mate,Black
TRUE,68,10+0,1880,1707,173,D02,3,Resign,Black
TRUE,25,10+0,1856,2190,-334,D52,12,Resign,White
TRUE,70,10+0,1559,1852,-293,C77,9,Resign,Black
TRUE,153,10+0,1849,1919,-70,E32,7,Out of Time,Draw
TRUE,1,10+0,1878,1860,18,A00,1,Resign,Black
TRUE,85,10+0,1955,1890,65,C55,11,Mate,White
TRUE,81,10+0,1902,1952,-50,D55,12,Resign,Black
TRUE,102,10+0,1629,1897,-268,C77,9,Resign,Black
TRUE,62,10+0,1758,1887,-129,C50,11,Resign,Black
TRUE,35,10+0,1886,1345,541,D21,6,Mate,White
TRUE,124,10+0,1856,1872,-16,D02,5,Resign,Black
TRUE,61,10+0,2060,1910,150,D43,8,Mate,White
TRUE,72,10+0,1981,1941,40,D43,8,Resign,Black
TRUE,41,10+0,1924,1905,19,D30,7,Resign,White
TRUE,57,10+0,1892,1945,-53,B07,3,Mate,White
TRUE,37,10+0,1859,1969,-110,C30,5,Resign,White
TRUE,17,10+0,1985,2047,-62,A02,1,Resign,Black
TRUE,6,10+0,1959,2008,-49,B10,5,Resign,White
TRUE,2,10+0,2029,2025,4,B02,2,Resign,Black
TRUE,7,10+0,2058,1945,113,B01,4,Resign,Black
TRUE,97,10+0,1929,2090,-161,C23,5,Resign,White
TRUE,67,10+0,2076,1922,154,E64,12,Resign,White
TRUE,71,10+0,2080,2032,48,D30,8,Draw,Draw
TRUE,138,10+0,1944,2090,-146,C30,3,Draw,Draw
TRUE,40,5+8,1795,1760,35,A46,5,Resign,Black
TRUE,111,15+0,1729,1795,-66,D31,5,Mate,White
TRUE,54,10+0,1795,1784,11,C64,6,Mate,Black
TRUE,33,10+0,1770,1872,-102,D02,3,Resign,White
TRUE,90,10+0,1783,1721,62,D02,5,Resign,Black
TRUE,90,10+0,1884,1768,116,C64,7,Resign,Black
TRUE,40,10+0,1756,1756,0,C24,5,Mate,Black
TRUE,49,8+0,1724,1958,-234,A43,5,Out of Time,White
TRUE,50,10+0,2036,1706,330,A08,6,Resign,Black
TRUE,59,10+0,1706,925,781,D02,5,Mate,White
TRUE,104,7+2,1389,1307,82,C20,5,Mate,Black
FALSE,33,10+0,1678,1299,379,C21,10,Resign,White
TRUE,64,10+5,1152,1299,-147,C20,3,Mate,Black
TRUE,62,10+0,1303,1634,-331,C60,6,Out of Time,Black
TRUE,47,10+0,1278,1530,-252,C60,6,Mate,White
TRUE,30,10+0,1595,1281,314,C22,6,Resign,White
TRUE,24,10+0,1267,1344,-77,C68,8,Resign,White
TRUE,20,45+1,1332,1277,55,C50,8,Resign,White
FALSE,66,30+0,1213,1277,-64,C50,8,Resign,Black
FALSE,12,120+10,1277,1047,230,C40,3,Out of Time,Black
FALSE,63,120+10,1047,1277,-230,D00,3,Resign,Black
TRUE,82,30+0,1393,1285,108,D00,3,Resign,White
TRUE,87,30+0,1279,1090,189,B02,2,Resign,White
TRUE,19,8+0,1268,1255,13,C40,4,Resign,White
TRUE,59,15+10,1186,1283,-97,C20,3,Mate,White
FALSE,124,8+0,1283,1267,16,B30,5,Mate,Black
TRUE,96,10+4,1290,1270,20,A00,1,Resign,Black
TRUE,53,12+0,1331,1281,50,D00,4,Out of Time,White
TRUE,39,10+0,1304,1292,12,A00,1,Mate,White
TRUE,10,10+0,1305,1293,12,C00,3,Mate,Black
TRUE,51,10+0,1308,1317,-9,C22,8,Mate,White
TRUE,18,15+0,1296,1305,-9,C54,13,Resign,Black
FALSE,106,30+0,968,1305,-337,C50,8,Mate,Black
FALSE,38,15+15,1293,1466,-173,C41,5,Mate,Black
TRUE,59,7+2,1500,1299,201,C68,7,Mate,White
TRUE,111,7+2,1288,1232,56,B12,3,Mate,White
TRUE,28,7+2,1289,2108,-819,C77,9,Resign,Black
FALSE,101,7+2,1431,1289,142,C22,6,Out of Time,White
FALSE,15,7+2,1806,1289,517,C45,7,Mate,White
FALSE,42,7+2,1289,1311,-22,C41,5,Resign,White
FALSE,118,7+2,1431,1289,142,A40,3,Resign,Black
FALSE,34,7+2,1289,1484,-195,C50,6,Resign,Black
FALSE,60,7+2,1289,1810,-521,A42,5,Resign,Black
FALSE,66,7+2,1806,1289,517,C44,5,Resign,Black
FALSE,21,5+8,1289,1500,-211,C41,5,Out of Time,White
TRUE,73,15+1,1409,1297,112,C70,8,Mate,White
TRUE,159,15+1,1280,1485,-205,C55,6,Mate,White
FALSE,74,15+0,1280,1211,69,B01,4,Resign,White
FALSE,28,15+0,1211,1280,-69,A00,3,Mate,Black
TRUE,112,10+0,1281,1765,-484,C41,6,Mate,Black
TRUE,86,10+0,1813,1796,17,A89,14,Resign,Black
TRUE,56,10+0,1810,1720,90,B56,10,Resign,Black
TRUE,125,10+0,1798,1836,-38,C64,7,Resign,White
TRUE,55,10+0,1795,1831,-36,B30,5,Resign,White
TRUE,112,10+0,1809,1729,80,B00,2,Resign,Black
TRUE,64,10+0,1816,1956,-140,C00,3,Resign,Black
TRUE,55,10+0,1803,1839,-36,B03,10,Resign,White
TRUE,175,10+0,1767,1816,-49,B21,3,Out of Time,White
TRUE,56,10+0,1759,1806,-47,A85,5,Resign,Black
TRUE,37,10+0,1529,1826,-297,B50,4,Mate,White
TRUE,156,15+5,1819,2071,-252,C94,19,Draw,Draw
TRUE,81,10+0,1808,1798,10,C63,6,Resign,White
TRUE,67,10+0,1819,1819,0,B20,3,Resign,White
TRUE,86,10+0,1832,1807,25,C62,6,Resign,Black
TRUE,70,10+0,1878,1819,59,A80,3,Mate,Black
FALSE,106,15+5,1661,1819,-158,B20,3,Mate,Black
TRUE,56,10+0,1703,1810,-107,B50,5,Mate,Black
TRUE,39,15+5,1809,1184,625,B00,4,Mate,White
TRUE,100,10+0,1823,1766,57,B12,5,Mate,Black
TRUE,117,10+0,1815,1683,132,C60,6,Mate,White
TRUE,63,10+0,1797,2024,-227,B03,13,Resign,White
TRUE,86,10+0,1892,1782,110,B20,3,Out of Time,Black
TRUE,80,10+0,1777,1769,8,A85,5,Mate,Black
TRUE,69,15+5,1767,1356,411,B30,5,Resign,White
FALSE,71,17+3,1767,1226,541,A00,1,Mate,White
FALSE,81,17+3,1226,1767,-541,B52,6,Resign,White
TRUE,59,15+5,1228,1766,-538,B50,4,Resign,Black
FALSE,109,15+5,1766,1218,548,B90,11,Resign,White
TRUE,34,15+5,1219,1765,-546,B50,4,Mate,Black
TRUE,113,15+0,1989,1770,219,B84,12,Resign,White
TRUE,134,15+0,1776,1984,-208,B43,9,Out of Time,Black
TRUE,103,5+8,1928,1782,146,B20,3,Resign,White
TRUE,53,1+19,1770,1803,-33,C42,5,Resign,White
TRUE,47,15+0,1852,1779,73,A85,5,Resign,White
TRUE,54,15+0,1789,1842,-53,B30,5,Resign,Black
TRUE,143,15+0,1832,1799,33,A80,2,Out of Time,White
TRUE,24,5+5,1973,1782,191,A80,2,Resign,Black
TRUE,33,5+8,1767,1875,-108,B15,5,Mate,White
TRUE,67,15+0,1755,1778,-23,C41,8,Mate,White
TRUE,53,15+0,1738,1911,-173,C15,6,Resign,White
TRUE,54,10+0,1824,1724,100,B50,4,Resign,Black
TRUE,49,10+0,1812,1709,103,A85,5,Resign,Black
TRUE,30,6+6,1715,1886,-171,C70,8,Resign,Black
TRUE,41,15+0,1481,1734,-253,B20,3,Resign,White
TRUE,62,15+6,1750,1721,29,B80,13,Mate,Black
TRUE,118,7+5,1842,1705,137,A84,4,Resign,Black
TRUE,66,10+10,1709,2015,-306,C41,8,Resign,Black
FALSE,10,30+30,2454,1848,606,A15,4,Resign,White
FALSE,43,10+10,1848,2272,-424,E21,8,Out of Time,White
FALSE,61,10+0,1557,1536,21,C42,5,Resign,White
FALSE,85,10+0,1536,1500,36,B02,4,Out of Time,White
FALSE,45,10+0,1482,1536,-54,D20,5,Mate,White
FALSE,23,10+0,1500,1536,-36,C22,7,Mate,White
FALSE,36,10+0,1536,1480,56,C53,7,Resign,Black
FALSE,144,10+0,1536,1500,36,C41,5,Resign,Black
FALSE,88,10+0,1500,1536,-36,D00,3,Mate,Black
FALSE,45,10+0,1536,1414,122,C40,3,Resign,White
FALSE,40,10+0,1414,1536,-122,C42,5,Resign,Black
FALSE,30,10+0,1536,1500,36,C00,4,Resign,Black
FALSE,23,10+0,1536,1500,36,B01,6,Resign,White
FALSE,196,10+0,1401,1536,-135,C20,3,Mate,Black
FALSE,59,10+0,1536,1500,36,C41,6,Resign,White
FALSE,61,10+0,1536,1500,36,C50,8,Resign,White
FALSE,58,10+0,1536,1500,36,B30,4,Resign,Black
FALSE,15,10+0,1500,1536,-36,D00,9,Resign,White
FALSE,51,10+0,1589,1536,53,A04,2,Resign,White
FALSE,55,10+0,1536,1589,-53,B20,3,Resign,White
FALSE,55,10+0,1469,1536,-67,C48,8,Resign,White
FALSE,62,10+0,1536,1469,67,B00,2,Resign,Black
FALSE,74,10+0,1536,1425,111,C40,3,Resign,Black
FALSE,134,10+10,1536,1550,-14,C00,5,Mate,Black
FALSE,87,10+10,1550,1536,14,C77,9,Resign,White
FALSE,54,10+10,1536,1550,-14,A15,3,Mate,Black
FALSE,189,10+10,1550,1536,14,C41,5,Mate,White
FALSE,66,10+10,1536,1550,-14,C02,7,Mate,Black
FALSE,79,10+10,1550,1536,14,C62,6,Mate,White
FALSE,58,10+0,1536,1500,36,C55,6,Resign,Black
FALSE,21,10+0,1536,1557,-21,C00,3,Resign,Black
FALSE,148,10+0,1500,1536,-36,D02,3,Mate,Black
FALSE,43,10+0,1536,1542,-6,C40,4,Resign,White
FALSE,58,10+0,1542,1536,6,C20,3,Mate,Black
FALSE,103,10+0,1536,1542,-6,B00,2,Resign,White
TRUE,104,15+10,1690,1730,-40,B77,17,Resign,Black
TRUE,106,10+5,1010,1730,-720,A00,1,Mate,Black
TRUE,31,10+5,1729,1012,717,A05,10,Resign,White
TRUE,12,10+5,1014,1728,-714,B57,8,Resign,Black
FALSE,96,8+0,2384,2199,185,B40,4,Out of Time,Black
TRUE,63,10+0,2212,2231,-19,B20,3,Resign,White
TRUE,349,10+0,2194,2240,-46,D30,13,Out of Time,White
TRUE,157,10+0,2162,2122,40,D31,7,Resign,White
TRUE,23,10+0,2426,2178,248,C50,9,Resign,White
TRUE,64,10+0,2196,2420,-224,D35,10,Resign,Black
TRUE,46,10+0,2413,2219,194,E51,10,Resign,White
TRUE,67,10+0,2247,2405,-158,D35,10,Resign,Black
FALSE,69,10+0,1832,1452,380,B20,2,Mate,White
FALSE,50,10+0,1452,1832,-380,A25,4,Mate,Black
FALSE,87,10+0,1832,1452,380,A04,2,Mate,White
TRUE,45,10+0,1473,1462,11,B10,2,Resign,White
TRUE,24,10+0,1246,1457,-211,A03,2,Mate,Black
TRUE,25,10+0,1451,1327,124,A10,2,Mate,White
TRUE,32,10+0,1460,1513,-53,C44,5,Resign,Black
TRUE,78,10+0,1468,1539,-71,A10,2,Resign,Black
TRUE,26,10+0,1617,1453,164,B20,3,Resign,Black
TRUE,29,10+0,1446,1430,16,A00,1,Resign,Black
TRUE,60,10+0,1379,1421,-42,D02,3,Resign,Black
TRUE,47,10+0,1417,1140,277,A20,2,Resign,White
TRUE,44,10+0,1478,1404,74,D00,2,Out of Time,Black
TRUE,63,10+0,1393,1409,-16,A25,4,Resign,White
TRUE,73,10+0,1403,1424,-21,B01,2,Resign,Black
TRUE,61,10+0,1405,1414,-9,B12,7,Resign,White
TRUE,51,10+0,1406,1325,81,A20,2,Resign,White
TRUE,109,10+0,1394,1424,-30,A04,2,Out of Time,White
TRUE,31,10+0,1437,1382,55,B10,2,Resign,Black
TRUE,39,10+0,1372,1343,29,A04,2,Mate,White
TRUE,66,10+0,1298,1363,-65,B10,2,Resign,Black
TRUE,10,10+0,1337,1352,-15,B18,8,Resign,Black
TRUE,89,10+0,1343,1303,40,A10,1,Resign,White
TRUE,50,10+0,1356,1353,3,B21,3,Resign,White
TRUE,14,10+0,1362,1446,-84,C20,3,Resign,Black
TRUE,77,10+0,1369,1508,-139,A04,2,Resign,Black
TRUE,34,10+0,1383,1299,84,C20,3,Resign,Black
TRUE,151,10+0,1369,1395,-26,D00,3,Mate,White
TRUE,42,10+0,1387,1268,119,D02,5,Resign,White
TRUE,24,10+0,1241,1380,-139,B15,5,Resign,Black
TRUE,104,10+0,1243,1361,-118,A11,2,Resign,Black
TRUE,82,10+0,1373,1367,6,C40,4,Mate,Black
TRUE,71,10+0,1361,1361,0,C20,3,Mate,White
TRUE,51,10+0,1382,1373,9,D10,4,Mate,White
TRUE,39,10+0,1333,1386,-53,B20,3,Resign,White
TRUE,88,10+0,1398,1376,22,C20,3,Resign,Black
TRUE,40,10+0,1387,1386,1,D00,3,Resign,Black
TRUE,45,10+0,1396,1457,-61,D02,4,Resign,Black
TRUE,107,10+0,1383,1420,-37,C20,3,Mate,White
TRUE,54,10+0,1350,1372,-22,B20,3,Mate,Black
TRUE,34,10+0,1385,1355,30,B22,3,Mate,Black
TRUE,70,10+0,1237,1378,-141,B12,5,Mate,Black
TRUE,43,10+0,1402,1389,13,B15,5,Mate,White
TRUE,35,10+0,1382,1242,140,B00,2,Resign,White
TRUE,39,10+0,1382,1373,9,B01,2,Draw,Draw
TRUE,47,10+0,1477,1392,85,A00,1,Resign,White
TRUE,63,10+0,1378,1406,-28,C55,7,Mate,White
FALSE,40,10+0,1329,1424,-95,B56,9,Resign,White
TRUE,129,10+0,1284,1446,-162,A04,2,Out of Time,White
TRUE,90,10+0,1387,1436,-49,C20,4,Mate,Black
TRUE,45,10+0,1430,1282,148,C46,5,Resign,White
TRUE,118,10+0,1453,1380,73,C46,5,Mate,Black
TRUE,49,10+0,1446,1317,129,C46,7,Mate,White
TRUE,64,10+0,1459,1392,67,C41,4,Resign,Black
TRUE,42,10+0,1434,1449,-15,C58,11,Mate,Black
FALSE,35,5+7,2621,1449,1172,C50,9,Mate,White
TRUE,34,30+0,1151,1424,-273,B01,2,Draw,Draw
FALSE,25,30+0,1151,1424,-273,B50,4,Resign,White
FALSE,40,10+0,1329,1424,-95,B56,9,Resign,White
FALSE,20,30+0,1149,1424,-275,B21,3,Resign,White
TRUE,98,10+0,1426,1357,69,A00,1,Draw,Draw
FALSE,37,30+0,1149,1426,-277,C45,7,Resign,White
TRUE,70,7+2,1621,1579,42,A22,5,Mate,Black
TRUE,60,7+2,1608,1610,-2,B10,2,Mate,Black
TRUE,53,7+2,1597,1630,-33,A10,6,Mate,White
TRUE,66,7+2,1620,1609,11,B07,6,Resign,White
TRUE,80,7+2,1618,1687,-69,A10,2,Out of Time,Black
TRUE,53,7+2,1608,1568,40,A34,5,Out of Time,White
TRUE,111,7+2,1595,1517,78,A10,2,Draw,Draw
TRUE,50,7+2,1516,1586,-70,A53,7,Out of Time,Black
TRUE,22,7+2,1514,1576,-62,A53,4,Resign,Black
TRUE,83,7+2,1564,1549,15,A30,2,Mate,White
TRUE,109,7+2,1551,1562,-11,A30,2,Mate,White
TRUE,61,7+2,1536,1610,-74,A25,4,Resign,White
TRUE,61,7+2,1569,1548,21,C15,7,Resign,White
TRUE,63,7+2,1535,1556,-21,A15,2,Out of Time,White
TRUE,43,7+2,1521,1543,-22,D20,5,Mate,White
TRUE,61,7+2,1536,1535,1,B10,2,Resign,White
TRUE,98,7+2,1543,1682,-139,D35,10,Out of Time,Black
TRUE,107,7+2,1645,1539,106,B10,2,Draw,Draw
TRUE,94,7+2,1554,1529,25,D20,6,Resign,Black
TRUE,86,7+2,1577,1538,39,B10,2,Resign,Black
TRUE,31,7+2,1522,1583,-61,D35,7,Resign,White
TRUE,133,7+2,1529,1537,-8,B00,3,Mate,White
TRUE,72,7+2,1514,1522,-8,D10,4,Mate,Black
TRUE,88,7+2,1519,1604,-85,D35,7,Draw,Draw
TRUE,126,7+2,1622,1514,108,D00,3,Draw,Draw
TRUE,75,7+2,1499,1498,1,D06,4,Mate,White
TRUE,89,7+2,1516,1515,1,B10,2,Resign,White
TRUE,52,7+2,1532,1517,15,D35,9,Resign,Black
TRUE,104,7+2,1512,1514,-2,B10,2,Mate,Black
TRUE,59,7+2,1560,1531,29,B10,2,Resign,White
TRUE,83,7+2,1513,1507,6,A40,2,Mate,White
TRUE,66,7+2,1526,1642,-116,A40,2,Mate,Black
TRUE,24,7+2,1548,1503,45,A40,1,Mate,Black
TRUE,52,7+2,1512,1751,-239,D45,10,Resign,Black
TRUE,90,7+2,1469,1491,-22,D02,4,Resign,Black
TRUE,59,7+2,1486,1516,-30,A00,5,Out of Time,White
TRUE,14,7+2,1651,1481,170,C55,6,Out of Time,Black
TRUE,132,7+2,1480,1495,-15,A84,5,Draw,Draw
TRUE,126,7+2,1497,1637,-140,D02,5,Resign,Black
TRUE,82,7+2,1510,1725,-215,D02,3,Resign,Black
TRUE,68,10+0,1338,1326,12,C68,7,Resign,Black
TRUE,126,10+0,1337,1352,-15,B10,2,Draw,Draw
TRUE,55,10+0,1329,1253,76,C44,5,Resign,White
TRUE,98,10+0,1263,1320,-57,C41,5,Mate,Black
TRUE,95,10+0,1331,1331,0,D00,2,Resign,White
TRUE,60,10+0,1345,1208,137,C20,3,Resign,Black
TRUE,137,10+0,1236,1360,-124,C20,3,Resign,White
TRUE,43,10+0,1378,1370,8,C41,5,Resign,White
TRUE,52,10+0,1379,1424,-45,B06,2,Mate,Black
TRUE,70,10+0,1512,1365,147,A07,3,Resign,Black
TRUE,48,10+0,1373,1455,-82,B20,3,Mate,Black
TRUE,43,10+0,1382,1441,-59,C20,3,Resign,Black
TRUE,94,10+0,1214,1376,-162,C41,5,Mate,Black
TRUE,86,10+0,1378,1298,80,C00,2,Draw,Draw
TRUE,46,10+0,1393,1367,26,D20,6,Resign,Black
TRUE,44,10+0,1363,1450,-87,C20,3,Resign,Black
TRUE,56,10+0,1346,1353,-7,C41,5,Resign,Black
TRUE,28,10+0,1364,1349,15,B01,2,Resign,Black
TRUE,27,10+0,1337,1376,-39,C41,5,Resign,White
TRUE,61,10+0,1385,1377,8,C41,5,Resign,White
TRUE,37,10+0,1371,1193,178,C20,3,Resign,White
TRUE,47,10+0,1364,1351,13,C41,4,Resign,Black
TRUE,96,10+0,1257,1343,-86,C42,5,Mate,Black
TRUE,51,10+0,1334,1265,69,C20,3,Mate,White
TRUE,11,10+0,1252,1348,-96,C23,3,Mate,White
TRUE,40,10+0,1353,1581,-228,C20,3,Resign,Black
TRUE,52,10+0,1362,1388,-26,B20,2,Resign,Black
TRUE,43,10+0,1377,1373,4,C41,5,Resign,White
TRUE,50,10+0,1292,1364,-72,C20,3,Mate,Black
TRUE,88,10+0,1210,1358,-148,A00,1,Resign,Black
TRUE,76,10+0,1368,1390,-22,C40,4,Mate,Black
TRUE,58,10+0,1379,1357,22,C41,4,Resign,Black
TRUE,53,10+0,1345,1377,-32,C20,3,Resign,White
TRUE,147,10+0,1339,1185,154,C20,3,Mate,White
TRUE,21,10+0,1169,1343,-174,C41,5,Resign,White
TRUE,102,10+0,1511,1328,183,C41,5,Resign,Black
TRUE,5,10+0,1328,1362,-34,B20,2,Out of Time,White
TRUE,38,10+0,1332,1551,-219,C00,3,Resign,Black
TRUE,68,10+0,1349,1321,28,C41,5,Mate,Black
TRUE,41,10+0,1309,1297,12,C44,4,Mate,White
TRUE,29,10+0,1300,1233,67,C68,7,Resign,White
TRUE,123,10+0,1428,1150,278,B01,4,Resign,White
TRUE,92,10+0,1139,1404,-265,D02,4,Mate,Black
TRUE,116,10+0,1166,1123,43,A00,1,Resign,Black
TRUE,54,10+0,1137,1359,-222,D02,4,Mate,Black
TRUE,53,10+0,1497,1141,356,A06,3,Mate,White
TRUE,41,10+0,1383,1147,236,A00,1,Mate,White
TRUE,72,10+0,1148,1880,-732,A46,4,Mate,Black
TRUE,52,10+0,1150,1596,-446,A40,2,Mate,Black
TRUE,15,10+0,1445,1473,-28,C48,8,Resign,White
TRUE,62,10+0,1454,1488,-34,C61,6,Mate,Black
TRUE,73,10+0,1508,1441,67,C41,4,Resign,Black
TRUE,62,15+0,1450,1516,-66,B22,3,Resign,Black
TRUE,25,15+0,1506,1460,46,C34,6,Resign,White
TRUE,58,15+0,1436,1449,-13,A49,4,Resign,Black
TRUE,72,10+5,1478,1473,5,C00,3,Resign,Black
TRUE,82,10+5,1487,1559,-72,C42,5,Mate,Black
TRUE,75,10+5,1550,1496,54,C41,4,Mate,White
TRUE,97,15+6,1499,1431,68,C78,11,Draw,Draw
TRUE,45,15+10,1486,1526,-40,C00,3,Resign,White
TRUE,66,15+1,1499,1433,66,B22,3,Mate,Black
TRUE,44,15+15,1242,1494,-252,C41,5,Mate,Black
TRUE,103,15+15,1490,1247,243,C41,5,Resign,White
TRUE,49,20+0,1803,1493,310,C64,6,Mate,White
TRUE,170,20+0,1545,1491,54,B00,3,Draw,Draw
TRUE,66,10+5,1489,1604,-115,B01,4,Mate,Black
TRUE,68,15+0,1506,1500,6,D15,8,Resign,White
TRUE,97,8+0,1489,1498,-9,C41,5,Resign,White
TRUE,61,15+0,1471,1487,-16,A45,3,Resign,White
TRUE,136,15+0,1499,1458,41,C41,4,Mate,Black
TRUE,128,8+5,1397,1491,-94,C20,3,Mate,Black
TRUE,116,20+0,1504,1450,54,C48,7,Mate,Black
TRUE,35,20+0,1761,1508,253,D20,5,Resign,White
TRUE,55,20+0,1518,1546,-28,C68,7,Resign,Black
TRUE,57,20+0,1536,1528,8,C62,6,Mate,White
TRUE,63,20+0,1517,1547,-30,C62,6,Resign,White
TRUE,56,15+10,1526,1580,-54,B22,3,Resign,Black
TRUE,32,5+30,1675,1510,165,A01,2,Resign,Black
TRUE,83,20+0,1498,1206,292,C40,4,Mate,White
TRUE,69,10+5,1279,1515,-236,C45,11,Resign,White
TRUE,105,15+5,1502,1603,-101,C72,9,Resign,White
TRUE,34,10+0,1392,1494,-102,C41,5,Resign,Black
TRUE,27,30+10,1480,1580,-100,C64,6,Mate,White
TRUE,54,30+10,1596,1466,130,A16,3,Resign,Black
TRUE,80,15+5,1470,1694,-224,B10,2,Mate,Black
TRUE,84,20+0,1482,1454,28,B09,11,Resign,Black
TRUE,61,15+10,1480,1430,50,C42,5,Mate,White
TRUE,45,15+10,1416,1493,-77,C62,6,Mate,White
TRUE,139,8+10,1475,1505,-30,B07,7,Mate,White
TRUE,50,10+0,1432,1493,-61,C20,3,Resign,Black
TRUE,40,10+0,1404,1485,-81,C42,5,Mate,Black
TRUE,105,10+0,1474,1468,6,D00,3,Resign,White
TRUE,78,10+0,1485,1484,1,A40,1,Resign,Black
TRUE,88,10+0,1495,1474,21,C26,5,Resign,Black
TRUE,27,10+0,1500,1481,19,C42,5,Resign,White
TRUE,45,10+0,1470,1479,-9,A40,2,Resign,White
TRUE,17,10+0,1476,1481,-5,C42,5,Mate,White
TRUE,45,10+0,1500,1488,12,C42,5,Resign,White
TRUE,62,10+0,1493,1477,16,C26,5,Resign,Black
TRUE,106,10+0,1459,1466,-7,C42,9,Resign,Black
TRUE,72,10+0,1476,1513,-37,D00,3,Resign,Black
TRUE,17,10+0,1303,1491,-188,C20,2,Resign,White
TRUE,35,10+0,1503,1477,26,A43,3,Resign,Black
TRUE,41,10+0,1520,1513,7,C20,3,Mate,White
TRUE,14,10+0,1511,1576,-65,A43,3,Draw,Draw
TRUE,51,10+0,1446,1517,-71,C42,5,Resign,White
TRUE,97,10+0,1532,1517,15,C43,6,Draw,Draw
TRUE,72,10+0,1528,1517,11,D00,3,Resign,Black
TRUE,15,10+0,1814,1531,283,C34,6,Resign,White
TRUE,19,10+0,1549,1541,8,A00,1,Mate,White
TRUE,21,10+0,1531,1526,5,D00,3,Resign,White
TRUE,58,10+0,1544,1465,79,D00,3,Resign,Black
TRUE,25,10+0,1532,1595,-63,A45,2,Mate,White
FALSE,74,7+11,1306,1500,-194,C46,7,Resign,Black
FALSE,38,10+6,1500,1500,0,C44,4,Resign,Black
FALSE,35,10+0,1754,1500,254,C50,8,Resign,White
FALSE,61,8+2,1640,1500,140,C46,5,Resign,White
FALSE,86,8+2,1500,1640,-140,C50,5,Resign,Black
FALSE,20,10+5,1500,1544,-44,C41,5,Resign,White
FALSE,89,10+5,1544,1500,44,C30,4,Resign,White
FALSE,47,15+0,1978,1500,478,E90,9,Resign,White
FALSE,63,15+7,1500,1493,7,C53,9,Out of Time,White
TRUE,65,10+0,1281,1196,85,A40,1,Mate,White
TRUE,51,10+0,1416,1201,215,B10,2,Resign,White
TRUE,22,10+0,1212,1218,-6,E61,4,Resign,Black
TRUE,46,10+0,1224,1222,2,D06,4,Resign,Black
TRUE,61,10+0,1547,1227,320,B10,2,Resign,White
TRUE,36,10+0,1565,1207,358,B12,5,Resign,Black
TRUE,133,10+0,1208,1871,-663,D30,4,Resign,Black
TRUE,65,10+0,1099,1222,-123,A45,3,Out of Time,White
TRUE,59,10+0,1397,1228,169,B10,2,Resign,White
TRUE,28,10+0,1219,1162,57,A40,2,Resign,White
TRUE,53,10+0,1406,1224,182,B15,9,Out of Time,White
TRUE,55,10+0,1317,1233,84,B10,2,Out of Time,White
TRUE,36,10+0,1281,1220,61,B10,2,Mate,Black
TRUE,64,10+0,1232,1198,34,D11,7,Out of Time,Black
TRUE,55,10+0,1222,1202,20,A43,2,Resign,White
TRUE,71,10+0,1650,1661,-11,C24,4,Resign,White
TRUE,31,10+0,1652,1593,59,C45,7,Resign,White
TRUE,111,10+0,1658,1663,-5,C45,9,Resign,White
TRUE,99,10+0,1730,1672,58,E88,14,Resign,White
TRUE,85,10+0,1817,1683,134,B30,4,Resign,Black
TRUE,35,10+0,1617,1697,-80,B30,4,Resign,White
TRUE,26,10+0,1688,1612,76,C50,6,Resign,White
TRUE,106,10+0,1573,1680,-107,A02,1,Mate,Black
TRUE,17,10+0,1691,1699,-8,B06,7,Resign,Black
FALSE,13,10+2,2549,1425,1124,B10,8,Resign,White
FALSE,55,10+25,2621,1425,1196,B12,5,Mate,White
TRUE,69,20+10,1352,1304,48,C44,5,Mate,White
TRUE,57,15+10,1324,1407,-83,B00,3,Draw,Draw
FALSE,1,10+20,2621,1324,1297,A40,1,Out of Time,White
TRUE,86,10+0,1500,1500,0,C00,4,Out of Time,Black
TRUE,29,10+0,1815,1727,88,B12,7,Resign,White
TRUE,118,15+0,1674,1717,-43,B21,5,Resign,Black
TRUE,50,10+0,1748,1705,43,B10,3,Resign,Black
TRUE,65,10+0,1645,1601,44,C53,7,Resign,White
TRUE,40,10+0,1613,1613,0,A45,2,Mate,Black
TRUE,50,10+0,1655,1599,56,A40,2,Resign,Black
TRUE,37,10+0,1488,1616,-128,C50,6,Resign,White
TRUE,8,10+0,1631,1547,84,A40,2,Resign,Black
TRUE,36,10+0,1636,1895,-259,C53,7,Resign,Black
TRUE,57,10+0,1643,1693,-50,B50,6,Resign,White
TRUE,45,10+0,1591,1389,202,B23,5,Resign,White
TRUE,39,10+0,1372,1401,-29,D30,7,Resign,White
TRUE,54,10+0,1411,1407,4,C60,6,Resign,Black
TRUE,87,10+0,1395,1423,-28,D00,3,Resign,White
TRUE,46,10+0,1424,1395,29,C65,6,Draw,Draw
TRUE,60,10+0,1435,1404,31,C65,6,Resign,Black
TRUE,67,10+0,1425,1400,25,C60,6,Mate,White
TRUE,82,10+0,1390,1416,-26,B20,3,Mate,Black
TRUE,75,10+0,1427,1426,1,B21,3,Mate,White
TRUE,76,10+0,1438,1415,23,C40,4,Out of Time,Black
TRUE,64,10+0,1426,1427,-1,B21,3,Resign,Black
TRUE,54,10+0,1256,1421,-165,E20,8,Mate,Black
TRUE,48,10+0,1405,1586,-181,C41,5,Resign,White
TRUE,52,10+0,1415,1431,-16,C62,6,Out of Time,Black
TRUE,51,10+0,1487,1424,63,C48,7,Mate,White
TRUE,36,10+0,1434,1478,-44,C41,5,Resign,Black
TRUE,93,10+0,1384,1446,-62,A04,2,Resign,White
TRUE,93,10+0,1555,1454,101,B20,3,Resign,White
TRUE,36,10+0,1461,1334,127,B01,4,Mate,Black
FALSE,65,10+0,1833,1461,372,B20,3,Resign,White
FALSE,70,10+0,1461,1833,-372,C42,5,Resign,Black
FALSE,67,10+0,1833,1461,372,B20,3,Resign,White
TRUE,100,10+0,1512,1448,64,B21,3,Resign,Black
TRUE,19,10+0,1434,1526,-92,C40,4,Resign,White
TRUE,86,10+0,1436,1423,13,B20,3,Mate,Black
TRUE,68,10+0,1433,1457,-24,B00,2,Resign,Black
TRUE,68,10+0,1444,1443,1,C48,9,Out of Time,Black
TRUE,41,10+0,1432,1456,-24,B31,6,Mate,White
TRUE,56,10+0,1462,1637,-175,B10,2,Mate,Black
FALSE,103,10+0,1833,1452,381,B21,3,Out of Time,White
TRUE,65,10+0,1452,1433,19,B00,4,Mate,White
TRUE,47,10+0,1442,1452,-10,C41,4,Mate,White
TRUE,80,10+0,1428,1431,-3,B20,2,Mate,Black
FALSE,37,10+0,1833,1431,402,B20,3,Resign,White
FALSE,74,5+8,1500,1317,183,C00,3,Resign,Black
FALSE,64,5+8,1317,1500,-183,A04,2,Resign,Black
TRUE,80,10+0,1241,1280,-39,B21,3,Out of Time,Black
FALSE,188,15+2,1607,1280,327,A10,2,Mate,Black
FALSE,58,10+10,1280,1607,-327,B10,2,Resign,White
TRUE,60,10+0,1330,1306,24,C44,7,Resign,Black
FALSE,71,8+0,1163,1318,-155,B70,10,Out of Time,White
FALSE,50,10+0,1163,1617,-454,B70,10,Resign,White
FALSE,15,10+0,1617,1163,454,D10,4,Resign,White
TRUE,7,8+0,1342,1170,172,C20,3,Resign,White
TRUE,58,8+0,1177,1316,-139,C40,4,Mate,Black
TRUE,37,8+0,1180,1518,-338,C58,15,Resign,Black
FALSE,22,1+18,1193,1180,13,A00,1,Mate,Black
FALSE,32,1+18,1180,1193,-13,B07,5,Resign,Black
FALSE,16,1+18,1193,1180,13,C44,6,Resign,Black
FALSE,22,1+18,1180,1193,-13,C00,3,Resign,Black
TRUE,3,8+8,1183,1191,-8,C20,3,Resign,White
TRUE,55,8+8,1180,1193,-13,C00,3,Mate,White
TRUE,25,8+8,1354,1186,168,C65,6,Mate,White
FALSE,2,10+0,1286,1198,88,A01,2,Resign,White
FALSE,14,10+0,1198,1286,-88,C55,6,Resign,Black
FALSE,13,10+0,1286,1198,88,A40,2,Resign,White
FALSE,13,10+0,1198,1500,-302,C41,5,Mate,White
TRUE,50,2+40,1206,1311,-105,B13,10,Resign,Black
TRUE,22,2+40,1326,1190,136,A40,2,Out of Time,Black
TRUE,59,30+10,1808,1758,50,A45,2,Resign,White
TRUE,91,12+3,1691,1800,-109,B02,3,Out of Time,White
TRUE,53,12+3,1772,1700,72,A04,2,Mate,White
TRUE,68,12+3,1710,1738,-28,B02,3,Resign,Black
TRUE,68,8+4,1783,1754,29,C65,8,Mate,Black
TRUE,33,8+4,2047,1801,246,A00,1,Resign,White
TRUE,107,5+5,1993,1830,163,B02,5,Resign,White
TRUE,88,5+5,1869,1987,-118,C41,8,Mate,Black
TRUE,43,10+0,1796,1832,-36,B33,8,Mate,White
TRUE,58,5+5,2010,1653,357,A85,5,Out of Time,Black
FALSE,95,10+10,1904,1653,251,A04,2,Mate,White
TRUE,92,15+5,1721,1517,204,A80,2,Resign,Black
TRUE,83,5+5,1880,1546,334,B03,6,Mate,White
TRUE,86,5+5,1481,1386,95,B02,4,Resign,Black
TRUE,70,5+10,1500,1652,-152,C61,6,Out of Time,Black
FALSE,45,10+0,2621,1626,995,B32,6,Resign,White
FALSE,22,25+0,1855,1500,355,C50,6,Resign,White
FALSE,19,15+60,2256,1500,756,C53,9,Resign,White
TRUE,12,5+10,1500,2037,-537,C01,5,Resign,White
FALSE,108,20+90,1500,2035,-535,B33,10,Resign,Black
FALSE,48,10+30,1500,2125,-625,B90,11,Resign,Black
FALSE,31,20+0,2473,1500,973,C70,8,Resign,White
TRUE,52,10+5,1500,1895,-395,C00,3,Resign,Black
FALSE,43,20+0,1559,1600,-41,A40,2,Resign,White
FALSE,49,20+0,1600,1559,41,A40,2,Mate,White
FALSE,74,10+5,1663,1559,104,C01,5,Resign,Black
FALSE,116,3+10,1559,1615,-56,D00,3,Resign,Black
FALSE,64,5+5,1473,1559,-86,C01,5,Resign,Black
FALSE,43,15+0,1559,1700,-141,D02,5,Resign,White
FALSE,81,20+0,1603,1559,44,C00,3,Mate,White
FALSE,83,20+0,1559,1738,-179,D00,3,Out of Time,White
FALSE,39,20+0,1738,1559,179,C02,11,Mate,White
TRUE,100,5+8,1541,1548,-7,C00,3,Resign,Black
FALSE,27,10+0,1548,1659,-111,A40,2,Resign,White
FALSE,14,10+2,1585,1548,37,C02,11,Resign,Black
FALSE,206,15+0,1548,1553,-5,A41,2,Mate,Black
FALSE,94,10+0,1548,1620,-72,A48,5,Mate,Black
FALSE,90,30+0,1433,1548,-115,D02,3,Draw,Draw
FALSE,69,10+0,1548,1433,115,D00,3,Mate,White
FALSE,94,10+3,1611,1548,63,A40,2,Resign,Black
FALSE,80,10+0,1548,1604,-56,A46,5,Mate,Black
FALSE,42,15+0,1548,1700,-152,D02,5,Resign,Black
FALSE,128,10+0,1590,1548,42,A00,1,Mate,Black
FALSE,53,10+0,1661,1548,113,C00,3,Resign,White
FALSE,23,15+0,1548,1700,-152,D02,5,Resign,White
TRUE,11,15+0,1523,1130,393,C42,6,Resign,White
TRUE,62,15+0,1136,1521,-385,B22,3,Resign,Black
TRUE,43,7+3,1443,1147,296,B07,3,Resign,White
FALSE,21,5+8,1324,1133,191,C20,3,Resign,White
FALSE,58,10+0,1133,1500,-367,C20,3,Mate,Black
TRUE,56,0+12,1136,1741,-605,A00,1,Resign,Black
FALSE,24,5+8,1136,1564,-428,C40,4,Mate,Black
FALSE,16,5+8,1564,1136,428,C40,4,Resign,White
FALSE,40,5+8,1136,1500,-364,B52,6,Resign,Black
TRUE,45,8+0,1429,1148,281,B00,5,Resign,White
TRUE,40,8+0,1162,1425,-263,C23,3,Mate,Black
FALSE,49,25+0,1711,1162,549,A20,2,Resign,White
FALSE,52,20+0,1162,1699,-537,C46,7,Mate,Black
TRUE,38,10+5,1165,1731,-566,C41,5,Resign,Black
TRUE,55,15+5,1340,1190,150,C42,4,Mate,White
FALSE,33,7+8,1575,1190,385,C68,7,Resign,White
FALSE,73,10+0,1677,1190,487,A00,2,Mate,White
TRUE,12,120+0,1209,1443,-234,C42,6,Resign,Black
FALSE,83,10+2,1432,1209,223,D00,3,Mate,White
TRUE,75,10+0,1172,1272,-100,D00,3,Mate,White
FALSE,23,180+0,1666,1272,394,A00,1,Mate,White
TRUE,44,10+0,1290,1584,-294,C00,4,Resign,Black
TRUE,20,7+8,1340,1406,-66,A00,1,Mate,Black
FALSE,19,10+5,1402,1377,25,C50,8,Resign,White
TRUE,41,8+0,1315,1498,-183,C58,11,Out of Time,White
FALSE,41,30+0,1264,1500,-236,A00,1,Resign,Black
FALSE,31,30+0,1500,1264,236,C57,10,Resign,White
TRUE,83,15+15,1410,1408,2,A04,2,Resign,White
TRUE,21,15+15,1376,1398,-22,A85,5,Resign,Black
TRUE,53,10+0,1206,1415,-209,A80,2,Out of Time,White
TRUE,29,10+0,1404,1435,-31,A02,1,Resign,White
TRUE,73,10+0,1404,1420,-16,A03,2,Draw,Draw
TRUE,57,15+15,1392,1429,-37,A02,1,Resign,White
TRUE,29,15+15,1624,1397,227,B01,4,Resign,White
TRUE,29,15+15,1372,1409,-37,B07,2,Resign,White
TRUE,20,15+15,1419,1434,-15,A03,2,Resign,Black
TRUE,61,15+15,1410,1355,55,A02,1,Resign,White
TRUE,63,15+15,1539,1417,122,B07,4,Resign,White
TRUE,19,15+15,1522,1425,97,B07,4,Resign,White
TRUE,27,15+15,1438,1367,71,A02,1,Resign,Black
TRUE,52,15+15,1337,1431,-94,A80,2,Mate,Black
TRUE,42,10+0,1440,1512,-72,A03,2,Out of Time,Black
TRUE,15,15+15,1486,1450,36,B07,4,Resign,White
TRUE,64,15+15,1398,1447,-49,B07,2,Mate,Black
TRUE,31,10+0,1448,1458,-10,B01,4,Resign,White
TRUE,37,10+0,1447,1442,5,A03,2,Mate,White
TRUE,51,15+15,1441,1293,148,A02,1,Resign,White
TRUE,64,15+15,1453,1397,56,A02,1,Resign,Black
TRUE,92,15+15,1477,1452,25,A80,2,Draw,Draw
TRUE,19,15+15,1449,1456,-7,A03,2,Resign,White
TRUE,28,15+15,1521,1438,83,B07,4,Mate,Black
TRUE,94,15+15,1437,1446,-9,A41,2,Resign,White
TRUE,48,15+15,1459,1603,-144,A03,2,Resign,Black
TRUE,40,15+15,1478,1492,-14,A02,1,Resign,Black
TRUE,23,15+15,1513,1488,25,B07,4,Resign,White
TRUE,15,15+15,1477,1494,-17,A02,1,Mate,White
TRUE,63,15+15,1525,1486,39,B07,2,Resign,White
TRUE,107,15+15,1473,1585,-112,A02,1,Resign,White
TRUE,52,15+15,1567,1460,107,A84,4,Resign,Black
TRUE,29,15+15,1452,1371,81,A03,2,Mate,White
TRUE,42,10+0,1463,1440,23,B07,3,Resign,Black
TRUE,33,10+0,1431,1370,61,A03,2,Mate,White
TRUE,46,10+0,1310,1424,-114,B07,2,Resign,Black
TRUE,111,15+15,1412,1478,-66,A02,1,Resign,White
TRUE,67,15+15,1351,1424,-73,B07,2,Out of Time,White
TRUE,51,15+15,1412,1472,-60,A02,1,Resign,White
TRUE,42,10+0,1421,1468,-47,A02,1,Out of Time,Black
TRUE,126,10+0,1347,1412,-65,B07,4,Mate,Black
TRUE,55,15+15,1199,1429,-230,B07,4,Mate,White
TRUE,18,10+0,1527,1882,-355,C20,3,Resign,Black
TRUE,4,10+0,1527,1882,-355,A02,1,Mate,Black
TRUE,54,7+2,1500,1901,-401,D10,5,Mate,Black
TRUE,4,10+0,1533,1897,-364,A02,1,Mate,Black
TRUE,5,10+0,1894,1539,355,A00,1,Mate,White
TRUE,26,10+0,1545,1890,-345,C20,3,Mate,Black
TRUE,4,10+0,1552,1887,-335,A02,1,Mate,Black
FALSE,115,5+60,1923,1887,36,D00,3,Draw,Draw
TRUE,127,10+5,2086,1689,397,B01,6,Resign,White
TRUE,96,10+0,1606,1680,-74,B01,4,Out of Time,Black
TRUE,49,10+0,1664,1789,-125,D55,11,Resign,White
TRUE,31,10+0,1672,1789,-117,D31,6,Resign,Black
TRUE,52,10+0,1216,1670,-454,D20,5,Mate,Black
TRUE,14,10+0,1667,1371,296,A80,2,Resign,White
TRUE,54,9+0,1801,1650,151,B00,6,Mate,Black
TRUE,88,10+0,1658,1802,-144,D43,8,Mate,Black
TRUE,39,10+0,1656,1233,423,D20,4,Mate,White
TRUE,83,10+0,1769,1640,129,C24,5,Resign,Black
TRUE,41,5+8,1622,1865,-243,B06,4,Resign,White
TRUE,44,10+0,1350,1608,-258,B01,6,Mate,Black
TRUE,51,10+0,1619,1639,-20,D06,4,Resign,Black
TRUE,86,10+0,1625,1822,-197,D30,6,Mate,Black
TRUE,81,10+0,1776,1632,144,D02,4,Out of Time,White
TRUE,71,10+0,1546,1647,-101,B00,5,Resign,White
TRUE,74,10+0,1648,2159,-511,A40,4,Resign,Black
TRUE,69,10+0,1635,1693,-58,E21,7,Resign,White
TRUE,44,10+0,1647,1608,39,B00,2,Mate,Black
TRUE,45,10+0,1673,1657,16,D06,4,Resign,White
TRUE,76,10+0,1665,1767,-102,B06,6,Out of Time,Black
TRUE,44,10+0,1336,1662,-326,B01,6,Resign,Black
TRUE,84,10+0,1669,1810,-141,D53,8,Out of Time,Black
TRUE,111,10+0,1649,1681,-32,A03,2,Resign,White
TRUE,83,10+0,1671,1630,41,D16,10,Out of Time,White
TRUE,117,10+0,1398,1679,-281,A08,4,Out of Time,Draw
TRUE,73,10+0,1666,1697,-31,D35,6,Resign,White
TRUE,74,10+0,1670,1946,-276,B40,5,Out of Time,Black
TRUE,63,10+0,1667,1352,315,B11,4,Mate,White
TRUE,18,10+0,1199,1666,-467,B01,2,Resign,Black
TRUE,29,10+0,1580,1680,-100,B01,6,Mate,White
TRUE,24,10+0,1689,1735,-46,B10,2,Resign,Black
TRUE,80,10+0,1382,1293,89,C40,4,Resign,Black
TRUE,77,10+0,1377,1174,203,C41,5,Resign,White
TRUE,18,10+0,1149,1372,-223,C44,5,Resign,Black
TRUE,28,10+0,1161,1367,-206,C20,3,Resign,Black
TRUE,11,10+0,1361,1192,169,C41,5,Resign,White
TRUE,25,10+0,1349,1247,102,C42,6,Mate,White
TRUE,56,10+0,1287,1339,-52,B06,4,Mate,Black
TRUE,42,10+0,1191,1335,-144,C20,3,Resign,Black
TRUE,94,10+0,1349,1251,98,B27,3,Resign,Black
TRUE,59,10+0,1264,1370,-106,C44,4,Mate,White
TRUE,95,10+0,1363,1251,112,B02,4,Resign,White
TRUE,44,10+0,1249,1355,-106,C65,8,Resign,Black
TRUE,33,10+0,1347,1245,102,B29,5,Resign,White
TRUE,45,10+0,1272,1361,-89,A00,2,Resign,White
TRUE,110,10+0,1288,1352,-64,C50,6,Mate,Black
TRUE,40,10+0,1367,1240,127,C50,5,Mate,Black
TRUE,207,10+0,1371,1223,148,C55,6,Draw,Draw
TRUE,9,10+0,1364,1219,145,C57,7,Resign,White
TRUE,80,10+0,1225,1357,-132,B00,5,Mate,Black
TRUE,76,10+0,1221,1350,-129,C50,8,Resign,Black
TRUE,64,10+0,1335,1234,101,B32,7,Resign,White
TRUE,16,10+0,1137,1322,-185,C50,6,Resign,Black
TRUE,45,10+0,1293,1314,-21,C26,5,Resign,Black
TRUE,92,10+0,1327,1255,72,C50,6,Resign,Black
TRUE,22,10+0,1286,1317,-31,C20,3,Resign,Black
TRUE,72,10+0,1330,1257,73,B32,6,Resign,Black
TRUE,52,10+0,1296,1321,-25,A40,2,Resign,Black
TRUE,56,10+0,1313,1310,3,C44,5,Mate,Black
TRUE,88,10+0,1311,1245,66,C57,8,Resign,Black
TRUE,62,10+0,1273,1301,-28,C20,3,Mate,Black
TRUE,103,10+0,1257,1314,-57,A01,2,Resign,White
TRUE,49,10+0,1304,1276,28,B27,4,Mate,White
TRUE,87,10+0,1295,1238,57,C40,3,Mate,White
TRUE,190,10+0,1290,1295,-5,A00,1,Draw,Draw
TRUE,30,10+0,1248,1308,-60,C46,6,Resign,White
TRUE,36,10+0,1332,1285,47,B00,2,Resign,Black
TRUE,56,10+0,1295,1322,-27,B07,4,Resign,Black
TRUE,103,10+0,1316,1151,165,B02,4,Out of Time,White
TRUE,21,10+0,1296,1328,-32,C46,5,Resign,White
TRUE,39,10+0,1346,1114,232,B01,2,Resign,Black
TRUE,36,10+0,1722,1755,-33,B52,6,Resign,Black
TRUE,85,10+0,1734,1891,-157,C23,4,Resign,White
TRUE,45,10+0,1716,1747,-31,C45,7,Resign,White
TRUE,81,10+0,1720,1732,-12,A40,2,Resign,Black
TRUE,69,10+0,1706,1949,-243,B07,3,Mate,White
TRUE,41,10+0,1695,1573,122,C07,7,Mate,White
TRUE,78,10+0,1952,1667,285,B21,12,Out of Time,Black
TRUE,25,10+0,1639,1911,-272,C45,9,Resign,White
TRUE,42,10+0,1478,1628,-150,B21,3,Mate,Black
TRUE,150,10+0,2150,1595,555,E71,9,Out of Time,Black
TRUE,43,10+0,2166,1590,576,B06,2,Resign,White
TRUE,40,10+0,1565,1729,-164,A00,1,Resign,White
FALSE,37,15+0,1565,1898,-333,C60,7,Resign,White
FALSE,55,10+0,1950,2212,-262,E00,1,Out of Time,White
FALSE,49,10+10,1950,1226,724,A04,2,Resign,White
FALSE,78,10+10,1950,1885,65,A08,4,Mate,Black
FALSE,29,10+10,1950,2204,-254,A04,2,Draw,Draw
FALSE,65,10+10,1950,1500,450,A06,2,Draw,Draw
FALSE,66,10+10,1950,1819,131,A07,4,Draw,Draw
FALSE,112,10+10,1950,1477,473,A04,2,Draw,Draw
FALSE,70,10+10,1950,1500,450,A07,3,Draw,Draw
TRUE,50,10+0,2036,1706,330,A08,6,Resign,Black
FALSE,40,10+0,1795,2036,-241,B54,6,Resign,Black
TRUE,33,15+0,2023,1671,352,A04,2,Mate,White
TRUE,30,15+0,1675,2008,-333,B57,8,Mate,Black
TRUE,53,15+0,1990,1678,312,A04,2,Mate,White
FALSE,30,20+60,1990,1465,525,A08,5,Draw,Draw
FALSE,11,60+0,1990,1756,234,A04,2,Draw,Draw
FALSE,3,60+0,1990,1779,211,A04,2,Draw,Draw
FALSE,67,10+10,1990,1447,543,A04,2,Draw,Draw
TRUE,41,45+45,1458,1980,-522,A00,4,Resign,Black
TRUE,28,45+45,1967,1500,467,A04,2,Resign,White
FALSE,52,10+10,1967,1295,672,A07,3,Resign,White
FALSE,30,10+0,2102,1967,135,B54,6,Resign,Black
FALSE,31,30+0,1330,1500,-170,C40,3,Resign,White
TRUE,11,10+0,2386,1330,1056,C28,5,Resign,White
TRUE,38,10+0,1487,1340,147,C53,9,Resign,White
TRUE,72,10+0,1340,2197,-857,C50,6,Resign,Black
TRUE,23,10+0,1331,1159,172,C46,5,Mate,White
TRUE,90,10+0,1334,1798,-464,C40,5,Resign,Black
TRUE,35,10+0,2052,1334,718,C44,9,Resign,White
TRUE,23,10+0,1781,1336,445,D00,2,Resign,White
TRUE,73,10+0,1458,1347,111,D02,4,Resign,White
TRUE,44,10+0,1348,2075,-727,C02,7,Resign,Black
TRUE,17,10+0,1335,1272,63,C42,5,Resign,White
TRUE,70,10+0,1339,1705,-366,B07,3,Resign,Black
TRUE,27,10+0,1912,1340,572,C70,10,Resign,White
TRUE,32,10+0,1342,1792,-450,C50,9,Resign,Black
TRUE,15,10+0,1516,1500,16,B00,2,Mate,White
TRUE,97,10+0,1615,1608,7,A40,1,Resign,White
TRUE,86,10+0,1302,1611,-309,A00,1,Mate,Black
TRUE,119,10+0,1599,1580,19,A40,2,Out of Time,White
TRUE,43,10+0,1534,1614,-80,C20,4,Resign,White
TRUE,77,10+0,1423,1608,-185,C50,11,Resign,Black
TRUE,48,10+0,1586,1947,-361,D02,5,Resign,White
TRUE,62,10+0,1588,1990,-402,D02,5,Resign,Black
TRUE,129,10+0,1667,1598,69,C50,11,Mate,White
TRUE,141,10+0,1759,1605,154,C44,4,Mate,White
TRUE,53,10+0,2015,1608,407,C45,8,Resign,White
TRUE,88,10+0,1603,1732,-129,A40,1,Draw,Draw
TRUE,100,10+0,1604,2215,-611,A40,2,Resign,Black
TRUE,51,10+0,1606,2074,-468,A45,2,Resign,Black
TRUE,39,10+0,1783,1612,171,D06,4,Resign,White
TRUE,133,10+0,1993,1615,378,C62,6,Mate,White
TRUE,35,10+0,1949,1618,331,C50,6,Resign,White
TRUE,112,10+0,1619,1592,27,A45,2,Draw,Draw
TRUE,60,10+0,1624,1839,-215,A40,2,Mate,Black
TRUE,21,10+0,1763,1632,131,D06,4,Resign,White
TRUE,41,10+0,1840,1613,227,C51,10,Mate,White
TRUE,42,10+0,1623,1655,-32,D00,3,Resign,Black
TRUE,29,10+0,1603,1963,-360,D00,3,Mate,White
TRUE,37,9+0,1630,1614,16,C34,6,Mate,White
TRUE,74,10+0,1750,1598,152,C50,8,Resign,Black
TRUE,79,10+0,1786,1604,182,C44,6,Resign,White
TRUE,148,10+0,1612,1715,-103,D00,3,Resign,Black
TRUE,94,10+0,1644,1595,49,C48,7,Out of Time,Black
TRUE,108,10+0,1606,1618,-12,A46,5,Out of Time,Black
TRUE,146,10+0,1613,1760,-147,A48,5,Mate,Black
TRUE,49,10+0,2031,1615,416,C48,7,Resign,White
TRUE,46,10+0,1455,1620,-165,C62,6,Draw,Draw
TRUE,117,10+0,1611,1539,72,A45,2,Resign,White
TRUE,52,10+0,1614,1924,-310,D02,5,Resign,Black
TRUE,75,10+0,1953,1617,336,C50,7,Resign,White
TRUE,52,10+0,1453,1611,-158,D06,4,Resign,Black
TRUE,91,10+0,1599,1603,-4,A43,2,Resign,White
TRUE,73,10+0,1592,1457,135,D02,5,Resign,White
TRUE,32,10+0,1436,1585,-149,D00,2,Resign,Black
TRUE,45,25+0,1574,1489,85,D02,5,Resign,White
TRUE,98,10+0,1556,1789,-233,A40,2,Resign,White
TRUE,32,10+0,1447,1548,-101,C22,6,Mate,Black
TRUE,159,10+0,1364,1565,-201,C20,3,Out of Time,White
TRUE,31,10+0,1556,1496,60,A40,2,Mate,White
TRUE,61,10+0,1687,1566,121,B00,5,Resign,White
TRUE,107,10+0,1548,1605,-57,E60,5,Out of Time,White
TRUE,85,10+0,1596,1562,34,B30,4,Resign,White
TRUE,130,10+0,1523,1547,-24,B50,4,Out of Time,Black
TRUE,91,15+15,1533,1456,77,C65,6,Mate,White
TRUE,35,10+0,1553,1505,48,D06,8,Resign,Black
TRUE,124,10+0,1515,1536,-21,B12,7,Mate,Black
TRUE,85,10+0,1554,1568,-14,B27,4,Resign,Black
TRUE,59,10+0,1541,1431,110,D31,6,Resign,White
TRUE,48,10+0,1536,1541,-5,B20,3,Draw,Draw
TRUE,63,10+0,1655,1556,99,A43,2,Resign,White
TRUE,38,10+0,1562,1484,78,B29,5,Resign,Black
TRUE,32,10+0,1503,1375,128,B32,6,Mate,Black
TRUE,42,10+0,1500,1466,34,B20,3,Resign,Black
TRUE,22,10+0,1406,1437,-31,C55,6,Resign,White
FALSE,103,10+5,1933,1779,154,E34,8,Mate,White
FALSE,115,10+5,2188,1933,255,B27,4,Resign,White
FALSE,67,5+5,1080,1600,-520,B02,4,Out of Time,White
TRUE,85,8+0,1593,1434,159,C60,5,Out of Time,White
TRUE,46,8+0,1434,1586,-152,B04,8,Resign,Black
TRUE,46,5+8,1432,1579,-147,B02,4,Resign,Black
TRUE,54,5+5,1416,1571,-155,E60,5,Mate,Black
TRUE,96,5+6,1415,1564,-149,A45,2,Mate,Black
TRUE,88,5+8,1567,1536,31,D43,8,Resign,Black
TRUE,54,5+8,1547,1555,-8,B02,4,Resign,Black
TRUE,17,5+5,1545,1465,80,A04,2,Resign,White
TRUE,39,10+1,1463,1561,-98,D80,7,Resign,White
FALSE,57,7+3,1561,1080,481,A46,3,Draw,Draw
FALSE,20,5+60,1500,1561,-61,B02,7,Draw,Draw
FALSE,60,10+0,1547,1561,-14,D94,11,Resign,Black
FALSE,73,7+8,1545,1561,-16,D94,9,Resign,Black
FALSE,39,10+0,2206,1640,566,C30,3,Resign,White
FALSE,58,10+2,1640,1937,-297,C54,20,Mate,Black
FALSE,34,10+2,1640,1937,-297,C54,20,Resign,White
FALSE,50,10+2,1640,1937,-297,C54,16,Mate,Black
FALSE,42,10+0,1640,1914,-274,B27,4,Mate,Black
FALSE,55,10+1,2524,1640,884,C45,7,Mate,White
TRUE,59,5+8,1500,1418,82,A40,2,Mate,White
TRUE,84,8+0,1950,1960,-10,D00,3,Resign,Black
TRUE,29,10+0,1864,1976,-112,B46,10,Mate,White
FALSE,72,15+0,2065,1976,89,B21,6,Resign,White
TRUE,63,7+4,1976,1988,-12,B40,10,Resign,White
TRUE,141,7+4,1976,1987,-11,C44,4,Resign,White
TRUE,92,8+0,2035,1961,74,A56,6,Mate,Black
TRUE,64,10+0,1975,1908,67,C48,8,Resign,Black
TRUE,90,10+0,1463,1974,-511,A06,3,Resign,Black
TRUE,70,10+0,1997,1480,517,C22,7,Mate,Black
FALSE,68,10+0,1950,1997,-47,B01,2,Resign,Black
TRUE,63,8+0,2229,2002,227,C02,10,Mate,White
TRUE,90,8+0,1216,1555,-339,B20,3,Mate,Black
TRUE,51,8+11,2061,1432,629,C62,6,Resign,White
TRUE,70,10+0,2079,2006,73,D02,4,Resign,Black
TRUE,31,20+15,1664,2107,-443,D31,6,Resign,White
TRUE,42,10+0,2125,2061,64,B14,10,Resign,Black
TRUE,90,10+0,2060,2111,-51,E20,6,Resign,Black
TRUE,109,10+0,2105,1867,238,C66,8,Out of Time,White
TRUE,47,10+0,2097,1898,199,C64,6,Resign,White
TRUE,64,10+0,1904,2089,-185,C46,7,Resign,Black
TRUE,109,20+3,1153,1120,33,A00,1,Mate,White
TRUE,52,15+0,1468,1509,-41,C20,3,Mate,Black
FALSE,75,10+0,1904,1509,395,D02,4,Mate,White
FALSE,50,10+0,1509,1904,-395,B08,8,Resign,Black
TRUE,105,7+2,1502,1361,141,B30,4,Resign,White
TRUE,69,7+2,1913,1504,409,C68,7,Resign,White
TRUE,116,7+2,1509,1738,-229,C41,4,Mate,Black
TRUE,41,7+2,1369,1502,-133,C55,6,Resign,Black
TRUE,44,7+2,1454,1493,-39,D50,7,Mate,Black
FALSE,109,10+0,1427,1493,-66,C68,9,Mate,White
FALSE,17,10+0,1493,1781,-288,B30,5,Mate,White
FALSE,47,10+0,1427,1493,-66,C69,9,Mate,White
FALSE,20,10+0,1493,1781,-288,B07,4,Resign,Black
FALSE,15,10+0,1493,1427,66,C57,11,Resign,White
FALSE,45,10+0,1781,1493,288,C55,6,Resign,White
FALSE,45,10+5,1781,1493,288,D30,4,Resign,White
TRUE,46,20+0,1498,1482,16,C54,11,Resign,Black
TRUE,77,20+0,1461,1493,-32,C55,6,Resign,White
TRUE,43,10+0,1638,1500,138,C78,10,Resign,White
TRUE,81,10+0,1488,1527,-39,B02,5,Out of Time,White
TRUE,139,10+0,1501,1498,3,C55,6,Mate,White
TRUE,54,20+0,1547,1486,61,C68,7,Mate,Black
TRUE,60,10+0,1492,1658,-166,B30,4,Mate,Black
TRUE,36,10+0,1500,1605,-105,B23,3,Resign,Black
TRUE,87,7+2,1753,1723,30,A00,1,Resign,White
TRUE,135,7+2,1746,1256,490,A00,1,Mate,White
TRUE,76,7+2,1800,1738,62,B00,2,Draw,Draw
TRUE,140,7+2,1686,1747,-61,B06,6,Draw,Draw
TRUE,63,10+0,1945,1784,161,B10,2,Out of Time,White
TRUE,46,7+2,1807,2108,-301,C50,8,Resign,Black
TRUE,64,7+2,1548,1770,-222,B10,2,Resign,Black
TRUE,62,7+2,1875,1662,213,B23,5,Resign,Black
TRUE,59,7+2,1689,2078,-389,B12,5,Resign,White
TRUE,145,10+0,1634,1841,-207,C41,6,Mate,White
TRUE,19,10+0,1500,1407,93,B23,5,Resign,White
TRUE,60,10+15,2029,1924,105,B90,10,Resign,Black
TRUE,50,10+5,1931,2070,-139,D31,7,Mate,Black
TRUE,56,10+2,1941,1940,1,D43,8,Resign,Black
TRUE,38,5+7,1908,1953,-45,B51,5,Resign,White
TRUE,110,10+10,1832,1946,-114,A00,1,Mate,Black
TRUE,95,10+10,1950,1935,15,B20,3,Resign,Black
TRUE,37,10+10,1923,1961,-38,D31,7,Resign,White
TRUE,52,9+0,1886,1914,-28,B50,5,Resign,Black
TRUE,32,10+3,1923,1968,-45,D43,8,Resign,Black
TRUE,96,15+5,1867,1914,-47,B51,5,Resign,Black
TRUE,98,5+8,1925,1909,16,D06,4,Resign,Black
TRUE,16,12+8,1988,1933,55,B23,4,Resign,White
TRUE,29,20+0,1922,1950,-28,D15,8,Resign,White
TRUE,81,15+0,1913,1878,35,A52,7,Resign,White
TRUE,55,15+0,1904,1846,58,D06,4,Mate,White
TRUE,67,10+3,1979,1912,67,B90,10,Resign,White
TRUE,140,10+5,1908,2059,-151,D43,8,Draw,Draw
TRUE,14,10+10,1972,1917,55,A49,4,Resign,White
TRUE,28,10+0,1906,1924,-18,D35,9,Resign,White
TRUE,76,15+15,1857,1897,-40,D00,5,Resign,Black
TRUE,45,10+8,1910,1817,93,E34,8,Resign,Black
TRUE,15,8+7,1919,1953,-34,D08,7,Resign,Black
TRUE,61,5+5,1910,1870,40,A85,5,Resign,White
TRUE,40,5+5,1879,1900,-21,B93,11,Resign,Black
TRUE,67,5+20,1876,1912,-36,B92,11,Resign,White
TRUE,66,5+5,1882,1902,-20,A34,3,Resign,Black
TRUE,49,10+0,1914,1869,45,A41,4,Resign,Black
TRUE,114,10+10,1522,1727,-205,C54,13,Mate,Black
TRUE,107,10+10,1708,1528,180,C00,4,Mate,White
TRUE,92,10+5,1744,1770,-26,C50,7,Mate,Black
TRUE,63,10+5,1759,1790,-31,C25,4,Mate,White
TRUE,36,15+20,1750,1741,9,C50,6,Mate,Black
TRUE,55,5+7,1686,1681,5,C55,6,Resign,White
TRUE,85,30+10,1840,1732,108,C20,4,Mate,White
TRUE,118,6+8,1713,1637,76,D00,3,Resign,Black
TRUE,55,10+15,1791,1716,75,D00,3,Mate,White
FALSE,135,15+5,1716,1763,-47,C00,4,Draw,Draw
TRUE,78,20+0,1804,1931,-127,B20,3,Mate,Black
FALSE,40,10+3,1850,1804,46,C60,5,Resign,Black
FALSE,114,8+0,1804,1779,25,C02,7,Out of Time,Draw
TRUE,68,15+5,1701,1500,201,C46,5,Mate,Black
TRUE,128,5+5,1277,1619,-342,A00,1,Mate,Black
TRUE,125,10+8,1501,1271,230,B02,3,Draw,Draw
TRUE,110,15+0,1279,1385,-106,B10,5,Mate,Black
TRUE,24,30+0,1521,1284,237,B05,8,Resign,White
TRUE,53,20+5,1274,1233,41,A00,2,Mate,White
TRUE,25,120+0,1262,1281,-19,D01,6,Mate,White
TRUE,85,20+0,1220,1275,-55,B02,5,Resign,White
TRUE,119,20+0,1265,1229,36,C27,3,Mate,White
TRUE,15,20+0,1217,1278,-61,B02,3,Resign,White
TRUE,60,5+9,1286,1405,-119,D20,4,Resign,Black
TRUE,36,10+5,1292,1499,-207,B06,6,Resign,Black
TRUE,58,12+0,1465,1274,191,A03,2,Mate,Black
TRUE,37,10+2,1443,1281,162,A00,1,Mate,White
TRUE,100,20+0,1349,1267,82,B02,4,Mate,Black
TRUE,110,20+15,1962,1973,-11,B07,4,Resign,Black
TRUE,152,20+15,1972,2010,-38,B36,8,Resign,Black
TRUE,33,20+15,1965,2217,-252,C01,5,Draw,Draw
TRUE,85,20+15,1953,1982,-29,B00,5,Resign,White
TRUE,48,20+15,1963,1990,-27,C01,5,Resign,Black
TRUE,118,20+15,1974,1989,-15,B13,5,Resign,Black
TRUE,76,20+15,1985,2009,-24,C01,5,Resign,Black
TRUE,127,8+0,2007,1996,11,C44,11,Out of Time,White
TRUE,42,20+15,2008,1988,20,C64,6,Resign,Black
FALSE,98,10+5,1500,2008,-508,C62,6,Resign,White
TRUE,174,20+15,2012,2284,-272,B84,12,Resign,Black
TRUE,64,20+15,2023,2033,-10,B01,6,Resign,Black
TRUE,92,20+15,2036,1991,45,C53,9,Resign,Black
TRUE,95,20+15,2023,2055,-32,C01,5,Resign,White
TRUE,28,20+15,2011,2019,-8,B92,16,Resign,White
TRUE,102,20+15,2009,2069,-60,B13,5,Draw,Draw
TRUE,49,20+15,1998,2047,-49,B57,12,Resign,White
TRUE,70,20+15,2011,1975,36,B01,6,Resign,Black
TRUE,58,20+15,2014,2350,-336,C50,8,Resign,Black
TRUE,60,20+15,2027,2005,22,B13,5,Resign,Black
TRUE,66,20+15,2037,2080,-43,C50,8,Mate,Black
TRUE,55,20+15,2022,2127,-105,C46,7,Resign,White
TRUE,33,20+15,2011,1965,46,B27,3,Resign,White
TRUE,61,20+15,1997,2060,-63,B01,10,Mate,White
TRUE,124,20+15,2011,1962,49,C50,6,Resign,Black
TRUE,58,20+15,2011,2000,11,C77,9,Resign,Black
TRUE,134,20+15,2023,2028,-5,B40,8,Resign,Black
TRUE,37,10+0,1726,1565,161,B50,4,Mate,White
TRUE,36,10+0,1612,1552,60,B23,3,Resign,Black
TRUE,33,10+0,1538,1669,-131,B90,11,Resign,White
TRUE,68,10+0,1531,1674,-143,C42,5,Mate,Black
TRUE,30,10+0,1531,1526,5,C41,4,Resign,Black
TRUE,31,10+0,1591,1540,51,D20,6,Mate,White
TRUE,144,10+0,1633,1526,107,B50,5,Out of Time,Black
TRUE,42,10+0,1663,1512,151,B21,3,Resign,Black
TRUE,81,10+0,1927,2434,-507,B21,7,Out of Time,White
FALSE,64,60+0,2619,1927,692,D51,12,Resign,Black
TRUE,48,10+0,1128,1670,-542,B01,2,Mate,Black
TRUE,79,10+0,1638,1130,508,A21,5,Mate,White
TRUE,78,10+0,1132,1619,-487,C44,4,Mate,Black
TRUE,44,10+0,1137,1464,-327,B20,2,Mate,Black
TRUE,47,10+0,1558,1140,418,D20,4,Out of Time,White
TRUE,46,10+0,1143,1612,-469,B20,2,Mate,Black
TRUE,108,10+0,1120,1389,-269,C20,3,Mate,Black
TRUE,48,10+0,1128,1383,-255,C25,4,Mate,Black
TRUE,37,10+0,1468,1133,335,B01,2,Mate,White
TRUE,47,10+0,1347,1143,204,B01,4,Mate,White
TRUE,39,10+0,1445,1150,295,C40,3,Mate,White
TRUE,15,10+0,1116,1338,-222,C20,3,Resign,White
TRUE,30,15+5,1644,1810,-166,B25,4,Resign,Black
FALSE,52,8+0,1119,985,134,B02,4,Out of Time,Black
TRUE,70,20+0,1810,1473,337,C20,2,Mate,Black
TRUE,75,7+5,1436,1484,-48,B56,10,Resign,White
TRUE,104,14+8,1638,1417,221,D00,2,Draw,Draw
TRUE,129,15+15,1225,1221,4,A20,2,Resign,Black
TRUE,55,15+15,1227,1253,-26,B21,3,Resign,White
TRUE,75,15+15,1239,1358,-119,C27,7,Mate,White
TRUE,18,15+15,1240,1228,12,B56,9,Resign,Black
TRUE,92,15+15,1235,1352,-117,C50,8,Resign,Black
TRUE,17,15+15,1318,1243,75,B20,3,Mate,White
TRUE,82,5+10,1338,1229,109,B20,2,Mate,Black
TRUE,41,15+5,1158,1243,-85,B23,3,Mate,White
TRUE,52,8+0,1251,1329,-78,C41,5,Resign,Black
TRUE,60,8+2,1264,1200,64,C50,5,Out of Time,Black
TRUE,142,8+3,1278,1252,26,B20,3,Out of Time,Black
TRUE,104,11+8,1090,1246,-156,B20,3,Resign,Black
TRUE,88,20+0,1268,1234,34,C20,3,Resign,Black
TRUE,67,20+0,1221,1280,-59,C50,5,Resign,White
TRUE,46,20+15,1141,1212,-71,B20,2,Resign,Black
TRUE,44,8+0,1228,1060,168,C50,5,Resign,Black
TRUE,65,10+0,1274,1238,36,B33,8,Out of Time,White
TRUE,69,4+20,1097,1254,-157,C20,3,Resign,White
TRUE,65,6+4,1239,1064,175,C41,5,Mate,White
TRUE,61,6+4,1045,1256,-211,A00,1,Resign,White
TRUE,65,6+4,1251,1051,200,C40,3,Mate,White
TRUE,200,8+5,1252,1211,41,C57,7,Draw,Draw
TRUE,70,11+8,967,1248,-281,B20,2,Mate,Black
TRUE,69,5+5,1238,1225,13,C41,4,Mate,White
TRUE,59,0+15,1227,1206,21,B00,1,Mate,White
TRUE,135,10+0,1228,1227,1,B33,8,Draw,Draw
TRUE,96,10+0,1233,1215,18,B20,3,Mate,Black
TRUE,46,20+5,1049,1209,-160,B25,4,Resign,Black
TRUE,30,20+5,1060,1202,-142,B21,3,Mate,Black
TRUE,119,5+25,1189,1237,-48,C57,7,Resign,White
TRUE,27,15+0,907,1196,-289,D01,4,Draw,Draw
TRUE,73,15+0,1193,912,281,B06,2,Mate,White
TRUE,34,15+0,918,1188,-270,C20,3,Mate,Black
TRUE,9,15+0,1184,924,260,C57,7,Resign,White
TRUE,14,15+0,931,1180,-249,D01,4,Resign,Black
TRUE,44,12+5,1191,1181,10,B01,4,Mate,Black
TRUE,25,5+8,1186,967,219,C50,8,Out of Time,White
TRUE,113,5+5,1174,1210,-36,C00,2,Resign,White
TRUE,55,8+0,1304,1158,146,B22,3,Resign,Black
TRUE,27,30+0,1153,963,190,B07,5,Mate,White
TRUE,96,8+0,1400,1135,265,C60,5,Mate,Black
TRUE,62,10+3,1141,1309,-168,B07,4,Mate,Black
TRUE,29,10+0,1224,1149,75,D06,4,Out of Time,White
TRUE,90,20+0,1118,1139,-21,B20,2,Mate,Black
TRUE,50,10+0,1150,1138,12,C40,4,Out of Time,Black
TRUE,181,20+0,1148,1240,-92,C40,4,Draw,Draw
TRUE,125,15+0,1583,1588,-5,C40,4,Resign,White
TRUE,151,15+0,1516,1606,-90,D01,4,Mate,White
TRUE,29,10+0,1630,1522,108,C50,8,Resign,Black
TRUE,82,10+0,1255,1626,-371,B21,3,Mate,Black
TRUE,51,10+0,1607,1590,17,C41,7,Mate,White
TRUE,55,10+0,1588,1630,-42,A03,2,Resign,White
FALSE,43,5+8,1630,1241,389,C40,4,Mate,White
TRUE,87,12+5,1626,1534,92,B33,11,Resign,White
TRUE,73,12+5,1483,1661,-178,B50,4,Resign,White
TRUE,62,10+3,1650,1421,229,C40,6,Resign,White
TRUE,54,10+3,1431,1637,-206,B20,2,Mate,Black
FALSE,77,10+0,1479,1500,-21,B01,6,Mate,White
FALSE,37,10+5,1500,1479,21,B70,10,Resign,White
TRUE,8,15+0,1507,1651,-144,A46,4,Resign,White
TRUE,40,10+0,1902,1759,143,C42,9,Resign,Black
TRUE,53,10+0,1760,1771,-11,A00,1,Resign,White
TRUE,49,10+0,1764,1622,142,C30,4,Resign,White
FALSE,38,20+0,1500,2051,-551,B20,2,Mate,Black
FALSE,66,10+0,1321,2051,-730,A46,3,Mate,Black
FALSE,77,10+0,2051,1321,730,C28,5,Mate,White
FALSE,72,10+0,1321,2051,-730,B20,3,Out of Time,Black
FALSE,60,35+1,1500,2051,-551,B21,3,Resign,Black
FALSE,58,15+0,1268,2051,-783,A00,1,Resign,Black
TRUE,41,10+0,1417,1407,10,E60,5,Mate,White
TRUE,74,10+0,1417,1454,-37,C41,5,Mate,Black
TRUE,39,10+0,1409,1308,101,B27,3,Resign,White
TRUE,56,10+0,1316,1400,-84,A15,2,Resign,Black
TRUE,53,10+0,1389,1392,-3,D35,7,Mate,White
FALSE,96,10+5,1549,1425,124,C46,5,Resign,Black
TRUE,18,10+1,1833,1380,453,C47,8,Out of Time,Black
TRUE,60,15+0,1565,1253,312,A09,4,Resign,Black
TRUE,13,5+8,1111,1187,-76,A45,2,Resign,Black
TRUE,80,11+0,1264,1367,-103,C46,7,Mate,Black
FALSE,8,10+0,1176,1264,-88,C40,4,Resign,Black
TRUE,61,10+0,1169,1174,-5,C48,8,Mate,White
TRUE,198,10+0,1246,1340,-94,C20,4,Resign,Black
TRUE,18,10+0,1347,1495,-148,C41,5,Resign,Black
TRUE,18,10+0,1355,1470,-115,C00,3,Resign,Black
TRUE,51,10+0,1359,1366,-7,C46,7,Mate,White
TRUE,45,10+0,1370,1228,142,C46,7,Draw,Draw
TRUE,36,10+0,1351,1374,-23,C46,7,Resign,White
TRUE,81,5+5,1141,1369,-228,C30,3,Resign,Black
TRUE,87,8+0,1363,1201,162,C50,5,Resign,White
TRUE,68,25+0,1283,1354,-71,D00,3,Mate,Black
TRUE,111,10+0,1347,1186,161,C46,7,Mate,White
TRUE,27,10+0,1334,1400,-66,C00,3,Mate,White
TRUE,19,10+0,1348,1322,26,C34,6,Resign,Black
TRUE,27,10+0,1329,1466,-137,B20,3,Resign,Black
TRUE,25,10+0,1295,1821,-526,C44,4,Mate,White
TRUE,102,10+0,1329,1282,47,D07,7,Resign,Black
TRUE,60,10+0,1285,1598,-313,C27,3,Mate,Black
TRUE,62,10+0,1099,1279,-180,D00,3,Mate,Black
TRUE,130,10+0,1275,1398,-123,B10,3,Draw,Draw
TRUE,61,10+0,1350,1285,65,D07,7,Mate,White
TRUE,63,10+0,1383,1286,97,C46,7,Mate,White
TRUE,50,10+0,1297,1313,-16,C50,5,Mate,Black
TRUE,26,10+0,1273,1286,-13,C50,8,Mate,Black
TRUE,33,10+0,1282,1018,264,C42,5,Mate,White
TRUE,17,10+0,1231,1295,-64,C57,11,Mate,White
TRUE,32,10+0,1306,1298,8,C50,8,Resign,Black
TRUE,92,10+0,1195,1298,-103,A00,1,Out of Time,Black
TRUE,47,10+0,1383,1307,76,C40,4,Mate,White
TRUE,25,10+0,1296,1284,12,B23,3,Resign,White
TRUE,71,10+0,1600,1300,300,C22,6,Mate,White
TRUE,57,10+0,1282,1492,-210,C41,4,Mate,White
TRUE,43,10+0,1386,1279,107,A00,1,Draw,Draw
TRUE,17,10+0,1264,1367,-103,C50,6,Mate,White
TRUE,68,10+0,1273,1330,-57,B00,5,Out of Time,Black
TRUE,23,10+0,1192,1279,-87,C60,5,Mate,White
TRUE,16,10+15,1265,1625,-360,C65,8,Mate,Black
FALSE,11,8+2,1451,1365,86,C55,9,Resign,White
FALSE,14,10+1,1331,1365,-34,B00,2,Resign,White
FALSE,27,10+5,1412,1365,47,A40,2,Resign,White
FALSE,16,10+3,1365,1969,-604,B09,7,Out of Time,Black
FALSE,37,10+3,1969,1365,604,B40,5,Resign,White
FALSE,23,15+15,1085,1365,-280,C45,8,Resign,White
FALSE,32,15+15,1365,1215,150,C24,9,Resign,White
FALSE,17,10+0,1427,1365,62,D30,7,Resign,White
FALSE,46,5+5,1365,1902,-537,C55,6,Resign,Black
FALSE,55,5+5,1902,1365,537,C00,3,Resign,White
FALSE,37,10+0,1365,1817,-452,C15,7,Mate,White
FALSE,20,10+0,1399,1365,34,C01,5,Resign,Black
FALSE,24,10+0,1764,1365,399,B40,4,Resign,White
FALSE,40,60+0,1365,1881,-516,C51,15,Resign,Black
FALSE,2,30+8,1538,1365,173,B00,2,Resign,White
FALSE,68,20+0,1901,1365,536,C00,3,Resign,White
FALSE,13,10+5,1500,1365,135,C01,9,Resign,White
FALSE,30,15+0,1320,1365,-45,A00,1,Resign,White
FALSE,29,15+15,1365,1132,233,C23,3,Mate,White
FALSE,19,15+0,1365,1315,50,C40,4,Resign,White
FALSE,27,15+0,1365,1020,345,C23,3,Resign,Black
FALSE,99,5+7,1856,1365,491,C00,3,Mate,White
FALSE,22,5+7,1365,1856,-491,C24,7,Resign,White
FALSE,31,5+7,1856,1365,491,C02,11,Mate,White
FALSE,76,5+7,1365,1856,-491,A00,1,Mate,Black
FALSE,21,5+7,1856,1365,491,B00,5,Resign,White
FALSE,50,5+7,1365,1856,-491,A00,1,Resign,Black
FALSE,42,7+5,1442,1365,77,A02,1,Resign,White
FALSE,43,20+0,1365,1966,-601,C44,8,Resign,White
FALSE,32,20+0,1966,1365,601,A45,2,Resign,White
FALSE,34,20+0,1365,1966,-601,A00,1,Mate,Black
FALSE,5,120+0,1500,1472,28,C50,5,Resign,White
TRUE,39,10+0,1500,1479,21,C24,5,Mate,White
TRUE,33,10+0,1469,1438,31,D20,6,Resign,White
TRUE,43,10+0,1382,1484,-102,C20,3,Resign,White
FALSE,59,10+0,1500,1170,330,C21,3,Mate,White
FALSE,82,10+0,1170,1500,-330,C20,3,Mate,Black
TRUE,22,15+15,1229,1160,69,C23,3,Resign,Black
FALSE,49,10+0,1219,1229,-10,C10,5,Mate,White
TRUE,73,10+0,1776,1499,277,D02,3,Mate,White
TRUE,22,10+0,1771,1764,7,B36,8,Resign,Black
TRUE,68,15+10,1770,1951,-181,D10,5,Resign,Black
TRUE,25,10+0,1696,1785,-89,B07,4,Resign,White
TRUE,15,10+0,1554,1780,-226,C23,3,Resign,Black
TRUE,143,10+0,1775,1522,253,B07,3,Mate,White
TRUE,79,15+5,1761,1808,-47,C02,6,Resign,White
FALSE,32,5+5,2005,1761,244,C55,7,Resign,Black
TRUE,56,10+0,1766,2025,-259,C10,5,Resign,Black
TRUE,120,10+0,1728,1754,-26,D35,6,Mate,Black
TRUE,97,10+0,1735,1973,-238,B43,9,Mate,White
TRUE,50,10+0,1743,1864,-121,B13,5,Resign,Black
TRUE,63,10+0,2000,1748,252,D53,8,Resign,White
TRUE,58,10+0,1899,1741,158,C62,6,Resign,Black
TRUE,85,10+0,1722,1898,-176,B50,4,Out of Time,White
TRUE,111,15+15,1737,1724,13,C66,12,Draw,Draw
TRUE,24,15+0,1750,1722,28,C45,9,Resign,Black
FALSE,15,7+7,1725,1787,-62,C45,10,Resign,White
TRUE,84,15+6,1719,1733,-14,B30,4,Out of Time,Black
FALSE,70,15+0,1719,1727,-8,C00,3,Resign,White
FALSE,51,10+2,1196,1609,-413,A00,1,Mate,White
FALSE,92,20+5,1658,1609,49,B34,9,Resign,White
FALSE,82,10+0,1609,1657,-48,A13,2,Resign,Black
FALSE,46,10+0,1637,1609,28,B22,3,Resign,White
TRUE,72,25+5,1306,1605,-299,A00,1,Mate,Black
FALSE,61,8+0,1605,1603,2,C46,5,Mate,White
FALSE,39,4+7,1605,1157,448,B01,4,Out of Time,White
FALSE,39,15+15,1605,954,651,C40,3,Mate,White
FALSE,25,15+30,1853,1605,248,D11,7,Resign,White
TRUE,81,25+5,1600,1362,238,A13,3,Mate,White
TRUE,19,25+5,1365,1598,-233,A20,2,Draw,Draw
TRUE,35,25+5,1591,1500,91,A13,2,Resign,White
TRUE,43,20+5,1585,1500,85,A13,2,Mate,White
TRUE,14,15+15,913,981,-68,A45,2,Mate,Black
TRUE,66,15+15,924,982,-58,A40,2,Mate,Black
TRUE,121,15+15,1121,930,191,B07,2,Mate,White
TRUE,47,15+15,1181,936,245,B07,2,Mate,White
TRUE,83,15+15,1035,946,89,B07,2,Mate,White
TRUE,40,15+15,955,1082,-127,A40,2,Mate,Black
TRUE,90,15+15,967,999,-32,D06,3,Mate,Black
TRUE,51,15+15,1189,973,216,A00,1,Mate,White
TRUE,65,15+15,964,845,119,D00,2,Out of Time,White
TRUE,83,15+15,1251,969,282,B07,3,Mate,White
FALSE,94,15+15,969,1344,-375,D00,2,Mate,Black
FALSE,50,15+15,969,1344,-375,A40,2,Mate,Black
FALSE,15,15+15,1344,969,375,B07,3,Mate,White
FALSE,76,15+15,969,1346,-377,D00,2,Mate,Black
TRUE,62,15+15,793,961,-168,D00,2,Resign,Black
TRUE,93,15+15,1069,953,116,A00,1,Mate,White
TRUE,123,15+15,1113,962,151,A00,1,Mate,White
TRUE,64,15+15,973,1050,-77,D00,2,Mate,Black
TRUE,78,15+15,985,1074,-89,D00,2,Mate,Black
TRUE,47,7+2,1800,985,815,B50,5,Mate,White
TRUE,52,7+2,985,1768,-783,D00,2,Mate,Black
TRUE,45,7+2,1945,986,959,A04,2,Mate,White
TRUE,42,7+2,986,1944,-958,D00,2,Mate,Black
TRUE,45,7+2,1943,986,957,A04,2,Mate,White
TRUE,77,15+15,1099,996,103,A00,1,Mate,White
TRUE,81,15+15,1169,996,173,D10,4,Mate,White
TRUE,74,7+2,996,1732,-736,A40,1,Mate,Black
TRUE,82,7+2,1002,1253,-251,A40,2,Mate,Black
TRUE,42,7+2,1002,1731,-729,A40,2,Mate,Black
TRUE,27,7+2,1500,1005,495,C10,5,Mate,White
TRUE,44,15+15,996,991,5,D00,2,Resign,Black
TRUE,117,15+15,1261,966,295,A00,1,Draw,Draw
TRUE,72,15+15,972,1229,-257,A43,2,Mate,Black
TRUE,70,15+15,979,1164,-185,A40,2,Mate,Black
TRUE,24,15+15,1083,975,108,A00,1,Draw,Draw
TRUE,72,15+15,970,1090,-120,A45,2,Mate,Black
TRUE,32,15+15,1004,952,52,B54,5,Resign,Black
TRUE,20,15+15,961,1109,-148,A40,2,Mate,Black
TRUE,101,15+15,1103,972,131,B54,5,Mate,White
TRUE,45,15+15,943,1255,-312,A41,2,Resign,White
TRUE,73,15+15,1089,954,135,B07,2,Mate,White
TRUE,59,15+15,1100,965,135,A00,1,Mate,White
FALSE,7,7+2,1238,1500,-262,C23,3,Mate,White
FALSE,7,7+2,1500,1238,262,C23,3,Mate,White
FALSE,4,7+2,1500,1238,262,A02,1,Mate,Black
FALSE,18,7+2,1500,1238,262,B20,3,Mate,Black
FALSE,23,15+5,1443,1500,-57,C44,5,Mate,White
FALSE,12,10+5,1500,1626,-126,C23,3,Resign,Black
TRUE,68,15+0,1271,1510,-239,B01,2,Mate,Black
FALSE,77,20+0,1770,1510,260,B01,6,Mate,White
FALSE,18,20+0,1510,1770,-260,C41,5,Resign,White
TRUE,43,15+0,1343,1527,-184,A06,3,Mate,White
TRUE,36,15+0,1319,1521,-202,C48,8,Mate,Black
TRUE,91,15+0,1512,1448,64,C00,3,Mate,White
TRUE,31,15+0,1504,1384,120,B10,2,Mate,White
TRUE,13,15+0,1494,1439,55,C42,6,Resign,White
TRUE,46,15+0,1418,1485,-67,C50,6,Resign,Black
TRUE,47,15+0,1353,1501,-148,C64,6,Mate,White
TRUE,50,15+0,1497,1238,259,C44,5,Resign,White
TRUE,83,15+0,1416,1511,-95,C64,7,Mate,White
TRUE,53,15+0,1536,1522,14,C50,6,Resign,White
TRUE,47,15+0,1517,1311,206,C41,5,Resign,White
TRUE,47,15+0,1484,1530,-46,D01,4,Resign,White
TRUE,24,15+0,1542,1533,9,C44,5,Resign,Black
TRUE,71,15+0,1471,1556,-85,C50,6,Resign,White
TRUE,53,15+0,1555,1393,162,C41,7,Mate,White
TRUE,28,15+0,1400,1548,-148,C45,10,Resign,Black
TRUE,44,15+0,1562,1498,64,C41,5,Resign,Black
TRUE,61,15+0,1559,1211,348,C00,3,Out of Time,White
TRUE,78,15+0,1493,1549,-56,A00,1,Out of Time,Black
TRUE,34,15+0,1569,1251,318,B54,5,Resign,Black
TRUE,67,15+0,1450,1585,-135,C20,3,Resign,White
TRUE,14,15+0,1605,1342,263,C44,5,Mate,Black
TRUE,46,15+0,1622,1454,168,C41,7,Mate,Black
TRUE,46,15+0,1550,1612,-62,C44,4,Mate,Black
TRUE,97,15+0,1609,1256,353,C41,5,Mate,White
TRUE,148,15+0,1260,1606,-346,C44,4,Mate,Black
TRUE,59,30+0,1590,1395,195,C45,11,Resign,White
TRUE,25,15+0,1525,1593,-68,C50,6,Draw,Draw
TRUE,56,15+0,1611,1401,210,C41,5,Mate,Black
TRUE,45,15+0,1605,1388,217,C47,7,Resign,White
TRUE,50,15+0,1472,1598,-126,C55,7,Resign,Black
TRUE,127,15+0,1603,1445,158,B54,6,Draw,Draw
TRUE,70,15+0,1370,1597,-227,C50,6,Resign,Black
FALSE,47,30+0,1500,1597,-97,C64,6,Mate,White
TRUE,74,6+6,1370,1592,-222,C50,6,Mate,Black
FALSE,40,30+0,1592,1456,136,C00,3,Resign,White
FALSE,67,30+0,1592,1500,92,B01,4,Resign,White
FALSE,89,30+0,1592,1436,156,C41,5,Resign,White
TRUE,37,10+0,1801,1886,-85,A00,1,Resign,White
TRUE,83,10+0,2124,1891,233,A45,3,Resign,White
TRUE,39,10+0,1894,1781,113,C78,10,Draw,Draw
TRUE,43,10+0,1892,1470,422,C66,8,Resign,White
TRUE,55,10+0,1886,1706,180,C70,11,Resign,White
TRUE,67,10+0,1914,1897,17,C66,8,Resign,White
TRUE,80,10+0,1845,1887,-42,A00,1,Resign,Black
TRUE,47,10+0,1755,1903,-148,C30,4,Resign,White
TRUE,113,10+0,1550,1517,33,C07,7,Resign,Black
TRUE,108,8+2,1593,1538,55,D00,2,Mate,Black
TRUE,43,8+0,1523,1668,-145,B41,9,Resign,White
TRUE,13,10+0,1556,1533,23,D00,2,Resign,White
TRUE,138,10+0,1536,1836,-300,C53,9,Out of Time,Black
TRUE,47,10+0,1525,1541,-16,C55,6,Resign,White
TRUE,16,10+0,1511,1536,-25,C45,10,Resign,White
TRUE,19,10+0,1553,1547,6,C24,4,Resign,White
TRUE,49,12+0,1534,1602,-68,C53,9,Resign,White
TRUE,33,5+5,1545,1541,4,C50,6,Resign,Black
TRUE,63,10+5,1616,1554,62,C50,9,Resign,White
TRUE,41,5+8,1542,1583,-41,B32,7,Mate,White
TRUE,55,10+4,1531,1538,-7,C55,6,Out of Time,White
TRUE,15,10+0,1554,1541,13,C45,10,Resign,White
TRUE,42,5+8,1711,1555,156,D00,3,Resign,White
TRUE,24,7+2,1561,1740,-179,C58,11,Resign,Black
TRUE,54,5+8,1513,1552,-39,A00,1,Mate,Black
TRUE,20,10+0,1575,1561,14,D32,10,Resign,White
TRUE,72,10+0,1570,1633,-63,D31,5,Resign,Black
TRUE,51,6+3,1635,1579,56,A00,1,Resign,White
TRUE,48,10+0,1629,1567,62,D40,9,Resign,Black
TRUE,47,5+8,1770,1572,198,C55,10,Resign,White
TRUE,44,10+0,1320,1559,-239,A01,4,Mate,Black
TRUE,31,6+6,1567,1648,-81,A85,5,Resign,Black
TRUE,91,5+8,1713,1573,140,C24,4,Resign,White
TRUE,28,5+8,1580,1706,-126,D45,9,Mate,Black
TRUE,23,9+0,1695,1588,107,C37,7,Resign,White
TRUE,37,5+8,1662,1596,66,C88,15,Resign,White
TRUE,20,7+10,1604,1705,-101,D35,7,Resign,Black
TRUE,18,2+9,1657,1613,44,C57,10,Resign,White
TRUE,17,10+8,1700,1621,79,C45,8,Resign,White
TRUE,33,10+8,1691,1630,61,C45,8,Resign,White
TRUE,42,10+0,1638,1719,-81,C40,4,Resign,Black
TRUE,35,5+10,1694,1647,47,C54,13,Resign,White
TRUE,32,5+8,1634,1658,-24,C45,8,Resign,White
TRUE,61,10+0,1648,1638,10,D35,9,Resign,White
TRUE,60,10+5,1659,1636,23,E61,5,Resign,Black
TRUE,36,8+0,1668,1717,-49,D06,8,Resign,Black
TRUE,180,5+8,1621,1659,-38,C37,6,Mate,Black
TRUE,68,7+5,1756,1667,89,C55,6,Resign,White
TRUE,26,10+0,1761,1675,86,C54,19,Resign,White
TRUE,74,10+0,1682,1792,-110,B84,12,Mate,Black
TRUE,124,10+0,1694,1636,58,C00,3,Out of Time,Black
TRUE,90,4+6,1685,1684,1,C45,8,Resign,Black
TRUE,9,5+8,1668,1695,-27,C24,5,Resign,White
TRUE,64,4+6,1595,1687,-92,D02,3,Resign,Black
FALSE,1,15+30,2403,1746,657,B00,1,Out of Time,White
FALSE,5,30+30,2454,1746,708,C00,3,Out of Time,White
TRUE,59,10+0,1171,1432,-261,A29,7,Mate,White
TRUE,113,10+0,1403,1364,39,C00,3,Mate,White
TRUE,62,10+0,1446,1359,87,C20,3,Resign,Black
TRUE,58,10+0,1369,1413,-44,C23,3,Mate,Black
TRUE,12,10+0,1468,1354,114,C20,3,Mate,Black
TRUE,84,8+0,1331,1434,-103,C23,3,Mate,Black
TRUE,41,5+8,1215,1432,-217,C20,3,Resign,White
TRUE,43,5+8,1426,1265,161,A00,1,Mate,White
TRUE,17,5+8,1425,1351,74,D00,2,Resign,White
TRUE,37,16+8,1713,1500,213,A04,2,Resign,White
TRUE,103,30+30,2283,2358,-75,B23,4,Draw,Draw
TRUE,109,30+30,2214,2286,-72,A03,2,Draw,Draw
TRUE,92,45+45,2232,2272,-40,C50,8,Resign,Black
TRUE,77,30+30,2264,2082,182,C06,15,Resign,White
TRUE,76,20+20,1826,2262,-436,C26,5,Resign,Black
TRUE,22,60+30,2255,2008,247,C50,6,Resign,White
TRUE,62,30+30,2007,2249,-242,E17,14,Resign,Black
TRUE,70,20+20,1801,2246,-445,E38,8,Resign,Black
TRUE,63,45+45,2239,2401,-162,B23,5,Draw,Draw
TRUE,58,20+20,1471,2239,-768,C53,12,Resign,Black
TRUE,95,45+45,2094,2228,-134,C60,6,Resign,Black
TRUE,109,45+45,2229,2220,9,C54,17,Draw,Draw
TRUE,42,7+30,2162,2214,-52,E11,8,Resign,Black
TRUE,102,7+30,2236,2148,88,B06,2,Resign,Black
TRUE,97,60+30,2268,2254,14,C59,17,Resign,White
FALSE,56,20+0,1144,1500,-356,B01,4,Mate,Black
FALSE,20,15+15,1500,1264,236,C77,9,Draw,Draw
FALSE,43,15+0,1247,1500,-253,B01,2,Resign,White
FALSE,62,15+0,1247,1500,-253,B01,2,Out of Time,Black
FALSE,77,10+0,1500,1234,266,B15,5,Mate,White
FALSE,31,10+0,1234,1500,-266,A00,1,Draw,Draw
FALSE,3,30+0,1500,1193,307,D00,3,Resign,White
TRUE,89,25+10,1859,1734,125,A53,4,Resign,White
TRUE,63,1+15,1699,1752,-53,C64,6,Resign,White
TRUE,69,15+10,1655,1516,139,B10,2,Resign,White
TRUE,52,15+5,1671,1503,168,A40,2,Mate,Black
TRUE,63,15+5,1485,1688,-203,B20,3,Mate,White
TRUE,99,15+5,1683,1491,192,C30,4,Resign,White
TRUE,42,15+5,1648,1672,-24,B20,3,Resign,Black
TRUE,64,8+15,1551,1665,-114,B20,3,Mate,Black
TRUE,54,40+8,1484,1659,-175,A45,2,Mate,Black
TRUE,50,5+8,1545,1651,-106,B20,3,Mate,Black
TRUE,44,10+2,1665,1563,102,C50,8,Mate,Black
TRUE,43,10+2,1656,1571,85,D12,8,Resign,White
TRUE,82,10+2,1569,1659,-90,B25,4,Draw,Draw
TRUE,16,10+2,1674,1554,120,C30,4,Mate,Black
TRUE,134,8+8,1529,1667,-138,A45,2,Mate,Black
TRUE,27,5+5,1659,1547,112,D30,6,Resign,White
TRUE,117,5+8,1598,1673,-75,A02,1,Resign,White
TRUE,43,15+5,1666,1526,140,C33,6,Resign,White
TRUE,68,3+10,1679,1622,57,C30,3,Mate,Black
TRUE,63,5+15,1569,1694,-125,B20,3,Resign,White
TRUE,58,150+0,1606,1686,-80,B30,4,Mate,Black
TRUE,52,12+3,1469,1680,-211,B20,2,Out of Time,Black
TRUE,36,30+5,1460,1675,-215,A09,4,Mate,Black
TRUE,78,15+3,1449,1670,-221,A02,1,Resign,Black
TRUE,54,15+15,1687,1513,174,C34,6,Resign,Black
TRUE,54,30+30,1541,1680,-139,B21,5,Mate,Black
TRUE,59,5+5,1674,1488,186,B01,6,Mate,White
TRUE,63,25+8,1491,1691,-200,B30,4,Resign,White
TRUE,54,10+3,1466,1686,-220,B21,3,Mate,Black
TRUE,32,20+10,1703,1488,215,C30,4,Resign,Black
TRUE,52,20+10,1493,1698,-205,B25,4,Mate,Black
TRUE,45,10+5,1546,1691,-145,B30,4,Resign,Black
TRUE,31,10+5,1684,1553,131,C36,6,Resign,White
TRUE,68,45+0,1531,1677,-146,B32,8,Resign,Black
TRUE,50,5+5,1508,1670,-162,A00,1,Mate,Black
TRUE,83,10+10,1665,1475,190,B01,4,Resign,White
TRUE,61,15+7,1519,1681,-162,A00,1,Mate,White
TRUE,78,5+30,1481,1675,-194,A00,1,Resign,Black
TRUE,77,5+30,1669,1487,182,B00,2,Mate,White
TRUE,84,20+0,1468,1664,-196,A45,2,Out of Time,Black
TRUE,40,5+5,1465,1658,-193,B54,6,Resign,Black
TRUE,51,10+0,1634,1462,172,D20,5,Mate,White
TRUE,106,10+0,1466,1741,-275,C02,7,Mate,Black
TRUE,42,10+0,1456,1442,14,C22,6,Resign,Black
TRUE,25,10+0,1453,1258,195,C68,7,Resign,White
TRUE,94,10+0,1470,1464,6,C50,6,Resign,White
TRUE,40,10+0,1449,1453,-4,C21,10,Mate,Black
TRUE,53,10+0,1441,1459,-18,C41,5,Mate,White
TRUE,77,10+0,1334,1456,-122,C52,10,Resign,White
TRUE,138,10+0,1444,1445,-1,D00,3,Mate,Black
TRUE,78,10+0,1458,1404,54,B03,9,Mate,Black
TRUE,72,10+0,1465,1446,19,C20,3,Resign,Black
TRUE,108,10+0,1432,1521,-89,B52,6,Resign,White
TRUE,27,10+0,1435,1456,-21,C65,7,Mate,White
TRUE,71,10+0,1445,1446,-1,B00,2,Mate,White
TRUE,94,10+0,1614,1428,186,D07,6,Resign,Black
TRUE,45,10+0,1473,1448,25,C20,3,Mate,White
TRUE,58,10+0,1463,1436,27,A00,1,Mate,Black
TRUE,76,10+0,1448,1439,9,C00,3,Out of Time,Black
TRUE,127,10+0,1434,1515,-81,B51,5,Out of Time,White
TRUE,86,10+0,1442,1563,-121,B27,3,Mate,Black
TRUE,43,10+0,1426,1430,-4,C44,5,Resign,Black
TRUE,40,10+0,1414,1419,-5,C44,5,Resign,Black
TRUE,20,10+0,1512,1404,108,C45,8,Mate,Black
TRUE,88,20+0,1403,1419,-16,C50,8,Mate,Black
TRUE,73,10+0,1406,1326,80,C41,4,Draw,Draw
TRUE,148,10+0,1412,1564,-152,B40,6,Draw,Draw
TRUE,46,10+0,1146,1408,-262,D00,3,Mate,Black
TRUE,49,10+0,1405,1127,278,C40,4,Mate,White
TRUE,52,10+0,1413,1528,-115,C50,6,Mate,Black
TRUE,64,10+0,1424,1443,-19,C41,4,Mate,Black
TRUE,124,10+0,1264,1420,-156,D00,3,Mate,Black
TRUE,65,5+8,1190,1470,-280,B20,3,Mate,White
TRUE,41,8+1,1667,1192,475,C41,6,Resign,White
TRUE,30,8+1,1069,1182,-113,C40,5,Mate,Black
TRUE,55,8+1,1167,1176,-9,C21,4,Resign,White
TRUE,33,8+1,1561,1170,391,C27,3,Resign,White
TRUE,39,8+0,1356,1178,178,C41,8,Resign,White
TRUE,27,10+5,1627,1180,447,C40,4,Resign,White
TRUE,61,5+8,1506,1184,322,C41,4,Out of Time,White
TRUE,39,5+8,1633,1187,446,D00,3,Resign,White
TRUE,45,5+8,1344,1195,149,C40,3,Resign,White
TRUE,71,5+8,1610,1198,412,C41,4,Resign,White
TRUE,71,5+8,1658,1200,458,D00,5,Resign,White
TRUE,51,5+6,1389,1208,181,D00,3,Resign,White
TRUE,37,8+8,1711,1209,502,C24,4,Resign,White
TRUE,60,8+8,1215,1485,-270,B20,3,Resign,Black
TRUE,22,8+8,1493,1205,288,D00,3,Draw,Draw
TRUE,31,8+0,1640,1207,433,C37,7,Mate,White
TRUE,26,8+0,1209,1639,-430,B10,3,Mate,Black
TRUE,41,8+3,1611,1213,398,C40,4,Resign,White
TRUE,72,5+5,1544,1188,356,C40,4,Out of Time,Black
TRUE,32,12+3,1180,1674,-494,C22,6,Resign,Black
TRUE,57,5+8,1379,1187,192,C21,3,Resign,White
TRUE,52,5+8,1194,1373,-179,C41,5,Resign,Black
TRUE,33,5+8,1438,1200,238,C40,4,Resign,White
TRUE,41,5+8,1814,1201,613,D02,3,Resign,White
TRUE,48,5+8,1177,1504,-327,C44,6,Resign,White
TRUE,39,10+7,1621,1179,442,C41,5,Resign,White
TRUE,46,5+8,1184,1440,-256,C22,6,Resign,Black
TRUE,51,5+6,1364,1192,172,A20,2,Mate,White
TRUE,29,6+5,1492,1196,296,C41,7,Resign,White
TRUE,69,10+4,1621,1198,423,A41,3,Mate,White
TRUE,17,7+5,1379,1206,173,A00,1,Resign,White
TRUE,84,5+10,1207,1724,-517,B20,3,Resign,Black
TRUE,49,10+5,1185,1438,-253,C41,5,Mate,White
TRUE,47,5+8,1594,1188,406,D02,5,Resign,White
TRUE,53,10+10,1523,1191,332,A04,2,Resign,White
TRUE,76,10+10,1195,1516,-321,B21,3,Resign,Black
TRUE,48,5+8,1202,1382,-180,C22,6,Resign,Black
TRUE,57,5+7,1452,1251,201,A13,2,Resign,White
TRUE,19,20+0,1411,1465,-54,B25,4,Resign,White
TRUE,76,5+8,1313,1458,-145,A40,2,Mate,Black
TRUE,32,10+5,1474,1323,151,C20,3,Mate,Black
TRUE,67,5+8,1330,1490,-160,C41,4,Mate,White
TRUE,109,8+0,1425,1503,-78,A00,3,Mate,White
TRUE,71,10+0,1492,1497,-5,C20,3,Resign,White
TRUE,72,15+0,1407,1483,-76,A04,2,Mate,Black
TRUE,41,12+5,1477,1314,163,C20,3,Mate,White
TRUE,65,90+0,1461,1489,-28,A43,5,Mate,White
TRUE,99,5+8,1491,1451,40,C20,3,Draw,Draw
FALSE,15,25+1,1242,1491,-249,C41,7,Resign,White
TRUE,39,15+0,1485,1281,204,C00,4,Resign,White
TRUE,31,10+2,1373,1500,-127,C00,3,Mate,White
TRUE,36,5+8,1493,1355,138,C00,3,Resign,White
TRUE,63,10+0,1486,1342,144,C20,3,Mate,White
TRUE,44,10+0,1538,1472,66,A40,2,Out of Time,Black
TRUE,17,9+0,1423,1484,-61,C00,2,Mate,White
TRUE,20,5+5,1496,1459,37,C20,3,Resign,Black
TRUE,76,10+15,1491,1485,6,B40,4,Resign,Black
TRUE,133,20+0,1478,1305,173,C20,3,Resign,White
TRUE,21,5+8,1470,1353,117,C20,3,Resign,White
TRUE,115,10+0,1562,1479,83,C41,5,Mate,White
FALSE,37,10+0,1587,1500,87,C42,5,Mate,White
FALSE,100,5+5,1587,1500,87,B01,4,Mate,Black
FALSE,61,10+0,1587,1500,87,B27,4,Mate,White
FALSE,3,10+0,1500,1587,-87,A45,2,Resign,White
FALSE,117,10+5,1500,1587,-87,E77,8,Mate,White
FALSE,73,20+0,1500,1587,-87,B30,5,Resign,White
TRUE,71,5+5,1584,1500,84,C00,3,Draw,Draw
FALSE,97,8+0,1584,1500,84,B13,5,Out of Time,White
FALSE,42,15+0,1500,1584,-84,A45,2,Mate,Black
TRUE,73,10+2,1780,1589,191,B60,11,Mate,White
FALSE,44,5+8,1554,1589,-35,C50,8,Mate,Black
FALSE,16,20+0,1589,1500,89,C57,10,Resign,Black
FALSE,17,10+0,1589,1255,334,C41,5,Mate,White
FALSE,40,10+0,1589,1141,448,B01,4,Mate,Black
FALSE,57,10+0,1589,1489,100,C57,11,Mate,White
FALSE,15,10+0,1589,1337,252,C41,5,Resign,White
FALSE,91,10+0,1589,1500,89,B01,4,Mate,White
FALSE,66,10+0,1589,1348,241,D07,6,Mate,Black
FALSE,49,10+0,1500,1589,-89,A45,2,Resign,White
FALSE,53,10+0,1500,1589,-89,A45,3,Resign,White
FALSE,32,10+0,1372,1589,-217,C57,9,Mate,Black
FALSE,61,15+6,1589,1500,89,C02,5,Mate,White
FALSE,62,10+0,1437,1589,-152,E60,5,Draw,Draw
FALSE,161,7+3,1589,1500,89,C21,3,Mate,White
FALSE,39,30+15,1589,1500,89,D53,8,Resign,White
FALSE,52,30+15,1500,1589,-89,C20,3,Resign,Black
TRUE,39,5+6,1580,1519,61,D00,3,Resign,White
TRUE,43,15+0,1570,1251,319,B01,4,Resign,White
TRUE,46,15+0,1288,1565,-277,A00,1,Mate,Black
TRUE,15,15+0,1560,1349,211,A40,2,Mate,White
TRUE,62,15+0,1500,1554,-54,A00,1,Mate,Black
FALSE,105,10+0,1500,1554,-54,C62,6,Mate,White
FALSE,19,10+0,1554,1500,54,B13,5,Resign,White
FALSE,68,10+0,1399,1554,-155,C62,6,Resign,Black
FALSE,38,10+0,1362,1554,-192,C57,9,Mate,Black
FALSE,31,10+0,1145,1554,-409,B00,5,Mate,White
FALSE,15,10+0,1554,1347,207,D11,5,Resign,White
FALSE,41,10+0,1554,1236,318,D30,4,Resign,White
TRUE,61,10+0,1564,1577,-13,C15,6,Resign,Black
FALSE,110,10+0,1364,1564,-200,D02,4,Mate,Black
FALSE,53,10+0,1564,1500,64,B12,3,Resign,White
FALSE,56,10+0,1500,1564,-64,C23,3,Mate,Black
FALSE,65,10+0,1564,1500,64,B20,3,Resign,White
FALSE,26,10+0,1500,1564,-64,C20,3,Resign,White
TRUE,51,10+0,1876,1921,-45,A70,13,Resign,White
TRUE,103,10+0,1865,1841,24,D06,4,Resign,White
TRUE,48,10+0,1536,1862,-326,B12,7,Mate,Black
TRUE,96,10+0,1878,1724,154,D15,7,Resign,Black
TRUE,120,10+0,1844,1868,-24,A16,3,Mate,Black
TRUE,96,10+0,1732,1855,-123,A00,1,Out of Time,Black
TRUE,64,10+0,1867,1878,-11,A40,4,Resign,Black
TRUE,66,10+0,1730,1859,-129,B12,5,Resign,Black
TRUE,80,10+0,1948,1844,104,E61,4,Resign,Black
TRUE,41,10+0,1918,1858,60,E90,11,Resign,White
TRUE,57,10+0,1844,1907,-63,E80,9,Mate,White
TRUE,109,10+0,1905,1842,63,B13,5,Draw,Draw
TRUE,36,10+0,1834,1732,102,D53,8,Resign,White
TRUE,79,10+0,1823,1770,53,E88,14,Resign,White
TRUE,79,10+0,1813,1835,-22,E70,7,Resign,White
TRUE,58,10+0,1856,1509,347,D50,7,Resign,Black
TRUE,65,10+0,1453,1878,-425,B12,5,Mate,White
TRUE,48,10+0,1888,1957,-69,E80,9,Resign,Black
TRUE,75,10+0,1878,1816,62,A41,6,Mate,White
TRUE,41,10+0,1804,1893,-89,B13,7,Mate,White
TRUE,69,10+0,1881,1873,8,E81,10,Mate,White
TRUE,82,10+0,1705,1874,-169,B10,2,Resign,Black
TRUE,33,10+0,1469,1896,-427,B10,3,Resign,White
TRUE,74,10+0,1910,1863,47,E90,9,Resign,Black
TRUE,74,10+0,1493,1908,-415,B08,8,Mate,Black
TRUE,88,10+0,1931,1384,547,D08,7,Resign,Black
TRUE,40,10+0,1941,1985,-44,D85,8,Resign,Black
TRUE,112,10+0,1998,1927,71,B18,8,Resign,Black
TRUE,81,10+0,1923,1625,298,D10,5,Resign,White
TRUE,51,10+0,2003,1932,71,B10,3,Resign,White
TRUE,37,10+0,1930,1552,378,A80,2,Resign,White
TRUE,39,10+0,1914,1918,-4,B12,5,Resign,Black
TRUE,79,10+0,1807,1934,-127,B10,2,Resign,White
TRUE,80,10+0,1947,1909,38,E87,13,Resign,Black
TRUE,95,10+0,1945,1534,411,A40,2,Mate,White
TRUE,64,10+0,1691,1940,-249,A45,2,Mate,Black
TRUE,47,10+0,1759,1934,-175,B72,13,Resign,Black
TRUE,54,10+0,1947,1914,33,E16,10,Resign,Black
TRUE,45,10+0,1953,1959,-6,A49,5,Resign,White
TRUE,58,10+0,1820,1951,-131,E61,6,Mate,Black
TRUE,39,10+0,1943,1815,128,A40,2,Resign,White
TRUE,48,10+0,1890,1957,-67,B10,8,Resign,White
TRUE,63,10+0,1954,1613,341,D20,5,Mate,White
TRUE,63,10+0,1947,1784,163,A40,2,Resign,White
TRUE,59,10+0,1946,1469,477,A40,2,Resign,White
TRUE,122,10+0,2019,1943,76,B10,2,Draw,Draw
TRUE,28,10+0,1949,2156,-207,E81,10,Resign,Black
TRUE,137,10+0,1502,1517,-15,D35,7,Mate,White
TRUE,35,10+0,1720,1507,213,B25,4,Resign,White
TRUE,34,10+0,1504,1519,-15,B22,3,Resign,White
TRUE,74,10+0,1536,1507,29,D01,4,Resign,Black
TRUE,46,10+5,1509,1913,-404,E61,4,Resign,Black
TRUE,69,10+5,1495,1577,-82,B21,3,Out of Time,White
TRUE,91,10+5,1366,1511,-145,D02,3,Resign,White
TRUE,49,10+5,1505,1319,186,D10,7,Mate,White
TRUE,40,10+5,1952,1506,446,B50,4,Resign,White
TRUE,18,10+5,1508,1951,-443,B21,3,Resign,Black
TRUE,25,10+5,1572,1517,55,B50,5,Resign,White
TRUE,84,10+5,1527,1554,-27,C30,3,Resign,Black
TRUE,54,10+5,1632,1513,119,B53,7,Resign,Black
TRUE,32,10+5,1517,1762,-245,B21,3,Resign,Black
TRUE,127,10+5,1507,1482,25,C34,6,Mate,White
TRUE,65,10+5,1382,1522,-140,B20,3,Resign,White
FALSE,31,10+5,1522,1542,-20,C31,5,Resign,White
TRUE,39,10+0,1453,1536,-83,B20,3,Resign,White
TRUE,15,10+0,1531,1291,240,C34,6,Resign,White
TRUE,31,10+0,1516,1543,-27,B50,4,Resign,White
FALSE,55,10+5,1543,1267,276,B00,2,Mate,White
FALSE,39,5+8,1543,1500,43,C30,4,Mate,White
TRUE,63,10+5,1404,1558,-154,A03,2,Mate,White
TRUE,68,10+5,1568,1614,-46,C30,3,Resign,Black
TRUE,27,10+5,1795,1573,222,D00,9,Resign,White
TRUE,79,10+5,1567,1389,178,B07,3,Resign,White
TRUE,65,10+0,1624,1576,48,B50,4,Out of Time,White
TRUE,76,15+15,1557,1566,-9,B50,4,Resign,Black
TRUE,20,15+15,1559,1500,59,C30,3,Resign,White
TRUE,41,15+15,1532,1571,-39,B56,9,Resign,White
TRUE,50,10+0,1582,1586,-4,A03,3,Resign,Black
TRUE,101,10+0,1575,1593,-18,B27,4,Out of Time,White
TRUE,22,10+0,1607,1519,88,C02,7,Resign,Black
TRUE,161,10+0,1596,1589,7,C34,6,Mate,White
TRUE,136,10+0,1701,1582,119,B20,3,Mate,Black
TRUE,80,10+0,1590,1651,-61,C70,8,Resign,Black
TRUE,56,15+15,1506,1582,-76,B50,4,Resign,Black
TRUE,106,10+0,1653,1568,85,B20,3,Mate,Black
TRUE,5,5+10,1315,1198,117,D01,4,Resign,White
TRUE,14,15+15,1227,1276,-49,A00,2,Out of Time,Black
TRUE,68,15+15,1334,1284,50,B20,3,Mate,Black
TRUE,71,15+15,1297,1335,-38,B00,2,Mate,White
TRUE,58,10+0,1503,1495,8,D25,7,Resign,Black
FALSE,80,10+0,1149,1503,-354,C68,8,Draw,Draw
FALSE,106,10+5,1149,1503,-354,C50,6,Resign,Black
TRUE,57,10+0,1493,1473,20,C00,3,Mate,White
TRUE,33,10+0,1461,1505,-44,C50,7,Resign,White
FALSE,39,30+0,1423,1505,-82,C44,5,Resign,White
TRUE,92,15+15,1251,1331,-80,C22,6,Mate,Black
TRUE,21,15+15,1309,1269,40,B00,6,Resign,White
TRUE,55,15+15,1290,1186,104,C40,4,Mate,White
TRUE,18,25+12,1459,1307,152,C24,4,Resign,White
TRUE,40,15+15,1335,1360,-25,C68,7,Resign,Black
TRUE,43,15+15,1286,1304,-18,C48,7,Resign,Black
TRUE,14,10+0,1284,1301,-17,C50,5,Out of Time,Black
TRUE,30,10+5,1368,1184,184,C44,5,Resign,Black
TRUE,54,10+0,1415,1438,-23,C40,4,Out of Time,Black
TRUE,63,10+0,1486,1470,16,C44,7,Out of Time,White
TRUE,44,10+0,1536,1549,-13,C44,5,Resign,Black
TRUE,56,10+0,1418,1461,-43,D00,3,Resign,Black
TRUE,86,10+0,1512,1726,-214,C00,4,Resign,Black
TRUE,27,10+0,1765,1590,175,D07,6,Mate,White
TRUE,50,10+0,1271,1500,-229,C20,4,Mate,Black
TRUE,38,15+0,1063,1186,-123,C00,3,Resign,Black
TRUE,34,20+7,1500,1265,235,A00,1,Resign,Black
TRUE,55,10+0,1495,1460,35,B23,3,Resign,White
TRUE,71,10+0,1461,1508,-47,E60,5,Resign,White
TRUE,109,10+0,1525,1494,31,C44,5,Resign,Black
TRUE,84,10+0,1530,1561,-31,C00,3,Resign,Black
TRUE,76,10+0,1575,1516,59,E81,10,Resign,Black
TRUE,65,10+0,1514,1108,406,C44,5,Mate,White
TRUE,27,10+0,1602,1523,79,A48,5,Resign,White
TRUE,13,10+0,1538,1452,86,C44,5,Resign,Black
TRUE,66,10+0,1541,1900,-359,C45,7,Mate,Black
TRUE,79,10+0,1708,1548,160,B07,2,Resign,White
TRUE,76,10+0,1270,1544,-274,B07,5,Mate,Black
TRUE,82,3+8,1762,1834,-72,B50,4,Mate,Black
TRUE,65,20+0,1740,1729,11,A48,5,Resign,White
TRUE,62,5+6,1758,1851,-93,B30,4,Mate,Black
TRUE,58,10+0,1916,1749,167,B20,3,Out of Time,Black
TRUE,49,10+0,1730,1592,138,A35,6,Mate,White
TRUE,43,10+0,1713,1527,186,A04,2,Mate,White
TRUE,44,10+0,1987,1653,334,A45,3,Out of Time,Black
TRUE,91,10+0,2039,1660,379,D55,13,Out of Time,White
TRUE,57,10+0,1598,1891,-293,B01,4,Mate,White
TRUE,127,10+0,1506,2117,-611,B07,6,Mate,White
TRUE,70,10+0,1783,1432,351,C57,10,Mate,Black
TRUE,47,10+0,1361,1629,-268,C55,6,Mate,White
FALSE,59,10+3,1682,1417,265,D00,3,Mate,White
FALSE,19,10+3,1389,1682,-293,B13,5,Resign,Black
FALSE,45,10+0,1682,1500,182,D02,3,Mate,White
FALSE,42,10+0,1500,1682,-182,A46,3,Mate,Black
FALSE,19,10+0,1682,1500,182,D02,3,Resign,White
TRUE,60,10+0,1130,1383,-253,C34,6,Mate,Black
FALSE,50,17+5,1136,1383,-247,A00,1,Resign,Black
FALSE,37,17+5,1383,1136,247,C50,6,Resign,White
TRUE,76,10+10,984,1378,-394,D00,5,Resign,Black
FALSE,46,10+5,1378,1377,1,C40,4,Mate,Black
TRUE,11,13+10,1372,1003,369,B50,4,Resign,White
TRUE,77,10+0,1364,1065,299,C00,3,Mate,White
TRUE,20,15+0,1196,1348,-152,D20,5,Resign,Black
TRUE,37,10+0,1336,1088,248,C00,3,Resign,White
TRUE,89,15+0,1310,1273,37,C42,5,Resign,White
TRUE,17,5+5,1382,1304,78,C23,3,Draw,Draw
TRUE,30,15+0,1285,1116,169,B30,4,Resign,White
TRUE,77,5+10,1271,1328,-57,C50,8,Resign,White
TRUE,124,10+0,1930,1897,33,B09,10,Mate,Black
TRUE,43,10+0,2012,1904,108,B94,11,Resign,White
TRUE,37,10+0,1891,1977,-86,B28,8,Mate,White
TRUE,53,10+0,1882,1828,54,C65,8,Resign,White
TRUE,80,10+0,1822,1873,-51,B22,3,Resign,Black
TRUE,91,10+0,1890,1884,6,B56,9,Resign,White
TRUE,109,10+0,1884,1873,11,C77,9,Draw,Draw
TRUE,51,10+0,1861,1896,-35,B33,17,Resign,White
TRUE,43,10+0,1883,1942,-59,B02,6,Resign,White
FALSE,77,5+8,1128,795,333,A00,2,Mate,White
FALSE,130,9+3,1128,2177,-1049,A00,2,Mate,Black
TRUE,85,20+1,1114,1189,-75,A00,1,Resign,White
TRUE,51,20+1,1191,1111,80,A00,1,Draw,Draw
FALSE,53,60+0,1111,921,190,A00,4,Mate,White
FALSE,36,10+0,897,1111,-214,B06,2,Resign,Black
FALSE,26,10+0,1111,897,214,A00,1,Resign,White
TRUE,52,10+10,1099,1124,-25,A04,2,Resign,White
TRUE,139,10+0,1115,1013,102,A00,1,Mate,White
FALSE,72,10+0,1099,1115,-16,B06,2,Mate,Black
FALSE,142,10+0,1099,1115,-16,B06,2,Mate,Black
TRUE,60,0+25,1136,843,293,A00,2,Mate,Black
TRUE,23,0+25,798,1157,-359,B06,2,Resign,White
FALSE,9,30+30,2419,1157,1262,B30,5,Resign,White
TRUE,43,15+5,1151,964,187,A00,1,Mate,White
TRUE,141,10+0,1630,1537,93,D06,3,Mate,White
TRUE,153,10+0,1588,1631,-43,B00,3,Draw,Draw
TRUE,76,10+0,1601,1621,-20,B00,3,Mate,Black
TRUE,73,10+0,1610,1611,-1,D06,3,Mate,White
TRUE,24,10+0,1550,1600,-50,D01,4,Resign,Black
TRUE,81,10+0,1677,1587,90,B12,7,Resign,Black
TRUE,57,10+0,1573,1653,-80,A40,2,Out of Time,White
TRUE,35,10+0,1561,1587,-26,A40,2,Resign,White
TRUE,39,10+0,1638,1570,68,B12,7,Mate,White
TRUE,31,10+0,1559,1548,11,D15,7,Mate,White
TRUE,47,10+0,1699,1566,133,B10,2,Resign,White
TRUE,137,10+0,1557,1494,63,D31,6,Mate,White
TRUE,58,10+0,1532,1546,-14,B13,5,Resign,Black
TRUE,112,10+0,1616,1532,84,B13,5,Out of Time,Black
TRUE,48,10+0,1543,1550,-7,D50,7,Resign,Black
TRUE,59,10+0,1533,1555,-22,C01,7,Mate,White
TRUE,109,10+0,1727,1562,165,B10,2,Mate,White
TRUE,69,10+0,1552,1491,61,E60,5,Resign,White
TRUE,55,10+0,1814,1557,257,B10,2,Resign,White
TRUE,52,10+0,1561,1852,-291,E20,8,Mate,Black
TRUE,134,10+0,1271,1557,-286,A00,4,Resign,Black
TRUE,109,10+0,1551,1356,195,D20,4,Mate,White
TRUE,90,10+0,1604,1561,43,B12,7,Resign,White
TRUE,63,10+0,1544,1738,-194,D08,4,Mate,White
TRUE,62,15+0,1568,1578,-10,D20,4,Resign,Black
TRUE,38,15+0,1360,1562,-202,B12,7,Resign,Black
TRUE,31,10+0,1552,1503,49,D15,7,Resign,White
TRUE,166,10+0,1562,1539,23,B12,5,Mate,Black
TRUE,114,10+0,1483,1737,-254,B01,4,Mate,Black
TRUE,66,10+0,1488,1727,-239,C48,7,Resign,Black
TRUE,43,10+0,1880,1490,390,D00,9,Mate,White
TRUE,103,10+0,1898,1493,405,C50,5,Mate,White
TRUE,54,10+0,1499,1667,-168,C68,7,Resign,Black
TRUE,140,10+0,1579,1484,95,D00,4,Mate,Black
TRUE,73,10+0,1485,1465,20,C00,4,Draw,Draw
TRUE,49,10+0,1463,1201,262,C40,4,Mate,White
TRUE,25,10+0,1785,1466,319,D00,5,Resign,White
TRUE,34,10+0,1470,1742,-272,C00,3,Mate,Black
TRUE,45,10+0,1786,1474,312,C66,8,Mate,White
TRUE,44,10+0,1475,2012,-537,C45,8,Mate,Black
TRUE,123,10+0,1864,1477,387,A20,2,Mate,White
TRUE,43,10+0,1826,1480,346,C20,3,Resign,White
TRUE,39,10+0,1469,1469,0,B30,4,Resign,White
TRUE,40,10+0,1302,1462,-160,C48,7,Resign,Black
TRUE,58,10+0,1469,1609,-140,C60,6,Mate,Black
TRUE,66,10+0,1566,1455,111,A20,2,Resign,Black
TRUE,22,10+0,1462,1610,-148,C41,7,Mate,Black
TRUE,54,10+0,1480,1231,249,B07,2,Resign,Black
FALSE,52,5+8,1500,1698,-198,B07,4,Mate,Black
TRUE,61,10+10,1720,1783,-63,B30,4,Resign,White
TRUE,31,10+10,1855,1792,63,B21,3,Resign,White
TRUE,183,6+20,1847,1801,46,B20,3,Mate,White
TRUE,159,5+5,1792,1743,49,D30,4,Resign,White
TRUE,116,8+2,1798,1988,-190,C02,6,Mate,Black
TRUE,53,7+9,1788,1756,32,C55,6,Resign,White
TRUE,114,7+9,1755,1789,-34,D02,3,Draw,Draw
FALSE,96,12+3,1696,1789,-93,C62,6,Resign,Black
TRUE,141,10+0,1799,1832,-33,C00,3,Resign,Black
FALSE,151,10+0,1799,1500,299,D06,4,Resign,White
FALSE,98,10+0,1562,1799,-237,D00,3,Resign,Black
FALSE,105,10+0,1799,1500,299,D43,8,Out of Time,White
TRUE,131,15+15,1851,1808,43,A00,1,Mate,White
TRUE,77,15+15,1749,1799,-50,B33,11,Resign,Black
TRUE,105,10+3,1790,1734,56,D21,6,Resign,White
FALSE,55,10+0,1340,1790,-450,B30,5,Mate,White
TRUE,72,7+15,1801,1794,7,D06,4,Mate,Black
FALSE,87,10+0,1801,1377,424,A40,2,Resign,White
FALSE,62,10+0,1729,1801,-72,B34,9,Mate,Black
FALSE,53,10+0,1801,1729,72,D08,7,Mate,White
FALSE,75,15+0,1500,1801,-301,E12,6,Mate,White
FALSE,26,15+0,1801,1500,301,A00,1,Mate,Black
TRUE,142,7+3,1808,1914,-106,D21,5,Mate,Black
TRUE,49,15+0,1755,1821,-66,E24,9,Resign,White
TRUE,87,15+0,1716,1835,-119,B21,3,Resign,White
FALSE,88,12+3,1835,1632,203,E12,6,Draw,Draw
FALSE,107,12+3,1835,1632,203,E12,6,Resign,White
TRUE,132,10+0,1847,1809,38,D11,7,Mate,Black
TRUE,38,10+0,1860,1770,90,D06,4,Mate,Black
TRUE,110,10+0,1784,1851,-67,B30,4,Mate,Black
TRUE,81,14+0,1841,1832,9,D26,12,Mate,White
TRUE,129,10+0,1850,1851,-1,B32,7,Mate,White
FALSE,126,10+0,1851,1703,148,E12,6,Mate,Black
FALSE,123,10+0,1851,1703,148,E12,7,Resign,White
TRUE,222,10+0,1851,1853,-2,B07,4,Draw,Draw
TRUE,31,10+0,1839,1864,-25,D21,5,Mate,White
TRUE,101,10+0,1808,1890,-82,B50,4,Resign,White
TRUE,74,10+0,1643,1878,-235,B20,3,Resign,Black
FALSE,97,10+10,1876,2621,-745,E70,7,Resign,White
TRUE,88,10+0,1886,1880,6,B57,8,Out of Time,Black
TRUE,114,10+0,1875,1922,-47,A40,2,Draw,Draw
TRUE,27,10+0,1828,1890,-62,B80,10,Resign,Black
TRUE,31,10+0,2008,1840,168,A45,3,Resign,White
TRUE,52,10+0,1861,1882,-21,C58,15,Mate,Black
TRUE,72,10+0,1856,1836,20,B30,4,Resign,Black
TRUE,66,8+6,1865,1860,5,B20,3,Resign,White
TRUE,68,5+5,1814,1836,-22,A52,6,Mate,Black
TRUE,70,8+6,1869,1802,67,B20,3,Mate,Black
TRUE,27,7+2,1865,1509,356,C55,6,Resign,White
TRUE,50,10+0,1542,1842,-300,A81,3,Resign,Black
TRUE,40,10+0,1594,1529,65,B57,8,Resign,Black
TRUE,51,10+0,1428,1544,-116,B20,3,Out of Time,White
TRUE,118,15+10,1552,1648,-96,D35,9,Resign,Black
TRUE,89,10+0,1574,1562,12,D04,5,Out of Time,White
TRUE,67,10+0,1590,1561,29,B20,3,Draw,Draw
TRUE,31,10+0,1558,1235,323,D21,6,Resign,White
TRUE,101,15+15,1547,1567,-20,D20,5,Resign,White
TRUE,37,10+5,1517,1559,-42,E90,9,Out of Time,White
TRUE,80,10+10,1429,1552,-123,C00,3,Mate,Black
FALSE,10,10+0,1675,1500,175,A00,1,Resign,Black
TRUE,30,10+0,1604,1700,-96,C78,9,Resign,White
TRUE,94,10+0,1444,1696,-252,A21,3,Mate,Black
TRUE,78,8+0,1246,1694,-448,C55,6,Mate,Black
TRUE,57,8+0,1684,1658,26,B12,5,Resign,White
TRUE,60,10+0,1689,1893,-204,C53,9,Mate,Black
TRUE,41,10+0,1678,1698,-20,A06,3,Mate,White
TRUE,81,10+0,1671,1553,118,B40,6,Resign,White
TRUE,45,1+20,1659,1684,-25,C02,10,Out of Time,White
TRUE,27,10+5,1695,1669,26,B20,3,Resign,White
TRUE,47,10+5,1680,1684,-4,C50,5,Resign,Black
TRUE,16,10+5,1696,1668,28,B20,3,Resign,Black
TRUE,48,12+3,1692,1679,13,B20,3,Resign,White
TRUE,52,10+0,1702,1667,35,A01,5,Resign,Black
TRUE,63,10+0,1683,1677,6,B72,11,Mate,White
TRUE,132,10+6,1688,1703,-15,C57,11,Mate,Black
TRUE,53,4+6,1689,1699,-10,B54,9,Resign,White
TRUE,77,8+10,1689,1655,34,C41,6,Mate,White
TRUE,54,8+0,1798,1697,101,A00,1,Resign,White
TRUE,56,10+2,1707,1756,-49,B56,11,Mate,Black
TRUE,60,10+0,1715,1804,-89,C71,8,Resign,Black
TRUE,53,10+0,1727,1702,25,C58,11,Resign,Black
TRUE,76,15+10,1748,1715,33,C21,3,Resign,Black
TRUE,51,10+0,2040,1718,322,D00,3,Mate,White
TRUE,86,10+0,1713,1493,220,C58,11,Resign,White
TRUE,109,10+0,1697,1725,-28,D03,5,Mate,White
TRUE,84,10+0,1777,1712,65,B57,8,Resign,Black
TRUE,43,10+0,1724,1697,27,C41,5,Resign,Black
TRUE,72,10+0,1735,1747,-12,C50,6,Mate,Black
TRUE,53,10+0,1757,1746,11,C44,6,Resign,White
TRUE,93,10+0,1751,1753,-2,C53,9,Mate,White
TRUE,34,10+0,1762,1847,-85,C48,7,Resign,Black
TRUE,54,10+0,1901,1746,155,D15,7,Mate,Black
TRUE,90,9+0,1385,1756,-371,A20,3,Out of Time,Black
TRUE,53,9+0,1754,1387,367,B27,3,Mate,White
TRUE,72,10+5,1765,1774,-9,B77,17,Resign,Black
FALSE,37,5+5,1308,1765,-457,B20,3,Mate,White
FALSE,57,10+0,1788,1891,-103,C01,7,Resign,White
FALSE,36,10+0,1788,1563,225,B06,5,Resign,Black
FALSE,65,10+10,1878,1788,90,B12,5,Resign,White
FALSE,58,8+5,1352,1788,-436,C41,5,Draw,Draw
FALSE,49,20+0,1788,1698,90,C21,10,Mate,White
FALSE,50,10+0,2203,1788,415,B13,5,Resign,White
FALSE,49,30+0,1558,1289,269,B01,4,Resign,White
TRUE,55,10+0,1443,1296,147,C24,4,Resign,White
TRUE,18,10+0,1275,1281,-6,D20,5,Resign,Black
TRUE,92,10+0,1291,1333,-42,C44,6,Mate,Black
TRUE,109,10+0,1268,1303,-35,B01,4,Out of Time,White
TRUE,55,10+0,1291,1326,-35,A04,2,Resign,White
TRUE,57,10+0,1698,1293,405,C60,6,Resign,White
TRUE,18,10+0,1297,1591,-294,C21,5,Resign,Black
TRUE,29,10+0,1300,1279,21,D01,4,Draw,Draw
TRUE,41,10+0,1265,1373,-108,A20,2,Mate,White
TRUE,19,10+0,1348,1274,74,A00,1,Mate,White
TRUE,75,10+0,1264,1216,48,A00,2,Mate,White
TRUE,55,10+0,1465,1270,195,C21,5,Out of Time,White
TRUE,36,10+0,1343,1256,87,C20,3,Mate,Black
TRUE,73,10+0,1286,1276,10,C46,6,Out of Time,White
TRUE,19,15+15,1564,1621,-57,A85,5,Resign,White
TRUE,26,15+15,1580,1390,190,A40,2,Resign,Black
TRUE,42,15+15,1569,1570,-1,B20,2,Out of Time,Black
TRUE,55,15+15,1560,1518,42,E94,15,Mate,White
TRUE,78,15+15,1567,1702,-135,B12,5,Resign,Black
TRUE,104,15+15,1500,1560,-60,B25,4,Mate,Black
TRUE,135,10+3,2029,2103,-74,B57,15,Resign,White
TRUE,55,10+3,2094,2039,55,D06,4,Resign,White
TRUE,44,15+45,1462,1473,-11,B57,8,Resign,Black
TRUE,62,10+0,1533,1430,103,D20,5,Mate,Black
TRUE,28,10+6,1364,1463,-99,C40,4,Resign,White
TRUE,41,5+5,1491,1491,0,B00,3,Resign,Black
TRUE,18,8+0,1648,1509,139,C22,7,Resign,White
TRUE,80,5+10,1291,1494,-203,C70,8,Resign,Black
TRUE,63,5+10,1474,1337,137,B21,3,Mate,White
TRUE,51,60+7,1453,1306,147,C36,7,Resign,White
TRUE,39,10+3,1674,1557,117,D32,6,Resign,Black
TRUE,36,15+0,1701,1618,83,D31,5,Resign,Black
TRUE,37,10+0,1795,1709,86,A00,1,Resign,White
TRUE,39,15+15,1692,1889,-197,D37,7,Mate,White
TRUE,105,15+15,1663,1812,-149,E90,9,Mate,White
TRUE,20,10+5,1652,1635,17,E20,8,Resign,White
TRUE,69,10+0,1774,1660,114,B30,5,Resign,White
TRUE,41,5+5,1591,1674,-83,D00,3,Resign,White
TRUE,57,10+10,1595,1689,-94,B30,4,Resign,White
TRUE,91,10+0,1677,1683,-6,D32,8,Mate,White
TRUE,87,10+0,1663,1711,-48,D07,6,Resign,White
TRUE,68,15+15,1674,1500,174,D20,5,Resign,Black
TRUE,44,15+15,1635,1663,-28,B50,4,Resign,Black
TRUE,81,10+0,1666,1605,61,D20,4,Out of Time,White
TRUE,111,10+10,1613,1680,-67,B72,11,Resign,White
TRUE,90,10+3,1535,1673,-138,B20,3,Out of Time,Black
FALSE,59,30+6,1673,1607,66,A08,4,Resign,White
TRUE,53,10+0,1620,1687,-67,B21,3,Resign,White
TRUE,62,10+0,1698,1739,-41,D94,9,Resign,Black
TRUE,111,10+0,1615,1714,-99,B51,5,Out of Time,White
TRUE,72,10+0,1725,1786,-61,A50,4,Out of Time,Black
TRUE,65,15+15,1731,1711,20,B72,11,Resign,Black
TRUE,35,15+15,1699,1671,28,E20,8,Resign,White
TRUE,53,15+15,1679,1714,-35,B20,3,Resign,White
TRUE,47,10+0,1447,1736,-289,B53,7,Resign,White
TRUE,51,10+0,1750,1739,11,A04,2,Resign,Black
TRUE,19,10+0,1748,1283,465,A07,3,Resign,White
TRUE,57,10+0,1752,2079,-327,A05,4,Resign,Black
TRUE,70,10+0,1763,1738,25,B50,4,Mate,Black
TRUE,101,12+10,1598,1757,-159,B50,4,Mate,White
TRUE,57,10+0,1783,1530,253,C01,7,Resign,White
TRUE,76,12+0,1536,1726,-190,C62,6,Resign,Black
TRUE,62,10+0,1669,1520,149,B01,2,Mate,Black
TRUE,56,10+0,1522,1941,-419,B10,2,Resign,Black
TRUE,107,5+5,1681,1528,153,C41,5,Mate,White
TRUE,21,10+0,1536,1642,-106,B01,2,Resign,Black
TRUE,33,10+5,1743,1542,201,D02,3,Resign,White
TRUE,69,10+0,1527,1648,-121,C41,6,Resign,White
TRUE,57,10+0,1652,1534,118,D07,6,Resign,White
TRUE,37,11+0,1681,1541,140,C41,5,Resign,White
TRUE,47,15+10,1626,1550,76,A20,2,Resign,White
TRUE,77,8+8,1558,1652,-94,C41,5,Resign,Black
TRUE,60,5+5,1567,1646,-79,C44,4,Resign,Black
TRUE,60,10+2,1576,1656,-80,C62,6,Mate,Black
TRUE,85,15+0,1558,1588,-30,C20,3,Resign,White
TRUE,125,5+5,1576,1596,-20,C00,5,Resign,White
TRUE,61,10+8,1833,1581,252,C41,4,Resign,White
TRUE,209,10+0,1859,1585,274,C41,5,Resign,White
TRUE,89,15+0,1680,1593,87,C41,5,Mate,White
TRUE,104,8+0,1588,1756,-168,C00,3,Draw,Draw
TRUE,49,10+10,1575,1643,-68,C53,7,Resign,White
TRUE,116,10+1,1583,1699,-116,C00,2,Mate,Black
TRUE,77,8+0,1797,1588,209,C41,5,Resign,White
TRUE,78,5+8,1731,1572,159,C30,3,Resign,Black
TRUE,43,8+0,1565,1584,-19,D00,3,Mate,White
TRUE,34,10+0,1698,1568,130,C23,3,Resign,Black
TRUE,70,10+5,1572,1828,-256,B20,3,Resign,Black
TRUE,23,7+6,1645,1568,77,C41,5,Resign,White
TRUE,132,12+0,1623,1578,45,C41,4,Resign,White
TRUE,121,7+8,1657,1587,70,D02,4,Mate,White
TRUE,50,5+8,1934,1590,344,D30,4,Resign,White
TRUE,51,12+0,1657,1600,57,C41,4,Resign,White
TRUE,45,9+1,1668,1610,58,D02,4,Mate,White
TRUE,90,10+5,1616,1776,-160,B53,7,Resign,Black
TRUE,45,10+0,1607,1551,56,B06,2,Resign,White
TRUE,26,10+0,1623,1594,29,C41,5,Resign,Black
TRUE,19,10+0,2189,1595,594,D02,4,Resign,White
TRUE,70,7+4,1581,1649,-68,C41,6,Resign,White
TRUE,27,10+0,1710,1589,121,C27,3,Resign,White
TRUE,99,8+5,1853,1593,260,C41,5,Resign,White
TRUE,52,8+3,1595,2030,-435,B06,2,Mate,Black
TRUE,72,8+0,1589,1728,-139,B01,2,Resign,Black
TRUE,61,10+0,1956,1591,365,D30,4,Mate,White
TRUE,33,8+5,1832,1583,249,D37,7,Mate,White
TRUE,85,8+0,1737,1590,147,C23,3,Resign,White
TRUE,45,8+8,1712,1598,114,C00,3,Mate,White
FALSE,50,8+5,1211,1500,-289,C55,6,Mate,Black
TRUE,43,11+0,1834,1218,616,C40,4,Mate,White
FALSE,43,10+5,1742,1218,524,B00,3,Mate,White
FALSE,17,10+5,1742,1218,524,B00,2,Mate,White
TRUE,113,15+5,1500,1261,239,B00,2,Mate,White
TRUE,18,10+0,1317,1538,-221,B01,2,Resign,Black
FALSE,46,15+0,1317,1500,-183,C20,3,Mate,Black
FALSE,23,15+0,1500,1317,183,B00,5,Mate,White
TRUE,39,45+10,1940,1327,613,B00,3,Mate,White
TRUE,63,6+5,1504,1500,4,B00,2,Mate,White
TRUE,102,10+0,1724,1847,-123,C00,3,Out of Time,Black
TRUE,24,10+0,1800,1733,67,E20,5,Resign,White
TRUE,80,10+0,1741,1880,-139,B32,8,Out of Time,Black
TRUE,25,10+0,1874,1748,126,B21,3,Mate,White
TRUE,12,10+0,1758,1815,-57,C50,6,Resign,Black
TRUE,56,10+0,1842,1743,99,B90,11,Mate,Black
TRUE,53,10+0,1741,1804,-63,B44,8,Draw,Draw
TRUE,63,10+0,1727,1800,-73,B54,6,Resign,White
TRUE,75,10+0,1847,1735,112,B23,5,Mate,White
TRUE,33,10+0,1867,1743,124,C00,4,Resign,White
TRUE,42,10+0,1753,1811,-58,C42,6,Resign,Black
TRUE,64,10+0,1809,1739,70,B20,3,Mate,Black
TRUE,17,10+0,1811,1723,88,E00,5,Resign,Black
TRUE,34,10+0,1733,1802,-69,C41,5,Resign,Black
TRUE,41,10+0,1826,1743,83,D00,4,Resign,White
TRUE,37,10+0,1726,1856,-130,C40,4,Mate,White
TRUE,73,10+0,1710,1815,-105,B01,4,Mate,White
TRUE,110,10+0,1719,1817,-98,C55,6,Out of Time,Black
TRUE,41,10+0,1809,1729,80,B96,13,Resign,White
TRUE,62,10+0,1884,1710,174,A04,2,Resign,Black
TRUE,44,10+0,1797,1693,104,B92,11,Mate,Black
TRUE,57,10+0,1689,1801,-112,B27,4,Draw,Draw
TRUE,49,10+0,1668,1891,-223,B06,4,Mate,White
TRUE,55,10+0,1804,1677,127,A30,2,Resign,White
TRUE,83,10+0,1805,1686,119,E00,5,Mate,White
TRUE,52,10+0,1696,1812,-116,B90,10,Mate,Black
TRUE,26,10+0,1703,1880,-177,C42,5,Resign,Black
TRUE,82,10+0,1890,1681,209,B95,12,Out of Time,Black
TRUE,80,10+0,1690,1830,-140,B00,4,Out of Time,Black
TRUE,37,10+0,1823,1700,123,B80,10,Resign,White
TRUE,18,10+0,1679,1838,-159,B00,4,Resign,White
TRUE,47,10+0,1908,1697,211,B07,2,Out of Time,White
TRUE,42,10+0,1704,1903,-199,C41,6,Resign,Black
TRUE,71,10+0,1897,1713,184,B20,3,Resign,White
TRUE,71,10+0,1880,1722,158,B50,4,Out of Time,White
TRUE,67,10+0,1888,1732,156,B50,4,Out of Time,White
TRUE,75,10+0,1850,1744,106,E20,5,Out of Time,White
TRUE,43,15+0,1792,1760,32,B50,4,Resign,White
TRUE,41,10+0,1775,1816,-41,C41,5,Resign,Black
TRUE,69,10+0,1806,1793,13,A40,2,Out of Time,White
TRUE,24,10+0,1772,1817,-45,C50,5,Resign,White
FALSE,41,10+0,1772,1919,-147,C41,6,Resign,Black
TRUE,73,10+0,1877,1787,90,B52,6,Resign,White
TRUE,31,10+0,1886,1803,83,B54,6,Resign,White
TRUE,37,10+0,1739,1830,-91,E12,6,Resign,White
TRUE,84,10+0,1852,1872,-20,B06,4,Out of Time,Black
TRUE,57,10+0,1861,1877,-16,B21,3,Mate,White
TRUE,29,10+0,1850,1872,-22,C50,8,Resign,White
TRUE,56,10+0,1881,1830,51,C54,11,Out of Time,Black
TRUE,36,5+5,1352,1610,-258,C55,6,Resign,Black
TRUE,87,5+8,1605,1296,309,D00,8,Mate,White
TRUE,114,5+5,1066,1602,-536,C20,3,Mate,Black
FALSE,53,19+0,1477,1602,-125,B20,2,Resign,White
FALSE,41,19+0,1602,1477,125,C02,6,Resign,White
FALSE,62,15+0,1708,2024,-316,C44,5,Mate,Black
FALSE,63,15+0,2024,1708,316,B23,3,Resign,White
FALSE,54,15+0,1708,2024,-316,E91,11,Mate,Black
FALSE,38,15+0,1708,2024,-316,D04,6,Resign,Black
FALSE,115,15+0,1458,1708,-250,D04,5,Draw,Draw
FALSE,68,15+0,1708,1844,-136,D02,4,Resign,Black
FALSE,21,15+0,1708,1500,208,C45,7,Resign,Black
FALSE,64,15+0,1545,1708,-163,A45,2,Resign,White
FALSE,68,15+0,1708,1708,0,A45,2,Mate,Black
FALSE,50,15+0,1500,1708,-208,B86,11,Resign,Black
FALSE,61,15+0,1708,1500,208,D02,4,Mate,White
FALSE,8,15+0,1478,1708,-230,B20,2,Resign,Black
FALSE,45,15+0,1708,1577,131,C02,7,Resign,White
FALSE,86,15+0,1701,1708,-7,A15,4,Resign,Black
FALSE,84,15+0,1520,1708,-188,B50,4,Resign,Black
FALSE,37,15+0,1708,1410,298,D02,3,Mate,White
FALSE,119,15+0,1708,1410,298,B50,6,Resign,White
FALSE,45,15+0,1332,1708,-376,B20,3,Resign,White
FALSE,46,15+0,2180,1708,472,B21,3,Resign,White
FALSE,84,15+0,1708,2180,-472,D04,5,Resign,Black
FALSE,45,15+0,2180,1708,472,E72,9,Draw,Draw
FALSE,52,15+0,1323,1708,-385,B10,2,Resign,Black
FALSE,25,15+0,1708,1540,168,B20,2,Resign,Black
FALSE,91,15+0,1954,1708,246,A16,3,Resign,White
FALSE,3,15+0,1708,1215,493,A40,2,Resign,White
FALSE,45,15+0,1708,1668,40,D04,5,Resign,White
FALSE,64,15+0,1470,1708,-238,B50,4,Resign,Black
FALSE,54,15+0,1708,1579,129,A07,3,Resign,Black
FALSE,101,15+0,1708,1638,70,A04,2,Resign,White
FALSE,147,15+0,1708,1592,116,D02,4,Out of Time,White
TRUE,65,10+0,1371,1486,-115,C40,4,Mate,White
TRUE,90,10+0,1479,1475,4,C30,4,Out of Time,Black
TRUE,61,10+0,1339,1490,-151,C40,4,Mate,White
TRUE,130,10+0,1506,1321,185,D00,3,Mate,Black
TRUE,44,10+0,1454,1497,-43,C40,4,Mate,Black
TRUE,39,10+0,1488,1422,66,A43,3,Resign,White
TRUE,43,10+0,1476,1506,-30,D00,5,Resign,White
TRUE,62,10+0,1397,1468,-71,D21,5,Resign,Black
TRUE,69,10+0,1461,1338,123,D00,5,Mate,White
TRUE,56,10+0,1364,1453,-89,D02,3,Mate,Black
TRUE,92,10+0,1456,1444,12,A00,7,Mate,Black
TRUE,68,10+0,1400,1446,-46,C20,3,Mate,Black
TRUE,65,10+0,1435,1486,-51,D00,5,Resign,White
TRUE,72,10+0,1354,1427,-73,C20,3,Mate,Black
TRUE,51,10+0,1418,1361,57,D00,4,Mate,White
TRUE,90,10+0,1409,1407,2,C40,4,Mate,Black
TRUE,129,10+0,1399,1319,80,D00,5,Out of Time,White
TRUE,48,10+0,1386,1388,-2,C40,4,Mate,Black
TRUE,54,10+0,1398,1436,-38,B01,2,Mate,Black
TRUE,56,10+0,1409,1268,141,D00,5,Mate,Black
TRUE,118,10+0,1500,1400,100,C40,4,Mate,Black
TRUE,107,10+0,1473,1409,64,C44,5,Mate,White
TRUE,46,10+0,1361,1399,-38,D00,3,Mate,Black
TRUE,19,10+0,1389,1370,19,C00,3,Mate,White
TRUE,42,10+0,1381,1379,2,C54,11,Resign,Black
TRUE,39,10+0,1368,1382,-14,D00,2,Mate,White
TRUE,57,10+0,1359,1339,20,D02,4,Mate,White
TRUE,43,10+0,1348,1360,-12,D00,3,Mate,White
TRUE,79,10+0,1349,1359,-10,C20,3,Mate,White
TRUE,103,10+0,1415,1379,36,C26,5,Mate,White
TRUE,104,10+0,1389,1405,-16,D00,5,Mate,Black
TRUE,78,10+0,1397,1509,-112,C02,5,Mate,Black
TRUE,67,10+0,1392,1395,-3,C40,4,Resign,White
TRUE,66,10+0,1407,1373,34,C20,3,Mate,Black
TRUE,113,10+0,1359,1420,-61,C40,4,Mate,White
TRUE,13,10+0,1410,1390,20,C20,3,Resign,White
TRUE,18,10+0,1429,1399,30,C40,4,Resign,Black
TRUE,38,10+0,1374,1391,-17,A00,1,Mate,Black
TRUE,68,10+0,1403,1363,40,C00,3,Mate,Black
TRUE,37,10+0,1350,1416,-66,D00,4,Resign,White
TRUE,38,10+0,1355,1406,-51,D02,4,Resign,Black
TRUE,74,10+0,1782,1710,72,C34,5,Resign,Black
TRUE,76,10+0,1734,1697,37,C50,7,Resign,Black
TRUE,27,10+0,1707,1775,-68,B50,4,Resign,Black
TRUE,55,10+0,1978,1711,267,C70,8,Resign,White
TRUE,48,10+0,1704,1549,155,A50,4,Resign,White
TRUE,76,10+0,1710,1692,18,C45,7,Resign,Black
TRUE,168,10+0,1705,1679,26,B13,5,Resign,Black
TRUE,46,10+0,1712,1867,-155,A80,4,Resign,Black
TRUE,114,10+0,1505,1706,-201,D00,3,Mate,Black
TRUE,32,5+8,1864,1713,151,C44,7,Resign,White
TRUE,126,10+0,1718,1941,-223,A45,2,Out of Time,Black
TRUE,95,10+0,1374,1740,-366,C50,6,Mate,White
TRUE,55,10+1,1879,1747,132,C70,10,Resign,White
TRUE,149,10+0,1743,1498,245,A40,1,Mate,White
TRUE,83,10+0,1730,1754,-24,B28,5,Out of Time,White
TRUE,30,10+0,2092,1733,359,C45,8,Resign,White
TRUE,144,10+0,1752,1465,287,D06,4,Mate,Black
TRUE,123,5+5,1730,1753,-23,A22,4,Mate,White
TRUE,41,10+0,1760,1908,-148,E90,9,Resign,Black
TRUE,104,10+0,1920,1755,165,C45,7,Draw,Draw
TRUE,24,10+0,1758,2112,-354,D80,7,Resign,Black
TRUE,39,10+0,1750,1634,116,A43,3,Resign,White
TRUE,92,10+0,1877,1733,144,C70,10,Resign,Black
TRUE,109,10+0,1716,1857,-141,C00,3,Resign,White
TRUE,70,10+0,1057,1716,-659,D00,4,Mate,Black
TRUE,49,15+0,1858,1723,135,C24,4,Resign,White
FALSE,77,10+0,1888,1723,165,A06,2,Resign,White
TRUE,95,15+10,1705,1927,-222,C00,3,Resign,White
TRUE,136,10+0,2054,1683,371,A00,1,Mate,Black
TRUE,46,10+0,1686,2022,-336,A85,5,Resign,Black
TRUE,21,10+0,1209,1685,-476,D02,4,Resign,Black
TRUE,52,10+0,1964,2331,-367,A00,5,Resign,Black
TRUE,58,10+0,1754,2329,-575,D00,5,Mate,Black
TRUE,43,10+0,2329,1613,716,C66,12,Resign,White
TRUE,59,10+0,2320,2132,188,B80,10,Resign,White
TRUE,76,10+0,2275,2303,-28,A14,9,Resign,Black
TRUE,62,10+0,1846,1788,58,B90,11,Out of Time,Black
TRUE,97,10+0,1780,1677,103,C00,4,Resign,White
TRUE,62,10+0,1776,1460,316,B54,6,Resign,White
TRUE,36,10+0,1788,1600,188,A40,6,Resign,Black
TRUE,118,10+0,1552,1783,-231,A00,1,Resign,Black
TRUE,71,10+0,1877,1792,85,B50,4,Mate,White
TRUE,51,10+0,1622,1797,-175,B21,3,Draw,Draw
TRUE,45,10+0,1793,1519,274,B07,5,Mate,White
TRUE,41,10+0,1792,1178,614,D06,4,Mate,White
TRUE,54,10+0,1655,1785,-130,B52,6,Mate,Black
TRUE,92,10+0,1676,1777,-101,B50,4,Out of Time,Black
TRUE,59,10+0,1775,1337,438,D20,5,Resign,White
TRUE,64,10+0,1408,1772,-364,B25,4,Mate,Black
TRUE,103,10+0,1778,1579,199,D40,8,Draw,Draw
TRUE,106,10+0,1798,1390,408,D20,5,Resign,Black
TRUE,69,10+0,1786,1816,-30,D91,9,Mate,White
TRUE,41,10+0,1764,1798,-34,B53,7,Resign,White
TRUE,69,10+0,1783,1916,-133,D37,7,Mate,White
FALSE,44,10+0,1548,1517,31,C55,7,Mate,Black
FALSE,99,10+0,1517,1548,-31,B11,4,Draw,Draw
TRUE,164,10+0,1558,1583,-25,C55,7,Out of Time,Black
TRUE,42,10+0,1544,1636,-92,B32,7,Resign,White
TRUE,107,10+0,1541,1651,-110,C41,5,Draw,Draw
TRUE,58,10+0,1542,1530,12,B10,2,Resign,Black
TRUE,23,10+5,1522,1486,36,C53,9,Resign,White
TRUE,20,8+0,1532,1567,-35,B06,7,Out of Time,Black
TRUE,62,5+5,1533,1544,-11,B12,7,Resign,White
TRUE,57,10+0,1707,1550,157,D00,3,Mate,White
TRUE,58,10+0,1547,1664,-117,B02,2,Draw,Draw
TRUE,17,10+0,1536,1534,2,C41,5,Resign,White
TRUE,37,10+0,1524,1536,-12,C41,5,Resign,White
TRUE,81,10+5,1514,1511,3,C40,4,Resign,White
TRUE,72,10+5,1522,1502,20,B12,7,Mate,Black
TRUE,19,10+5,1489,1378,111,C53,9,Resign,White
FALSE,46,15+5,1489,1511,-22,C53,9,Resign,White
FALSE,7,10+5,1588,1489,99,B12,5,Resign,Black
FALSE,74,8+0,1500,1489,11,B00,3,Mate,Black
FALSE,28,10+0,1489,1567,-78,C01,5,Resign,Black
FALSE,21,5+15,1489,1566,-77,C40,4,Out of Time,White
FALSE,21,10+5,1500,1489,11,B10,2,Resign,White
FALSE,17,5+5,1500,1489,11,D00,3,Resign,Black
FALSE,35,10+0,1489,1511,-22,B07,3,Resign,Black
TRUE,72,10+5,1496,1500,-4,C53,9,Resign,Black
FALSE,9,15+1,1496,1508,-12,B01,4,Resign,White
FALSE,76,15+1,1508,1496,12,B10,2,Mate,Black
FALSE,25,20+0,1527,1496,31,B12,5,Resign,White
FALSE,32,5+8,1500,1496,4,A00,1,Mate,Black
TRUE,67,8+2,1485,1489,-4,C55,7,Out of Time,White
TRUE,31,5+10,1509,1496,13,B11,4,Mate,White
FALSE,57,15+5,2320,1500,820,C05,12,Mate,White
FALSE,61,15+10,2193,1500,693,C05,12,Mate,White
FALSE,50,15+10,1500,2193,-693,D85,13,Mate,Black
FALSE,39,15+15,1462,1500,-38,A40,2,Mate,White
TRUE,47,10+0,1794,1816,-22,E12,7,Resign,White
TRUE,91,10+0,1807,1741,66,C02,5,Resign,White
TRUE,14,10+0,1796,1805,-9,D20,5,Resign,White
TRUE,69,10+0,1817,1784,33,B20,3,Resign,Black
TRUE,62,10+0,1748,1774,-26,A00,1,Resign,Black
TRUE,73,10+0,1762,1805,-43,E61,6,Out of Time,White
TRUE,18,10+0,1775,1728,47,A43,3,Resign,Black
TRUE,31,10+0,2167,1777,390,C37,9,Resign,White
TRUE,64,10+0,1742,1767,-25,B30,5,Resign,Black
TRUE,110,10+0,1779,1735,44,D31,6,Out of Time,Black
TRUE,175,10+0,1773,1613,160,D06,4,Mate,White
TRUE,117,10+0,1820,1782,38,C39,10,Resign,White
TRUE,34,10+0,1642,1775,-133,A46,5,Resign,Black
TRUE,28,10+0,1782,1914,-132,D35,7,Resign,Black
TRUE,51,10+0,1775,1665,110,D35,7,Resign,White
TRUE,74,10+0,1791,1785,6,D20,5,Resign,White
TRUE,48,10+0,1798,1725,73,A00,1,Resign,Black
TRUE,71,10+0,1781,1809,-28,C20,4,Resign,White
TRUE,33,10+0,1797,1865,-68,E24,9,Resign,White
TRUE,40,10+0,1765,1787,-22,C50,6,Resign,Black
TRUE,107,10+0,1778,1701,77,B12,3,Out of Time,White
TRUE,40,10+0,1789,1796,-7,E61,6,Resign,Black
TRUE,23,10+0,1806,1799,7,C26,6,Resign,White
TRUE,27,10+0,1900,1806,94,C62,6,Mate,White
TRUE,100,10+0,1817,1809,8,D20,5,Mate,Black
TRUE,31,10+0,1895,1825,70,C37,9,Resign,White
TRUE,41,10+0,1815,1792,23,D20,5,Resign,White
TRUE,12,10+0,1807,1827,-20,C50,7,Resign,White
TRUE,23,10+0,1546,1845,-299,C53,7,Resign,White
TRUE,87,10+0,1835,1819,16,D20,5,Resign,White
TRUE,132,10+0,1843,1902,-59,D10,5,Resign,Black
TRUE,72,10+0,1773,1856,-83,A45,3,Resign,White
TRUE,164,10+0,1801,1858,-57,C45,7,Out of Time,Draw
TRUE,41,10+0,1849,1810,39,E61,4,Resign,White
TRUE,30,10+0,1862,1764,98,A51,6,Resign,Black
TRUE,73,10+0,1854,1765,89,A85,5,Mate,White
TRUE,50,10+0,1865,1845,20,A80,3,Resign,Black
TRUE,107,10+0,1834,1877,-43,A03,2,Resign,White
TRUE,29,10+0,2074,1883,191,C45,7,Resign,White
TRUE,32,10+0,1779,1875,-96,C50,7,Mate,Black
TRUE,108,10+0,1886,1864,22,C11,11,Mate,Black
TRUE,51,10+0,1852,1898,-46,D08,4,Resign,White
TRUE,79,10+0,1842,1800,42,D51,10,Resign,White
TRUE,90,10+0,1845,1746,99,D20,5,Draw,Draw
TRUE,98,15+0,1713,1735,-22,C50,9,Resign,Black
TRUE,139,15+0,1619,1727,-108,A01,4,Mate,White
TRUE,79,15+0,1726,1760,-34,C20,4,Draw,Draw
TRUE,139,15+0,1711,1738,-27,D00,4,Resign,White
TRUE,100,15+0,1721,1727,-6,D00,4,Resign,Black
TRUE,42,15+0,1739,1701,38,C23,4,Mate,Black
TRUE,61,15+0,1787,1749,38,C50,8,Resign,White
TRUE,54,15+0,1760,1740,20,C26,6,Mate,Black
TRUE,43,15+0,1753,1611,142,B06,5,Mate,White
TRUE,78,15+0,1702,1755,-53,C62,6,Draw,Draw
TRUE,57,15+0,1641,1770,-129,A40,3,Mate,White
TRUE,90,15+0,1785,1616,169,B08,8,Mate,Black
TRUE,116,15+0,1751,1775,-24,C50,11,Out of Time,Black
TRUE,104,15+0,1787,1739,48,B20,3,Resign,Black
TRUE,101,15+0,1767,1799,-32,C62,6,Out of Time,White
TRUE,93,15+0,1792,1688,104,C50,6,Out of Time,White
TRUE,84,15+0,1796,1652,144,C01,5,Draw,Draw
TRUE,47,15+0,1788,1665,123,C55,6,Mate,White
TRUE,66,15+0,1674,1781,-107,C50,8,Resign,Black
TRUE,80,15+0,1812,1693,119,C46,7,Resign,Black
TRUE,108,15+0,1734,1803,-69,C44,6,Resign,Black
TRUE,81,15+0,1794,1724,70,C50,5,Resign,White
TRUE,96,15+0,1811,1603,208,B12,3,Resign,Black
TRUE,56,15+0,1627,1816,-189,C34,6,Draw,Draw
TRUE,41,15+0,1810,1641,169,B20,3,Resign,White
TRUE,31,15+0,1623,1827,-204,C21,5,Mate,White
TRUE,59,15+0,1821,1620,201,B12,3,Mate,White
TRUE,31,15+0,1800,1647,153,B20,3,Resign,White
TRUE,151,15+0,1794,1648,146,B00,4,Resign,White
TRUE,52,15+0,1809,1662,147,C50,9,Mate,Black
TRUE,47,15+0,1802,1660,142,C50,11,Mate,White
TRUE,88,15+0,1667,1795,-128,C62,6,Resign,Black
TRUE,70,15+0,1679,1788,-109,C44,5,Resign,Black
TRUE,71,15+0,1780,1686,94,C50,9,Resign,White
TRUE,42,15+0,1694,1771,-77,C50,8,Resign,Black
TRUE,16,15+0,1622,1765,-143,C30,3,Out of Time,Black
TRUE,98,15+0,1776,1759,17,B20,3,Resign,Black
TRUE,72,15+0,1788,1740,48,C02,7,Resign,Black
TRUE,56,15+0,1794,1724,70,B20,3,Mate,Black
TRUE,74,15+0,1800,1959,-159,B20,3,Resign,Black
TRUE,77,15+0,1952,1807,145,C44,5,Resign,White
TRUE,48,15+0,1754,1797,-43,C46,5,Mate,Black
TRUE,39,5+8,2579,2036,543,A05,4,Resign,White
TRUE,44,5+8,2037,2577,-540,B11,8,Out of Time,Black
TRUE,33,5+8,2574,2039,535,A04,2,Resign,White
TRUE,92,5+8,2040,2571,-531,B11,8,Resign,Black
TRUE,53,5+5,2367,2043,324,B24,8,Out of Time,White
TRUE,53,10+5,2029,2099,-70,B77,18,Resign,White
TRUE,49,8+0,2324,2033,291,E63,14,Resign,White
TRUE,72,10+0,2033,2368,-335,B90,10,Mate,Black
TRUE,97,10+0,2214,2039,175,A30,12,Out of Time,White
TRUE,61,9+8,2024,2154,-130,C55,7,Resign,White
TRUE,77,10+2,2013,2022,-9,C50,6,Mate,White
TRUE,49,5+5,2163,2020,143,B43,10,Resign,White
TRUE,185,10+0,2070,2018,52,B56,10,Draw,Draw
TRUE,43,8+1,2245,2023,222,B22,8,Resign,White
TRUE,35,8+0,2149,2031,118,B52,6,Resign,White
TRUE,74,8+0,2352,2366,-14,C40,7,Resign,White
TRUE,161,8+0,2351,2363,-12,B50,5,Mate,White
TRUE,86,8+0,1814,1662,152,C00,4,Resign,Black
FALSE,56,25+15,1711,1778,-67,D06,4,Resign,Black
FALSE,16,25+15,1756,1778,-22,C02,11,Resign,Black
FALSE,87,25+15,1778,1656,122,C02,11,Resign,White
FALSE,17,25+15,1610,1778,-168,A34,3,Resign,Black
FALSE,107,25+15,1778,1932,-154,C50,6,Resign,White
FALSE,55,25+15,1778,1723,55,B06,4,Resign,White
TRUE,89,45+2,1778,1795,-17,C78,10,Draw,Draw
TRUE,104,25+15,1966,1761,205,C00,3,Resign,Black
TRUE,113,15+15,1750,1755,-5,C40,4,Resign,White
TRUE,19,15+15,1768,1738,30,C02,8,Resign,Black
TRUE,87,15+15,1728,1681,47,B08,9,Mate,White
TRUE,58,15+15,1737,1811,-74,C02,10,Resign,Black
TRUE,160,15+15,1811,1735,76,D94,9,Draw,Draw
TRUE,64,15+15,1691,1748,-57,C00,3,Resign,White
TRUE,10,15+15,1757,1830,-73,C42,5,Resign,Black
TRUE,80,15+15,1766,1820,-54,C41,5,Mate,Black
TRUE,154,15+15,1785,1527,258,C62,6,Resign,Black
TRUE,52,15+15,1641,1778,-137,C00,3,Resign,Black
TRUE,19,15+15,1761,1790,-29,D94,9,Mate,White
TRUE,61,12+12,1650,1806,-156,D90,8,Resign,White
TRUE,55,12+12,1799,1657,142,B18,8,Resign,White
TRUE,55,12+12,1641,1816,-175,D90,8,Mate,White
TRUE,17,15+10,1805,1788,17,C67,10,Resign,White
TRUE,34,15+15,1807,2179,-372,C61,6,Resign,Black
TRUE,130,15+15,1577,1825,-248,C00,3,Resign,White
TRUE,58,20+5,1841,1681,160,C62,6,Resign,Black
TRUE,150,25+0,1634,1836,-202,C00,3,Resign,Black
TRUE,135,25+8,1621,1853,-232,C02,8,Mate,White
TRUE,119,30+0,1845,1758,87,C65,7,Resign,White
TRUE,59,15+10,1827,1857,-30,D94,9,Mate,White
TRUE,81,45+0,1847,1812,35,C01,7,Resign,White
TRUE,62,15+10,1862,1736,126,C42,5,Resign,Black
TRUE,113,20+5,1644,1868,-224,A04,2,Draw,Draw
FALSE,71,13+13,1829,1868,-39,C02,8,Resign,White
FALSE,45,10+15,1868,1645,223,C41,5,Resign,White
FALSE,103,15+5,1868,1675,193,C70,8,Resign,White
FALSE,41,10+8,1868,1662,206,B32,8,Out of Time,White
FALSE,116,10+8,1662,1868,-206,C10,6,Resign,Black
FALSE,60,10+8,1868,1662,206,B30,4,Resign,Black
FALSE,142,10+8,1662,1868,-206,C02,7,Resign,Black
FALSE,84,18+0,1868,1706,162,C66,8,Out of Time,Black
FALSE,29,15+0,1868,1769,99,C42,9,Resign,Black
FALSE,81,20+0,1579,1868,-289,C01,5,Out of Time,White
FALSE,35,10+7,1880,1868,12,C00,7,Mate,White
FALSE,65,30+0,1770,1868,-98,D94,9,Resign,Black
FALSE,62,9+20,1701,1868,-167,C02,7,Resign,Black
FALSE,12,20+0,1805,1868,-63,C00,3,Resign,Black
FALSE,46,15+10,1868,1614,254,C64,7,Resign,White
FALSE,95,15+15,1758,1868,-110,C00,3,Resign,White
TRUE,20,5+8,1787,1074,713,D10,6,Resign,Black
TRUE,51,180+180,1393,1787,-394,D06,4,Resign,White
FALSE,4,180+180,1787,1393,394,A02,1,Mate,Black
TRUE,27,10+8,1787,1296,491,C00,3,Resign,White
FALSE,40,15+8,1787,2188,-401,D14,12,Resign,Black
FALSE,31,15+8,1787,2188,-401,D01,4,Resign,Black
TRUE,40,8+0,1787,1500,287,C01,5,Resign,Black
FALSE,16,5+8,1802,1787,15,A00,1,Draw,Draw
FALSE,42,8+0,1828,1787,41,A22,5,Mate,Black
TRUE,72,30+5,1828,1674,154,C46,7,Resign,Black
TRUE,39,7+3,1502,1830,-328,B23,3,Resign,White
TRUE,33,20+0,1772,1583,189,D35,9,Out of Time,White
TRUE,59,180+180,1263,1803,-540,B01,4,Resign,White
TRUE,45,30+0,1390,1500,-110,D00,3,Resign,White
FALSE,45,20+0,1158,1294,-136,C55,6,Resign,White
FALSE,46,15+15,1371,1158,213,D07,6,Resign,White
TRUE,37,12+1,1452,1172,280,C45,7,Resign,White
TRUE,40,10+0,1332,1105,227,C44,4,Resign,Black
TRUE,3,10+0,1242,1134,108,C40,3,Resign,White
FALSE,3,10+0,1242,1134,108,C40,3,Resign,White
FALSE,44,15+15,1134,1500,-366,C50,9,Mate,Black
FALSE,65,10+5,1668,1134,534,C50,11,Mate,White
TRUE,16,20+0,1143,1558,-415,B07,2,Resign,Black
FALSE,47,10+2,2305,1883,422,B01,4,Resign,White
FALSE,32,10+2,1883,2305,-422,A45,2,Resign,Black
FALSE,25,10+2,2305,1883,422,C55,7,Resign,White
FALSE,55,10+2,1883,2305,-422,A45,2,Resign,Black
FALSE,118,20+5,2305,2085,220,B11,8,Resign,Black
FALSE,102,20+5,2085,2305,-220,B07,5,Resign,Black
TRUE,96,10+0,1182,1062,120,B00,3,Out of Time,Black
TRUE,45,10+0,1302,1278,24,C46,5,Resign,White
TRUE,105,10+0,1104,1175,-71,C20,5,Resign,White
TRUE,94,10+3,1500,1172,328,C44,5,Mate,Black
FALSE,42,10+0,1500,1500,0,A46,5,Mate,Black
FALSE,15,10+0,1500,1500,0,C65,6,Mate,White
TRUE,47,15+15,1072,947,125,C40,4,Mate,White
TRUE,105,10+0,1801,1816,-15,A45,3,Resign,White
TRUE,165,10+0,1578,1829,-251,C68,7,Draw,Draw
TRUE,123,10+0,1807,1587,220,D08,7,Resign,White
TRUE,73,10+0,1779,1315,464,A40,2,Mate,White
TRUE,71,10+0,1735,1622,113,D20,5,Resign,White
TRUE,70,10+0,1772,1781,-9,C45,7,Resign,Black
TRUE,60,10+0,1794,1712,82,C44,4,Resign,Black
TRUE,32,10+0,1765,1784,-19,C45,7,Resign,Black
TRUE,17,10+0,1836,1830,6,A03,2,Resign,White
TRUE,46,10+0,1558,1796,-238,C62,6,Mate,Black
TRUE,67,10+0,1746,1565,181,C41,5,Resign,White
TRUE,56,10+0,1573,1653,-80,C62,6,Mate,Black
TRUE,41,10+0,1500,1452,48,B22,3,Resign,White
TRUE,101,10+0,1576,1578,-2,A22,6,Resign,White
TRUE,111,10+0,1727,1582,145,C42,7,Out of Time,White
TRUE,127,10+0,1670,1591,79,C46,7,Out of Time,White
TRUE,46,10+0,1582,1523,59,B10,3,Resign,White
TRUE,88,10+0,1592,1607,-15,A10,2,Out of Time,Black
TRUE,2,10+0,1629,1580,49,C20,2,Resign,Black
TRUE,89,10+0,1593,1590,3,C42,5,Out of Time,White
TRUE,60,10+0,1600,1620,-20,A17,4,Out of Time,Black
TRUE,45,10+0,1590,1571,19,D31,7,Resign,White
TRUE,49,10+0,1586,1601,-15,A40,3,Mate,White
TRUE,58,10+0,1612,1557,55,A15,2,Resign,Black
TRUE,58,10+0,1590,1601,-11,D02,4,Mate,Black
TRUE,12,10+0,1612,1600,12,A10,1,Resign,Black
TRUE,46,10+0,1587,1592,-5,D53,9,Resign,Black
TRUE,52,10+0,1602,1650,-48,A10,6,Out of Time,Black
TRUE,89,10+0,1596,1422,174,A34,3,Resign,White
TRUE,35,10+0,1585,1593,-8,A17,4,Mate,White
TRUE,65,10+0,1573,1596,-23,C22,6,Out of Time,White
TRUE,75,10+0,1539,1609,-70,C48,7,Out of Time,White
TRUE,73,10+0,1589,1621,-32,D30,4,Mate,White
TRUE,132,10+0,1632,1618,14,A10,1,Mate,Black
TRUE,48,10+0,1624,1621,3,C42,9,Resign,Black
TRUE,30,10+0,1630,1678,-48,A11,2,Mate,Black
TRUE,104,10+0,1638,1757,-119,A21,6,Mate,Black
TRUE,75,10+0,1661,1648,13,D00,3,Out of Time,White
TRUE,74,10+0,1668,1237,431,A13,2,Mate,Black
TRUE,80,10+0,1517,1661,-144,C42,9,Resign,Black
FALSE,93,10+0,1661,1500,161,A13,2,Mate,White
TRUE,111,10+0,1621,1673,-52,C42,9,Resign,White
TRUE,41,10+0,1670,1642,28,A10,2,Resign,White
TRUE,52,10+0,1532,1663,-131,D30,7,Resign,Black
TRUE,118,10+0,1638,1643,-5,C42,9,Out of Time,Black
TRUE,42,10+0,1684,1631,53,A30,2,Resign,Black
TRUE,40,10+0,1621,1616,5,A25,4,Resign,White
TRUE,24,10+0,1413,1616,-203,C42,7,Mate,Black
TRUE,59,10+0,1607,1558,49,A21,3,Resign,White
TRUE,72,10+0,1594,1596,-2,C28,5,Resign,Black
TRUE,60,10+0,1588,1585,3,D00,3,Resign,Black
TRUE,129,10+0,1576,1538,38,A36,5,Mate,White
TRUE,100,10+0,1508,1567,-59,C00,3,Mate,Black
TRUE,54,10+0,1560,1556,4,C02,8,Mate,Black
TRUE,41,10+0,1547,1493,54,A22,5,Resign,White
TRUE,34,10+0,1537,1495,42,A13,2,Resign,White
TRUE,29,10+0,1594,1547,47,C00,3,Mate,White
TRUE,34,10+0,1394,1531,-137,C42,6,Resign,Black
TRUE,73,10+0,1522,1503,19,A22,6,Out of Time,White
TRUE,71,10+0,1816,1817,-1,C47,8,Mate,White
TRUE,82,10+0,1831,1721,110,A05,4,Mate,Black
TRUE,50,10+0,2043,1814,229,B00,2,Resign,Black
TRUE,35,10+0,1802,1826,-24,A04,2,Mate,White
TRUE,61,10+0,1615,1796,-181,A01,2,Resign,Black
TRUE,28,10+0,1804,1915,-111,A08,4,Resign,Black
TRUE,57,10+0,2005,1809,196,A40,1,Resign,White
TRUE,52,10+0,1817,1924,-107,A04,2,Resign,Black
TRUE,59,10+0,1806,1808,-2,D02,4,Mate,White
TRUE,76,10+0,1826,2013,-187,A00,1,Resign,Black
TRUE,8,10+0,1391,1824,-433,A00,2,Resign,Black
TRUE,94,10+0,1839,1736,103,A04,2,Resign,Black
TRUE,91,10+0,1828,1802,26,A04,2,Mate,White
TRUE,93,10+0,2318,1830,488,A40,1,Out of Time,White
TRUE,74,10+0,1746,1815,-69,A00,4,Mate,Black
TRUE,19,10+0,1810,1564,246,A04,2,Resign,White
TRUE,66,10+0,1797,1799,-2,B02,4,Resign,Black
TRUE,34,10+0,1435,1796,-361,A15,2,Mate,Black
TRUE,45,45+10,1591,1655,-64,C80,13,Mate,White
FALSE,65,30+20,1879,1591,288,A91,8,Resign,Black
TRUE,53,25+0,1562,1650,-88,C40,4,Mate,White
TRUE,46,15+1,1602,1534,68,C01,5,Resign,Black
TRUE,88,40+10,1538,1579,-41,C70,8,Draw,Draw
TRUE,4,10+0,1606,1567,39,B30,4,Out of Time,Black
FALSE,50,10+15,1651,1506,145,A09,4,Resign,Black
TRUE,22,13+15,1709,1396,313,C40,4,Resign,Black
TRUE,47,10+0,1677,1640,37,D02,4,Mate,White
TRUE,60,10+0,1650,1636,14,C02,7,Resign,Black
FALSE,88,4+6,1772,1659,113,B06,7,Out of Time,Black
TRUE,69,4+6,1659,1772,-113,C58,11,Out of Time,White
TRUE,49,4+6,1659,1772,-113,C50,5,Resign,White
TRUE,96,4+6,1866,1772,94,C62,6,Mate,Black
TRUE,95,5+5,1744,1772,-28,D06,4,Out of Time,White
TRUE,52,10+0,1772,1612,160,C22,8,Resign,Black
FALSE,33,5+5,1772,1943,-171,B01,6,Resign,White
TRUE,83,5+5,1943,1772,171,C62,6,Mate,White
TRUE,74,5+5,1775,1760,15,C44,5,Resign,Black
TRUE,2,5+5,1710,1750,-40,C20,2,Out of Time,Black
TRUE,89,5+5,1870,1757,113,C42,5,Mate,White
TRUE,15,5+5,1750,1622,128,C22,7,Mate,White
TRUE,63,5+5,1726,1739,-13,C42,4,Resign,Black
TRUE,66,5+5,1720,1726,-6,D02,4,Resign,White
TRUE,67,5+5,1714,1732,-18,C42,5,Mate,White
TRUE,32,5+5,1744,1701,43,B22,3,Mate,Black
TRUE,108,5+5,1689,1746,-57,C42,5,Draw,Draw
TRUE,75,5+5,1551,1764,-213,C42,4,Mate,White
TRUE,50,5+5,1649,1756,-107,A20,2,Out of Time,Black
TRUE,42,5+5,1659,1751,-92,C42,5,Resign,Black
TRUE,83,5+5,1739,1754,-15,C22,8,Resign,White
TRUE,57,5+5,1742,1751,-9,C46,7,Resign,White
TRUE,69,5+5,1738,1775,-37,C00,3,Resign,White
TRUE,51,5+5,1731,1575,156,C22,7,Mate,White
TRUE,172,5+5,1571,1736,-165,C46,7,Draw,Draw
TRUE,33,5+5,1728,1632,96,C22,7,Resign,White
TRUE,73,5+5,1570,1745,-175,C25,4,Out of Time,White
TRUE,33,5+5,1675,1744,-69,C42,5,Resign,Black
TRUE,95,5+5,1737,1568,169,D30,7,Resign,White
TRUE,45,5+5,1659,1752,-93,A00,1,Mate,White
TRUE,51,5+5,1641,1777,-136,B00,5,Mate,White
TRUE,88,5+5,1793,1695,98,D20,5,Mate,Black
TRUE,129,5+5,1816,1805,11,B01,4,Out of Time,White
TRUE,66,10+0,1874,1486,388,C55,10,Mate,Black
TRUE,61,10+0,1833,1602,231,C55,6,Resign,White
TRUE,41,5+8,1691,1215,476,C41,5,Mate,White
TRUE,104,15+0,1280,1244,36,B02,3,Mate,Black
TRUE,28,5+8,1297,1659,-362,B13,5,Mate,Black
TRUE,52,20+10,1427,1172,255,D02,4,Resign,Black
FALSE,103,5+5,1572,1172,400,B50,4,Mate,White
TRUE,39,20+6,1552,1193,359,C47,8,Resign,White
TRUE,96,4+6,1209,1628,-419,A00,1,Mate,Black
TRUE,59,10+0,1118,1125,-7,C00,3,Mate,White
TRUE,64,10+0,1177,1131,46,B10,2,Resign,White
TRUE,13,10+0,1019,1138,-119,D02,4,Resign,Black
TRUE,48,10+0,1176,1120,56,A00,1,Resign,Black
TRUE,78,10+0,1138,1093,45,B02,2,Resign,Black
TRUE,54,10+0,1156,1120,36,C40,4,Mate,Black
TRUE,53,10+0,1114,820,294,D00,2,Mate,White
TRUE,35,10+0,1164,1130,34,A03,2,Mate,White
TRUE,49,10+0,1110,1148,-38,D00,2,Resign,White
TRUE,43,10+0,1096,1012,84,A00,1,Resign,White
TRUE,65,10+0,1075,1116,-41,A00,1,Mate,White
TRUE,57,10+0,1113,1209,-96,C20,3,Resign,White
TRUE,88,10+0,1130,1203,-73,D00,2,Out of Time,Black
TRUE,60,10+0,1159,1068,91,C41,4,Resign,Black
TRUE,128,10+0,1228,1128,100,C42,5,Mate,Black
TRUE,167,10+0,1012,1164,-152,C41,4,Mate,White
TRUE,80,10+0,1174,1453,-279,C45,7,Resign,Black
TRUE,21,10+0,1270,1226,44,C20,4,Out of Time,White
TRUE,87,10+0,1375,1248,127,A03,2,Mate,White
TRUE,53,10+0,1293,1282,11,C42,4,Mate,White
TRUE,61,10+0,1810,1686,124,A40,2,Resign,White
TRUE,33,10+0,1680,1499,181,C55,6,Resign,White
TRUE,54,10+0,1882,1686,196,A40,2,Resign,White
TRUE,101,10+0,1929,1690,239,C21,9,Mate,White
TRUE,63,10+0,1681,1614,67,C41,4,Resign,White
TRUE,135,10+0,1717,1664,53,C57,9,Mate,White
TRUE,80,5+5,1193,1421,-228,C00,3,Mate,Black
TRUE,65,5+5,1414,1271,143,C40,4,Mate,White
TRUE,38,5+5,1500,1404,96,A40,2,Mate,Black
TRUE,66,5+5,1500,1394,106,C00,3,Mate,Black
TRUE,41,5+5,1391,1041,350,C46,7,Mate,White
TRUE,40,5+5,1044,1388,-344,C00,2,Mate,Black
TRUE,69,8+0,1403,1314,89,B84,12,Resign,Black
TRUE,34,8+0,1358,1392,-34,C00,2,Resign,Black
TRUE,48,10+0,1558,1372,186,C02,9,Out of Time,Black
FALSE,31,10+0,1951,1500,451,D30,4,Resign,White
FALSE,44,10+0,1500,1951,-451,B50,4,Resign,Black
FALSE,23,10+0,1951,1435,516,D20,5,Mate,White
FALSE,52,10+0,1435,1951,-516,D00,4,Mate,Black
FALSE,27,10+0,1951,1500,451,A40,2,Mate,White
FALSE,54,10+0,1951,1875,76,E61,9,Resign,Black
FALSE,51,10+0,1951,1848,103,A80,2,Resign,Black
FALSE,86,10+0,1679,1951,-272,B50,4,Resign,Black
FALSE,29,10+0,1951,1679,272,D20,5,Resign,White
FALSE,78,10+0,1679,1951,-272,B50,4,Resign,Black
FALSE,97,10+0,1951,1513,438,D10,5,Resign,White
FALSE,54,10+0,1740,1951,-211,D08,7,Resign,Black
FALSE,73,10+0,1951,1475,476,D20,5,Resign,White
TRUE,70,10+0,1029,1753,-724,E00,1,Mate,Black
FALSE,41,5+5,1242,1336,-94,C42,5,Resign,Black
FALSE,81,5+5,1500,1336,164,C46,6,Mate,White
FALSE,68,12+8,1336,1500,-164,D01,4,Resign,Black
FALSE,30,5+8,1336,1500,-164,D02,3,Resign,Black
TRUE,9,40+0,1524,1500,24,B00,5,Resign,White
TRUE,22,15+5,1257,1500,-243,A40,2,Draw,Draw
TRUE,73,20+10,1259,1252,7,C00,3,Mate,White
TRUE,28,8+8,1268,1318,-50,D10,4,Resign,Black
TRUE,31,10+7,1314,1278,36,C21,3,Resign,White
TRUE,109,10+1,1316,1276,40,C20,3,Out of Time,Draw
TRUE,72,8+0,1295,1374,-79,D30,4,Resign,Black
TRUE,13,20+0,1282,1358,-76,D20,5,Resign,White
TRUE,125,10+5,1263,1293,-30,D01,6,Resign,White
TRUE,37,10+2,1282,1309,-27,A40,2,Mate,White
TRUE,78,15+0,1272,1246,26,D30,4,Resign,White
TRUE,78,10+5,1280,1366,-86,D02,4,Mate,Black
TRUE,17,5+5,1305,1290,15,A41,2,Resign,White
TRUE,33,15+10,1383,1299,84,C53,7,Resign,White
TRUE,24,10+2,1350,1286,64,C64,6,Mate,Black
TRUE,52,20+0,1205,1278,-73,D31,5,Resign,Black
TRUE,15,10+1,1268,1215,53,D30,4,Resign,White
TRUE,128,10+2,1273,1480,-207,D10,5,Mate,Black
TRUE,59,20+10,1333,1283,50,C21,3,Mate,White
TRUE,145,20+2,1368,1291,77,A25,4,Resign,White
TRUE,40,10+15,1301,1341,-40,A40,6,Resign,Black
TRUE,25,10+5,1311,1349,-38,D10,5,Resign,Black
TRUE,22,9+10,1317,1490,-173,D10,4,Resign,Black
TRUE,54,20+0,1302,1306,-4,D01,4,Resign,Black
TRUE,53,15+0,1297,1236,61,D06,4,Resign,White
TRUE,105,20+10,1289,1195,94,D30,4,Resign,White
TRUE,48,5+6,1175,1281,-106,C50,9,Resign,Black
TRUE,13,15+1,1310,1291,19,C68,8,Resign,White
TRUE,44,10+0,1301,1368,-67,D20,5,Resign,Black
TRUE,15,15+2,1290,1320,-30,B06,4,Resign,White
TRUE,33,10+10,1323,1301,22,C50,8,Resign,White
TRUE,73,15+1,1288,1329,-41,A43,3,Mate,White
TRUE,52,15+8,1103,1283,-180,C78,12,Mate,Black
TRUE,28,15+7,1291,1396,-105,D06,4,Resign,Black
TRUE,55,16+0,1286,1442,-156,D20,5,Draw,Draw
TRUE,21,20+5,1346,1296,50,C46,7,Resign,White
TRUE,27,30+0,1401,1304,97,C24,4,Resign,White
TRUE,48,15+0,1313,1374,-61,D06,4,Resign,Black
TRUE,87,12+2,1302,1304,-2,B32,6,Mate,White
TRUE,51,8+10,1369,1312,57,C22,6,Resign,White
TRUE,27,15+6,1436,1319,117,D00,2,Resign,White
TRUE,47,10+2,1307,1382,-75,D02,4,Mate,White
TRUE,20,10+2,1240,1297,-57,C68,7,Resign,Black
TRUE,42,8+0,1308,1337,-29,A40,2,Resign,Black
TRUE,59,14+1,1297,1276,21,D30,4,Mate,White
TRUE,36,8+8,1274,1285,-11,C44,5,Resign,Black
TRUE,20,15+0,1276,1179,97,D20,5,Resign,White
TRUE,51,10+5,1421,1284,137,C46,7,Mate,White
TRUE,58,30+0,1288,1587,-299,D10,5,Resign,Black
TRUE,53,15+0,1943,1500,443,B01,2,Resign,White
FALSE,26,5+15,1516,1500,16,D20,5,Resign,Black
FALSE,7,10+5,1500,1500,0,B00,5,Resign,White
FALSE,76,10+5,1500,1500,0,C46,5,Resign,Black
FALSE,47,5+7,1441,1500,-59,C49,8,Resign,White
FALSE,92,15+15,1500,1560,-60,A04,2,Mate,Black
FALSE,55,15+10,1500,1500,0,D00,2,Mate,White
FALSE,60,15+10,1500,1500,0,C41,4,Resign,Black
FALSE,55,12+4,1833,1500,333,A53,4,Mate,White
FALSE,79,15+10,1500,1500,0,C60,5,Out of Time,White
TRUE,39,15+15,1274,1311,-37,B20,2,Resign,White
TRUE,32,15+15,1323,1348,-25,C41,4,Out of Time,Black
TRUE,23,15+15,1305,1483,-178,B07,2,Resign,White
TRUE,66,5+5,1469,1285,184,C46,5,Out of Time,Black
TRUE,96,5+5,1295,1758,-463,B10,2,Mate,Black
TRUE,154,5+5,1498,1274,224,C60,6,Mate,Black
TRUE,94,5+5,1278,1582,-304,C61,6,Resign,Black
TRUE,47,5+5,1298,1119,179,C45,7,Resign,Black
TRUE,85,5+5,1498,1304,194,B23,3,Resign,White
TRUE,63,5+5,1556,1310,246,B25,4,Mate,White
TRUE,77,5+5,1305,1023,282,C41,4,Mate,White
TRUE,119,5+5,1674,1308,366,B31,6,Resign,White
FALSE,87,15+10,1400,1259,141,A04,2,Mate,White
FALSE,57,25+2,1423,1400,23,B00,2,Resign,White
FALSE,60,10+2,1400,1476,-76,A04,2,Out of Time,Black
FALSE,72,15+10,1290,1400,-110,A10,1,Out of Time,Black
FALSE,73,15+10,1530,1400,130,B00,2,Resign,White
FALSE,27,15+10,1619,1400,219,A40,2,Mate,White
FALSE,44,15+10,1400,1619,-219,A06,3,Resign,Black
FALSE,72,15+10,1302,1400,-98,A40,2,Mate,Black
FALSE,113,10+0,1400,1475,-75,A06,3,Mate,White
FALSE,46,15+10,1400,1476,-76,A04,2,Resign,White
FALSE,16,25+0,1741,1400,341,B00,2,Resign,White
FALSE,73,15+10,1400,1028,372,A04,2,Mate,White
FALSE,106,5+8,1766,1400,366,B00,2,Draw,Draw
FALSE,51,15+0,1437,1400,37,A40,2,Resign,White
FALSE,18,15+0,1352,1400,-48,B00,2,Resign,Black
FALSE,95,15+0,1631,1400,231,B00,5,Out of Time,White
FALSE,18,10+0,1559,1400,159,A40,2,Resign,White
FALSE,64,15+0,1400,1635,-235,A04,2,Resign,Black
FALSE,9,40+10,1400,1381,19,A06,3,Resign,White
FALSE,25,15+15,1171,1400,-229,B00,2,Resign,Black
FALSE,59,10+0,1318,1400,-82,B00,2,Resign,White
FALSE,85,20+0,1400,1372,28,A04,2,Mate,White
FALSE,30,20+0,1400,1387,13,A06,3,Resign,Black
FALSE,15,20+0,1371,1400,-29,B00,2,Mate,White
FALSE,66,20+0,1400,1349,51,A06,3,Resign,Black
FALSE,38,20+0,1675,1400,275,B00,2,Mate,Black
FALSE,18,10+0,1515,1400,115,B00,2,Resign,Black
FALSE,81,15+10,1400,1332,68,A04,2,Mate,White
FALSE,58,5+8,1366,1400,-34,B00,2,Mate,Black
FALSE,31,5+5,1589,1400,189,B00,2,Resign,Black
FALSE,49,10+5,1400,1466,-66,A06,3,Resign,White
FALSE,44,8+0,1400,1437,-37,A04,2,Resign,Black
FALSE,65,15+10,1566,1400,166,A00,1,Resign,White
FALSE,40,15+10,1356,1400,-44,B00,2,Mate,Black
FALSE,28,15+10,1400,1395,5,A04,2,Resign,Black
FALSE,56,15+10,1500,1400,100,B00,2,Mate,Black
FALSE,19,15+10,1400,1396,4,A04,2,Resign,White
FALSE,105,15+10,1400,1412,-12,A04,2,Mate,White
FALSE,40,15+10,1442,1400,42,A00,1,Mate,Black
TRUE,66,15+0,1752,1960,-208,C00,3,Mate,Black
TRUE,31,15+0,1877,1940,-63,C01,9,Resign,Black
TRUE,33,15+0,1932,1644,288,A34,3,Resign,White
TRUE,8,15+0,1632,1924,-292,C00,4,Resign,Black
TRUE,9,15+0,1916,1620,296,A10,2,Resign,White
TRUE,79,10+0,1919,1945,-26,C02,8,Out of Time,White
TRUE,49,15+15,1924,1832,92,A20,2,Resign,White
TRUE,54,15+15,1918,1891,27,A84,5,Resign,Black
TRUE,79,15+15,1865,1781,84,A30,2,Mate,White
TRUE,16,15+15,1847,1657,190,A11,2,Resign,White
TRUE,30,30+0,1572,1832,-260,B07,5,Resign,Black
TRUE,41,15+15,1697,1890,-193,C41,8,Resign,White
TRUE,65,45+45,1848,1823,25,A20,2,Mate,White
TRUE,49,45+45,1798,1796,2,A41,4,Resign,Black
TRUE,59,15+10,1709,1871,-162,A18,5,Resign,White
TRUE,37,30+0,1659,1555,104,A10,1,Resign,White
TRUE,22,60+0,1815,1378,437,A10,2,Resign,Black
TRUE,78,30+10,1676,1741,-65,C41,8,Out of Time,Black
TRUE,67,40+10,1500,1430,70,A10,2,Resign,White
TRUE,50,15+15,1470,1453,17,C30,4,Resign,Black
TRUE,42,15+15,1445,1464,-19,C65,6,Resign,White
TRUE,100,15+15,1500,1456,44,C42,5,Resign,Black
TRUE,63,15+15,1446,1424,22,B20,3,Mate,White
TRUE,64,15+15,1461,1434,27,D15,7,Resign,Black
FALSE,66,15+0,1434,1513,-79,D31,5,Out of Time,Black
TRUE,7,15+1,1499,1442,57,A00,1,Resign,White
FALSE,107,6+8,1442,1566,-124,D20,5,Mate,White
FALSE,37,10+5,1500,1442,58,A28,7,Resign,White
TRUE,259,15+5,1441,1461,-20,D10,5,Draw,Draw
TRUE,101,30+10,1543,1448,95,A20,2,Mate,White
TRUE,21,30+0,1448,1458,-10,A40,2,Draw,Draw
TRUE,120,15+0,1446,1494,-48,D25,7,Out of Time,Black
TRUE,69,30+0,1497,1456,41,D06,4,Resign,White
TRUE,82,30+0,1466,1527,-61,D06,4,Resign,Black
TRUE,19,20+30,1444,1500,-56,C40,4,Mate,White
TRUE,75,30+0,1661,1450,211,C57,11,Resign,White
TRUE,134,15+4,1441,1438,3,A01,5,Out of Time,Black
FALSE,20,7+7,1351,1471,-120,C44,6,Resign,Black
TRUE,94,10+0,1491,1346,145,B15,5,Resign,Black
TRUE,70,10+0,1318,1483,-165,C42,5,Mate,Black
TRUE,58,10+0,1496,1511,-15,B30,4,Mate,Black
TRUE,44,10+0,1485,1482,3,D05,7,Resign,Black
TRUE,117,10+0,1467,1456,11,B40,6,Mate,White
TRUE,31,10+0,1446,1452,-6,C44,5,Resign,Black
TRUE,65,10+0,1421,1429,-8,C62,6,Resign,White
TRUE,37,10+0,1329,1443,-114,C60,6,Mate,White
TRUE,39,10+5,1423,1484,-61,C40,3,Mate,White
TRUE,35,15+15,1407,1377,30,B00,3,Resign,White
TRUE,82,10+6,1231,1397,-166,D20,5,Mate,Black
TRUE,11,15+0,952,1394,-442,A00,2,Resign,Black
TRUE,31,15+0,1390,967,423,B00,3,Mate,White
TRUE,46,10+0,1046,1030,16,B10,3,Out of Time,Black
TRUE,13,10+0,1045,1119,-74,A04,2,Resign,White
TRUE,14,10+0,1179,1329,-150,A00,1,Resign,Black
TRUE,69,10+0,1409,1228,181,B00,2,Mate,White
TRUE,48,10+0,1388,1326,62,B10,2,Resign,White
TRUE,28,10+0,1500,1503,-3,A00,1,Mate,Black
TRUE,4,10+0,1650,1812,-162,C44,4,Resign,Black
TRUE,43,10+0,1436,1668,-232,C00,4,Resign,White
TRUE,78,10+0,1678,1715,-37,D10,4,Mate,Black
TRUE,75,10+0,1724,1688,36,B08,8,Out of Time,White
TRUE,39,10+0,1678,1630,48,D20,5,Resign,White
TRUE,41,10+0,1728,1688,40,B32,8,Resign,White
TRUE,98,10+0,1701,1638,63,C50,8,Out of Time,Black
TRUE,62,10+0,1715,1652,63,B50,5,Resign,Black
TRUE,61,10+0,1777,1725,52,E90,9,Out of Time,White
TRUE,100,10+0,1745,1747,-2,B40,4,Mate,Black
TRUE,37,10+0,1831,1745,86,B21,12,Out of Time,White
TRUE,125,10+0,1732,1747,-15,B01,4,Mate,White
TRUE,30,10+0,1759,1719,40,A41,2,Mate,Black
TRUE,43,10+0,1739,1719,20,B07,2,Draw,Draw
TRUE,80,10+0,1747,1588,159,D06,4,Out of Time,Black
TRUE,63,10+0,1742,1506,236,C41,5,Resign,White
TRUE,49,10+0,1728,1772,-44,D02,3,Mate,White
TRUE,39,10+0,2257,1730,527,B07,3,Mate,White
TRUE,102,10+0,1434,1726,-292,A00,1,Out of Time,Black
TRUE,38,10+0,1742,1602,140,C55,6,Mate,Black
TRUE,105,10+0,1997,1747,250,B07,2,Out of Time,White
TRUE,35,10+0,1751,1992,-241,C00,3,Resign,Black
TRUE,35,10+0,1987,1757,230,B08,8,Resign,White
TRUE,82,10+0,1762,1971,-209,C42,5,Out of Time,Black
TRUE,83,10+0,1964,1768,196,B08,8,Out of Time,White
TRUE,89,10+0,1939,1795,144,A00,1,Mate,White
TRUE,22,10+0,1811,1696,115,C40,4,Resign,Black
TRUE,39,10+0,1894,1820,74,B07,2,Resign,White
TRUE,34,10+0,1835,1733,102,C89,28,Resign,Black
TRUE,45,10+0,1832,1503,329,D06,4,Resign,White
TRUE,88,10+0,2242,1811,431,B06,6,Resign,Black
TRUE,39,10+0,2101,1824,277,D30,4,Resign,White
TRUE,62,10+0,1828,2097,-269,B28,5,Resign,Black
TRUE,102,10+0,1846,1622,224,B00,2,Resign,Black
TRUE,41,10+0,2048,1852,196,B07,3,Resign,White
TRUE,36,10+0,1860,1969,-109,B30,4,Resign,Black
TRUE,81,10+0,1820,1850,-30,B07,3,Resign,Black
TRUE,71,10+0,1846,1551,295,C67,8,Resign,White
TRUE,32,10+0,1680,1839,-159,B50,4,Resign,Black
TRUE,65,10+0,1829,1777,52,B00,4,Resign,White
TRUE,68,10+0,1604,1824,-220,B08,8,Mate,Black
FALSE,87,10+0,939,963,-24,B02,4,Mate,White
FALSE,66,7+2,1458,939,519,A06,2,Resign,White
TRUE,59,10+0,1449,940,509,C24,4,Resign,White
TRUE,80,10+0,949,1064,-115,A15,4,Resign,Black
TRUE,66,10+0,961,974,-13,A00,1,Mate,Black
TRUE,89,10+0,963,975,-12,C20,3,Resign,White
TRUE,5,10+0,1046,986,60,C27,3,Out of Time,White
TRUE,95,8+0,1801,1784,17,A04,2,Out of Time,White
TRUE,41,5+8,1768,1773,-5,B53,7,Resign,White
TRUE,108,5+5,1857,1763,94,A43,4,Draw,Draw
TRUE,108,15+10,1775,1890,-115,B11,6,Mate,Black
TRUE,92,9+0,1815,1724,91,B18,8,Mate,Black
TRUE,62,5+5,1815,1872,-57,C05,6,Mate,Black
TRUE,47,5+8,1800,1741,59,C41,5,Resign,White
TRUE,168,7+8,1522,1793,-271,A45,2,Resign,Black
TRUE,27,10+3,1868,1808,60,C01,4,Mate,White
TRUE,21,10+5,1796,1643,153,C07,7,Resign,White
TRUE,58,8+7,1394,1792,-398,B30,5,Mate,Black
TRUE,63,10+0,1412,1410,2,B01,6,Resign,White
TRUE,28,10+0,1417,1565,-148,C00,2,Mate,Black
TRUE,49,10+0,1412,1174,238,C23,3,Mate,White
TRUE,20,10+0,1464,1397,67,A06,3,Resign,Black
TRUE,68,10+0,1387,1385,2,A06,3,Resign,Black
TRUE,107,10+0,1377,1645,-268,B07,3,Draw,Draw
TRUE,140,10+0,1383,1588,-205,B00,3,Out of Time,Black
TRUE,200,10+0,1910,1827,83,A47,4,Out of Time,Black
TRUE,80,10+0,1752,1818,-66,D01,4,Resign,Black
TRUE,47,10+0,1809,1762,47,B01,6,Resign,White
TRUE,51,10+0,1803,1658,145,C41,5,Out of Time,White
TRUE,71,10+0,1818,1813,5,C27,6,Resign,White
TRUE,88,10+0,1806,1802,4,C42,5,Resign,Black
TRUE,158,10+0,1804,1757,47,C50,5,Draw,Draw
TRUE,85,10+0,1796,1700,96,B15,5,Resign,White
TRUE,162,10+0,1807,1786,21,B20,3,Resign,Black
TRUE,60,10+0,1726,1799,-73,C02,8,Resign,Black
TRUE,141,10+0,1795,1523,272,C50,6,Mate,White
TRUE,43,10+0,1777,2054,-277,C00,3,Resign,White
TRUE,104,10+0,1831,1776,55,A51,4,Draw,Draw
TRUE,55,5+10,1786,1795,-9,C51,8,Resign,Black
TRUE,79,5+5,1775,1791,-16,B40,4,Out of Time,White
TRUE,51,10+0,1789,1786,3,A35,6,Resign,White
TRUE,109,10+0,1775,1761,14,B30,4,Out of Time,White
TRUE,41,5+5,1773,1786,-13,C42,5,Resign,White
TRUE,81,5+5,1743,1799,-56,A00,7,Resign,White
TRUE,131,10+0,1807,1809,-2,C21,5,Out of Time,White
TRUE,60,10+0,1823,1729,94,B18,8,Resign,Black
TRUE,44,10+0,1764,1814,-50,A45,2,Resign,Black
TRUE,83,10+0,1801,1881,-80,B50,4,Resign,White
TRUE,52,10+0,1814,1723,91,B30,4,Resign,Black
TRUE,80,10+0,1733,1806,-73,A45,2,Resign,Black
TRUE,73,10+0,1743,1819,-76,A52,7,Mate,White
TRUE,190,10+0,1818,1849,-31,B00,3,Out of Time,Draw
TRUE,92,10+0,1600,1652,-52,D53,8,Out of Time,Black
TRUE,63,10+0,1640,1672,-32,B07,2,Resign,White
TRUE,54,5+5,1648,1765,-117,D35,6,Mate,Black
TRUE,30,5+5,1757,1656,101,B90,11,Resign,White
TRUE,48,5+5,1792,1640,152,C41,8,Resign,Black
TRUE,54,5+5,1647,1785,-138,B90,11,Mate,Black
TRUE,42,5+5,1801,1631,170,C45,8,Resign,Black
TRUE,50,5+5,1638,1795,-157,B50,5,Out of Time,Black
TRUE,29,5+5,1788,1645,143,C41,8,Resign,White
TRUE,48,5+5,1652,1781,-129,B94,11,Resign,Black
TRUE,78,5+5,1796,1636,160,B80,13,Mate,Black
TRUE,90,15+5,1723,1622,101,C41,4,Resign,Black
FALSE,47,15+0,1588,1622,-34,C41,4,Resign,Black
TRUE,53,25+3,1664,1652,12,A06,2,Resign,White
TRUE,47,25+3,1707,1674,33,C46,7,Resign,White
TRUE,71,25+3,1670,1685,-15,B02,4,Resign,White
TRUE,97,25+3,1674,1680,-6,A27,5,Mate,White
TRUE,47,25+3,1670,1685,-15,C44,4,Mate,White
TRUE,58,25+6,1692,1792,-100,A22,4,Resign,Black
FALSE,122,10+0,1747,1692,55,B06,2,Draw,Draw
FALSE,111,10+0,1692,1747,-55,A01,5,Mate,White
FALSE,91,10+0,1747,1692,55,C62,6,Resign,White
FALSE,53,10+0,1692,1747,-55,A28,7,Resign,White
FALSE,130,10+0,1747,1692,55,B02,4,Resign,Black
FALSE,43,10+0,1692,1747,-55,D02,3,Resign,White
FALSE,121,15+3,1692,1747,-55,C50,5,Resign,White
FALSE,110,15+3,1747,1692,55,B50,5,Resign,Black
FALSE,96,10+10,1747,1692,55,C48,8,Out of Time,Black
FALSE,43,10+10,1692,1747,-55,A01,3,Resign,White
FALSE,81,10+10,1747,1692,55,C60,6,Draw,Draw
FALSE,129,10+10,1692,1747,-55,D02,4,Resign,White
FALSE,164,30+30,1654,1692,-38,B20,3,Draw,Draw
FALSE,79,15+3,1600,1692,-92,B00,3,Resign,White
FALSE,54,15+10,1692,1637,55,E10,5,Resign,Black
FALSE,128,25+3,1692,1637,55,A13,3,Resign,Black
TRUE,80,25+6,1606,1684,-78,C62,6,Resign,Black
TRUE,62,25+6,1694,1704,-10,D11,7,Resign,Black
TRUE,44,25+6,1688,1705,-17,B06,4,Resign,White
TRUE,73,30+10,1696,1657,39,A04,2,Mate,White
TRUE,9,25+6,1628,1688,-60,B50,4,Resign,Black
TRUE,53,25+6,1679,1626,53,A01,2,Resign,White
TRUE,83,25+6,1669,1663,6,A04,2,Resign,White
FALSE,97,25+10,1669,1573,96,A13,3,Resign,White
TRUE,82,25+5,1652,1659,-7,B06,2,Resign,Black
TRUE,36,25+5,1636,1649,-13,B12,7,Mate,Black
TRUE,26,25+5,1660,1622,38,A07,3,Resign,Black
TRUE,53,25+5,1682,1670,12,B21,3,Resign,White
FALSE,114,10+3,1548,1670,-122,D06,4,Mate,Black
FALSE,77,10+3,1670,1548,122,A06,2,Mate,White
FALSE,57,15+3,1651,1670,-19,A00,1,Resign,White
FALSE,93,25+6,1651,1670,-19,B20,3,Mate,White
FALSE,65,25+4,1670,1659,11,C41,7,Resign,White
TRUE,99,10+0,2095,1679,416,B77,16,Mate,White
TRUE,69,10+0,1872,1685,187,C50,6,Resign,White
TRUE,34,10+0,1421,1680,-259,C20,3,Mate,Black
TRUE,37,10+0,1670,1625,45,C28,5,Resign,White
TRUE,72,10+0,1686,1676,10,B00,2,Resign,Black
TRUE,61,10+0,1804,1698,106,A25,4,Resign,White
TRUE,87,10+0,1691,1567,124,C25,5,Resign,White
TRUE,49,10+0,1679,1690,-11,B52,6,Mate,White
TRUE,11,10+0,1666,1702,-36,C28,5,Resign,White
TRUE,66,10+0,1691,1643,48,C00,3,Mate,Black
TRUE,27,10+0,1933,1696,237,C37,11,Mate,White
TRUE,25,10+0,1675,2055,-380,B40,5,Resign,White
TRUE,102,10+0,1716,1661,55,C21,5,Mate,Black
TRUE,60,10+0,1568,1653,-85,D00,2,Mate,Black
TRUE,45,10+0,1648,1630,18,B30,5,Resign,White
TRUE,99,10+0,1647,1664,-17,C31,6,Resign,White
TRUE,41,10+0,1664,1632,32,C00,3,Mate,White
TRUE,55,10+0,1661,1322,339,C27,3,Mate,White
TRUE,51,10+0,1765,1669,96,D15,7,Resign,White
TRUE,72,10+0,1672,2052,-380,B30,5,Mate,Black
TRUE,97,10+0,1785,1680,105,C50,6,Out of Time,White
TRUE,48,10+0,1873,1913,-40,C40,4,Resign,Black
TRUE,61,10+0,1871,1456,415,A42,7,Mate,White
TRUE,13,10+0,1871,1098,773,C55,7,Resign,White
TRUE,80,10+0,1836,1884,-48,C71,8,Resign,White
TRUE,101,10+0,1822,1886,-64,D02,4,Out of Time,White
TRUE,68,10+0,1901,1806,95,C44,6,Resign,Black
TRUE,87,10+0,1893,1768,125,C00,3,Resign,White
TRUE,104,10+0,1738,1886,-148,A30,2,Mate,Black
TRUE,81,10+0,1872,1940,-68,B00,6,Resign,White
TRUE,21,10+0,1862,1809,53,C44,5,Resign,White
TRUE,65,10+0,1753,1871,-118,C50,5,Resign,White
TRUE,46,10+0,1826,1860,-34,C30,3,Resign,Black
TRUE,80,10+0,1882,1504,378,C44,5,Resign,Black
TRUE,96,10+0,1729,1874,-145,C45,13,Mate,Black
TRUE,118,10+0,1232,1874,-642,C45,8,Mate,Black
TRUE,74,8+0,2016,1889,127,C70,8,Resign,White
FALSE,76,10+40,2235,2447,-212,A50,4,Resign,Black
TRUE,56,10+0,1282,1472,-190,D10,5,Out of Time,Black
TRUE,82,15+0,1330,1464,-134,B25,4,Resign,Black
TRUE,38,25+0,1461,1559,-98,C41,5,Resign,Black
TRUE,55,15+5,1440,1777,-337,C50,8,Resign,White
TRUE,58,9+8,1558,1423,135,B20,3,Resign,Black
TRUE,73,15+0,1391,1437,-46,C22,6,Resign,White
TRUE,36,15+3,1403,1451,-48,A40,2,Resign,White
TRUE,90,8+6,1631,1432,199,C02,11,Out of Time,Black
TRUE,86,14+1,1153,1428,-275,C00,3,Resign,Black
TRUE,49,14+1,1423,1158,265,B01,4,Resign,White
TRUE,64,10+10,1262,1416,-154,C00,3,Mate,Black
TRUE,29,10+0,1352,1431,-79,A00,1,Resign,White
TRUE,64,5+7,1433,1869,-436,B00,2,Resign,Black
TRUE,62,10+8,1458,1044,414,C42,4,Resign,Black
TRUE,59,6+10,1581,1466,115,C02,7,Mate,White
TRUE,41,5+8,1461,1246,215,C45,7,Mate,White
TRUE,45,5+10,1454,1289,165,B33,8,Resign,White
TRUE,29,5+8,1339,1470,-131,C02,7,Resign,White
TRUE,99,6+3,1451,1865,-414,C41,5,Resign,White
TRUE,47,5+8,1844,1453,391,B32,8,Resign,White
TRUE,86,12+0,1450,1136,314,B00,2,Resign,White
FALSE,54,5+5,1500,1500,0,A00,1,Mate,Black
FALSE,22,10+0,1463,1500,-37,B00,2,Resign,Black
FALSE,107,20+10,2500,2205,295,B40,4,Resign,White
TRUE,23,10+0,2131,1869,262,D06,4,Resign,White
TRUE,58,10+0,1852,1805,47,C00,4,Resign,White
TRUE,64,10+0,1873,1858,15,B70,10,Mate,Black
TRUE,71,10+0,1865,1623,242,B13,7,Out of Time,White
TRUE,128,10+0,1732,1850,-118,C68,7,Resign,Black
TRUE,72,10+0,1864,2011,-147,C45,8,Mate,Black
TRUE,76,10+0,2040,1827,213,C54,17,Mate,Black
TRUE,79,10+0,1800,1508,292,C44,5,Mate,White
TRUE,19,10+0,1918,1820,98,A28,7,Resign,White
TRUE,35,10+0,1842,1915,-73,B13,7,Resign,Black
TRUE,47,10+0,1502,1834,-332,C50,6,Resign,Black
TRUE,99,10+0,1810,1728,82,C41,7,Mate,White
TRUE,58,10+0,1789,1776,13,C50,8,Resign,Black
TRUE,95,10+0,1723,1708,15,B00,2,Out of Time,White
TRUE,41,10+0,1662,1808,-146,C44,8,Mate,White
TRUE,44,10+0,1801,1697,104,C77,9,Resign,White
TRUE,50,10+0,1750,1761,-11,C40,4,Mate,Black
TRUE,47,10+0,1678,1717,-39,C01,5,Mate,White
TRUE,99,10+0,1596,1643,-47,C44,6,Resign,White
FALSE,79,8+0,2613,1904,709,D53,8,Resign,White
TRUE,75,10+0,1893,1897,-4,A42,8,Resign,White
TRUE,57,10+0,2003,1901,102,C07,7,Resign,White
TRUE,101,10+0,1815,1904,-89,C01,5,Draw,Draw
TRUE,226,10+0,1817,1907,-90,C00,3,Draw,Draw
TRUE,105,10+0,1899,1776,123,E61,4,Resign,White
TRUE,78,10+0,1610,1895,-285,A40,2,Mate,Black
TRUE,129,10+0,1888,1736,152,E61,6,Resign,White
TRUE,59,10+0,2224,1802,422,B22,3,Mate,White
TRUE,70,10+0,1783,2222,-439,B21,3,Resign,Black
TRUE,93,10+0,2217,1970,247,B00,3,Resign,White
TRUE,74,10+0,1873,2214,-341,B22,3,Resign,Black
TRUE,62,10+0,2211,1878,333,C41,6,Resign,White
TRUE,28,10+0,1935,2206,-271,B57,8,Mate,Black
TRUE,57,10+0,2200,2029,171,B22,6,Resign,White
TRUE,27,10+0,2199,1622,577,C55,6,Resign,White
TRUE,64,10+0,1971,2194,-223,B21,3,Resign,Black
TRUE,138,10+0,2274,2191,83,B20,3,Draw,Draw
TRUE,90,10+0,1801,2189,-388,B21,3,Mate,Black
TRUE,37,10+0,2188,1536,652,C00,4,Mate,White
TRUE,106,15+5,2196,2314,-118,C40,9,Resign,Black
TRUE,114,15+5,2346,2179,167,B71,12,Resign,Black
TRUE,29,15+5,2170,2112,58,B22,3,Resign,White
TRUE,47,15+5,2161,2084,77,C55,9,Mate,White
TRUE,53,30+0,2154,2010,144,B22,3,Resign,White
TRUE,57,30+0,2140,2218,-78,E54,12,Resign,White
TRUE,48,15+0,2043,2132,-89,A45,2,Resign,Black
TRUE,43,15+0,2122,2052,70,B01,6,Resign,White
TRUE,115,15+0,2007,2138,-131,A02,2,Mate,White
TRUE,57,15+0,2128,2064,64,B01,4,Resign,White
TRUE,156,10+0,1610,1578,32,B20,3,Mate,Black
TRUE,35,10+0,1743,1594,149,A45,2,Mate,White
TRUE,96,10+0,1584,1591,-7,D06,4,Resign,White
TRUE,54,10+0,1595,1563,32,A50,4,Mate,Black
TRUE,44,10+0,1573,1597,-24,B20,3,Mate,Black
TRUE,150,10+0,1609,1552,57,A40,2,Resign,Black
TRUE,106,10+0,1619,1632,-13,E20,8,Resign,Black
TRUE,40,10+0,1591,1609,-18,B50,5,Resign,Black
TRUE,53,10+0,1611,1557,54,D20,5,Resign,White
TRUE,75,10+0,1667,1620,47,A45,3,Resign,White
TRUE,57,10+0,1599,1631,-32,A46,5,Mate,White
TRUE,113,10+0,1631,1627,4,A40,2,Draw,Draw
TRUE,29,10+0,1620,1639,-19,E00,5,Resign,White
TRUE,113,10+0,1645,1630,15,B90,11,Mate,White
TRUE,205,10+0,1617,1704,-87,D06,3,Out of Time,White
TRUE,62,10+0,1601,1607,-6,B57,8,Mate,Black
TRUE,49,10+0,1569,1619,-50,B57,8,Mate,White
TRUE,17,10+0,1621,1593,28,D10,4,Out of Time,White
TRUE,37,10+0,1609,1688,-79,A40,2,Mate,White
TRUE,127,10+0,1598,1619,-21,B21,3,Resign,White
TRUE,153,10+0,1628,1666,-38,D31,6,Out of Time,Draw
TRUE,30,10+0,1574,1619,-45,B20,3,Resign,Black
TRUE,61,10+0,1609,1590,19,D45,9,Resign,White
TRUE,88,10+0,1641,1598,43,B90,11,Mate,Black
TRUE,71,10+0,1661,1606,55,B90,10,Mate,White
TRUE,48,10+0,1617,1616,1,D20,5,Mate,Black
TRUE,58,10+0,1620,1606,14,B50,4,Resign,Black
TRUE,79,10+0,1597,1565,32,A40,4,Resign,White
TRUE,73,10+0,1599,1607,-8,A46,5,Resign,White
TRUE,40,10+0,1601,1597,4,B20,2,Resign,Black
TRUE,48,10+0,1607,1600,7,D20,5,Mate,Black
TRUE,54,10+0,1615,1704,-89,D20,5,Mate,Black
TRUE,73,10+0,1601,1626,-25,A00,2,Mate,White
TRUE,48,10+0,1635,1666,-31,D07,4,Mate,Black
TRUE,43,10+0,1662,1645,17,A45,2,Mate,White
TRUE,48,10+0,1598,1636,-38,A45,2,Mate,Black
TRUE,45,10+0,1628,1556,72,D20,5,Resign,White
TRUE,54,10+0,1638,1639,-1,A40,2,Mate,Black
FALSE,34,30+0,1450,1999,-549,B45,9,Mate,Black
FALSE,53,30+0,1999,1450,549,C53,9,Mate,White
TRUE,77,10+30,1996,1959,37,C21,5,Out of Time,White
TRUE,32,6+10,1948,1942,6,E20,6,Resign,White
TRUE,113,10+0,1930,2204,-274,A40,10,Resign,White
TRUE,39,7+3,1918,1966,-48,A49,4,Resign,White
TRUE,17,2+10,2069,1925,144,D02,4,Resign,White
TRUE,75,10+0,1860,1938,-78,B30,4,Mate,White
TRUE,28,10+0,1905,1924,-19,A12,5,Resign,Black
TRUE,93,5+15,1930,2107,-177,D00,3,Resign,Black
TRUE,42,5+15,1936,2101,-165,D10,5,Resign,Black
TRUE,126,15+0,1313,1543,-230,A30,2,Out of Time,Black
TRUE,8,15+0,1563,1290,273,A20,2,Resign,Black
TRUE,67,15+0,1266,1585,-319,A13,2,Resign,White
TRUE,49,20+0,1542,1242,300,E61,4,Resign,Black
TRUE,88,20+0,1232,1551,-319,A21,3,Draw,Draw
TRUE,28,5+8,1244,1282,-38,A21,3,Resign,Black
TRUE,35,20+0,1525,1249,276,A30,2,Mate,White
TRUE,86,20+0,1225,1546,-321,A34,3,Resign,White
TRUE,65,15+0,1198,1613,-415,A10,1,Mate,White
TRUE,66,15+0,1189,1621,-432,A21,4,Resign,Black
TRUE,63,12+0,1619,1191,428,A40,2,Mate,White
TRUE,35,15+0,1176,1201,-25,A13,2,Resign,White
FALSE,22,15+0,1649,1176,473,C20,3,Mate,Black
FALSE,14,15+0,1176,1649,-473,A22,5,Resign,White
FALSE,67,15+0,1621,1176,445,C20,3,Resign,White
FALSE,106,15+0,1176,1621,-445,A34,3,Out of Time,Black
FALSE,96,15+0,1176,1615,-439,D20,5,Mate,Black
FALSE,115,15+0,1615,1176,439,D00,4,Mate,White
FALSE,113,15+0,1176,1615,-439,D20,6,Mate,White
FALSE,69,10+5,1653,1176,477,D00,4,Mate,White
FALSE,58,10+5,1176,1653,-477,A41,3,Mate,Black
FALSE,54,10+5,1653,1176,477,C20,3,Resign,Black
FALSE,21,10+5,1176,1653,-477,D20,5,Draw,Draw
FALSE,67,10+0,1500,1176,324,C02,5,Mate,White
TRUE,79,8+0,1308,1185,123,A20,2,Mate,White
TRUE,45,8+0,1164,1326,-162,D10,5,Mate,White
TRUE,73,8+0,1318,1173,145,A20,2,Resign,White
TRUE,114,12+0,1180,1361,-181,A40,2,Mate,Black
TRUE,18,12+0,1355,1188,167,A00,1,Resign,White
TRUE,48,15+10,1191,1623,-432,D07,6,Mate,Black
TRUE,116,9+0,1203,1267,-64,D06,4,Out of Time,Black
TRUE,42,9+0,1283,1182,101,A57,6,Mate,Black
TRUE,71,10+10,1156,1449,-293,A52,7,Mate,White
TRUE,45,10+10,1444,1161,283,A22,4,Mate,White
TRUE,114,5+8,1530,1552,-22,C00,3,Mate,Black
TRUE,26,45+10,1504,1543,-39,C00,2,Mate,Black
FALSE,35,5+8,1543,1601,-58,C41,5,Mate,White
TRUE,63,17+0,1519,1543,-24,A04,2,Draw,Draw
TRUE,119,5+8,1584,1553,31,C00,2,Out of Time,White
TRUE,84,15+0,1537,1543,-6,C02,7,Mate,Black
TRUE,38,15+10,1509,1544,-35,C00,5,Draw,Draw
TRUE,65,15+2,1532,1570,-38,C41,5,Mate,White
FALSE,40,10+3,1497,1532,-35,C02,6,Resign,Black
TRUE,51,12+8,1436,1546,-110,C00,5,Resign,White
TRUE,61,16+3,1536,1498,38,C00,3,Out of Time,White
TRUE,71,10+0,1453,1550,-97,C02,9,Out of Time,White
FALSE,57,15+15,1550,1429,121,A06,3,Mate,White
TRUE,51,10+10,1462,1541,-79,A00,1,Resign,Black
TRUE,53,12+1,1492,1554,-62,A00,1,Mate,White
TRUE,65,5+15,1522,1566,-44,A40,2,Resign,White
TRUE,94,5+8,1671,1563,108,A02,1,Draw,Draw
TRUE,26,13+5,1464,1555,-91,E03,11,Resign,Black
TRUE,133,10+5,1626,1564,62,C00,3,Mate,White
TRUE,111,10+5,1550,1639,-89,C50,7,Resign,White
FALSE,25,4+10,1550,1527,23,B30,4,Resign,White
TRUE,38,5+8,1693,1535,158,C02,7,Out of Time,Black
FALSE,52,15+10,1600,1535,65,A40,2,Out of Time,Black
FALSE,64,20+0,1500,1535,-35,C02,7,Mate,Black
TRUE,30,5+10,1443,1528,-85,A00,1,Mate,Black
TRUE,85,6+5,1542,1517,25,A02,1,Resign,Black
TRUE,77,15+5,1651,1524,127,A13,2,Mate,White
TRUE,54,5+8,1507,1513,-6,C01,5,Mate,Black
TRUE,166,10+10,1523,1556,-33,C65,6,Mate,Black
FALSE,73,20+0,1554,1523,31,C01,5,Resign,White
TRUE,91,7+12,1636,1506,130,C02,5,Resign,White
TRUE,90,15+0,1528,1495,33,C00,3,Out of Time,Black
TRUE,55,10+0,1545,1490,55,C00,2,Mate,White
TRUE,52,30+0,1508,1562,-54,C61,6,Mate,Black
TRUE,31,30+0,1552,1518,34,C00,3,Mate,White
TRUE,23,30+0,1505,1565,-60,C61,6,Resign,White
TRUE,35,30+0,1580,1492,88,C00,3,Resign,Black
TRUE,15,10+60,1484,1401,83,B01,4,Resign,White
TRUE,28,10+60,1418,1475,-57,C00,3,Resign,Black
TRUE,35,30+0,1466,1406,60,C70,8,Resign,White
TRUE,51,4+6,1432,1478,-46,A40,2,Mate,White
TRUE,60,15+3,1489,1475,14,B01,2,Resign,Black
TRUE,64,15+0,1454,1479,-25,A40,2,Out of Time,Black
TRUE,71,10+0,1516,1489,27,C02,7,Out of Time,White
FALSE,40,10+0,1582,1489,93,C00,3,Mate,Black
TRUE,45,0+13,1799,1578,221,C30,4,Resign,White
TRUE,78,3+8,1716,1464,252,C50,5,Resign,Black
FALSE,10,120+0,1277,1464,-187,C68,7,Draw,Draw
TRUE,60,15+0,1413,1280,133,C61,6,Resign,White
TRUE,48,15+0,1276,1461,-185,C62,6,Draw,Draw
TRUE,41,15+0,1284,1436,-152,C40,4,Mate,White
TRUE,49,15+0,1426,1500,-74,C20,3,Mate,White
TRUE,93,15+0,1405,1040,365,D10,5,Mate,White
TRUE,25,15+0,1516,1413,103,C41,7,Resign,White
TRUE,46,15+0,1434,1401,33,D02,4,Mate,Black
TRUE,37,15+0,1388,1447,-59,C44,5,Mate,White
TRUE,36,15+0,1507,1396,111,A00,1,Resign,White
TRUE,17,15+0,1636,1400,236,B23,3,Resign,White
TRUE,30,15+12,1408,1498,-90,B00,2,Resign,Black
TRUE,50,14+0,1415,1577,-162,C20,3,Resign,Black
TRUE,24,15+15,1331,1413,-82,C20,3,Resign,Black
TRUE,67,10+5,1400,1452,-52,B01,6,Mate,White
TRUE,21,10+4,1440,1421,19,C41,4,Resign,White
TRUE,65,10+4,1405,1557,-152,E67,14,Out of Time,White
TRUE,45,10+0,1309,1419,-110,C41,4,Out of Time,White
TRUE,72,11+11,1587,1403,184,C20,3,Resign,Black
TRUE,123,10+10,1416,1349,67,C25,4,Resign,Black
TRUE,50,15+8,1431,1317,114,B07,2,Resign,Black
TRUE,80,10+3,1436,1669,-233,C41,4,Resign,Black
TRUE,40,10+0,1363,1418,-55,C45,7,Resign,Black
TRUE,34,10+0,1423,1650,-227,B20,2,Resign,Black
TRUE,106,15+0,1418,1445,-27,A40,3,Resign,Black
TRUE,65,15+0,1587,1424,163,A40,4,Out of Time,White
TRUE,43,10+5,1407,1620,-213,B01,4,Resign,White
TRUE,57,10+0,1643,1424,219,D00,3,Out of Time,White
TRUE,115,15+15,1500,1430,70,C41,4,Resign,White
TRUE,11,15+15,1444,1358,86,C40,3,Resign,Black
TRUE,61,15+5,1442,1420,22,C57,8,Resign,Black
TRUE,39,10+0,1435,1453,-18,C20,2,Resign,White
TRUE,45,10+0,1728,1458,270,A04,2,Resign,White
TRUE,33,10+0,1470,1469,1,C53,7,Resign,White
TRUE,22,10+0,1461,1355,106,C55,6,Resign,White
TRUE,57,10+1,1466,1657,-191,C61,6,Resign,Black
TRUE,51,15+6,1441,1479,-38,C41,6,Resign,White
TRUE,55,10+0,1642,1485,157,D20,4,Resign,White
TRUE,56,10+5,1449,1475,-26,C62,6,Resign,Black
TRUE,55,10+5,1462,1504,-42,B20,3,Mate,White
TRUE,43,15+0,1727,1466,261,D52,11,Resign,White
TRUE,65,15+10,1457,1386,71,C44,5,Mate,White
TRUE,25,15+10,1503,1468,35,C50,6,Resign,White
TRUE,61,10+0,1461,1316,145,B01,4,Resign,White
TRUE,100,10+0,1466,1583,-117,B00,2,Out of Time,Draw
TRUE,58,10+0,1461,1455,6,C20,3,Mate,Black
TRUE,71,10+0,1446,1344,102,B27,4,Mate,White
TRUE,39,10+0,1436,1388,48,B00,2,Mate,White
FALSE,51,11+8,1665,1360,305,D20,5,Mate,White
TRUE,35,15+5,2171,2064,107,B94,11,Resign,White
TRUE,43,15+5,2162,2088,74,B45,10,Resign,White
TRUE,54,15+5,2097,2152,-55,A85,5,Resign,Black
TRUE,47,15+10,2053,2167,-114,C50,11,Resign,White
TRUE,51,20+0,1994,2160,-166,A80,2,Resign,Black
TRUE,59,30+10,2166,1997,169,C43,9,Draw,Draw
TRUE,88,10+0,1661,2069,-408,C57,10,Out of Time,Black
TRUE,68,10+0,2211,1637,574,A45,4,Resign,Black
TRUE,64,10+0,1187,1635,-448,A00,3,Mate,Black
TRUE,104,10+0,1924,1774,150,C41,4,Resign,Black
TRUE,68,10+0,1789,1899,-110,C18,11,Resign,Black
TRUE,65,10+0,1880,1679,201,C44,6,Resign,White
FALSE,43,40+40,2050,1880,170,C02,11,Resign,White
TRUE,50,10+0,1923,1911,12,B01,4,Resign,Black
TRUE,63,10+0,1964,2005,-41,B01,6,Resign,Black
FALSE,3,11+5,1970,1832,138,C40,3,Resign,White
FALSE,127,8+0,1990,1970,20,B30,4,Mate,White
FALSE,53,15+0,1886,1970,-84,C69,10,Out of Time,White
FALSE,138,15+0,1970,1886,84,E20,8,Out of Time,Black
TRUE,135,15+0,1886,1970,-84,B73,14,Mate,White
FALSE,29,5+5,1970,1500,470,C41,5,Resign,White
FALSE,34,15+10,1621,1970,-349,A46,5,Mate,Black
FALSE,17,10+0,1970,1710,260,C61,6,Resign,White
TRUE,35,8+9,1807,1970,-163,B21,5,Mate,White
FALSE,46,10+30,1970,1208,762,B00,3,Draw,Draw
FALSE,80,10+0,2106,1970,136,A21,4,Resign,Black
FALSE,141,10+0,1970,1506,464,B28,5,Resign,White
FALSE,96,10+0,1506,1970,-464,C20,3,Mate,Black
FALSE,25,10+0,1970,1500,470,C40,4,Resign,White
TRUE,42,20+0,1452,2085,-633,D00,2,Mate,Black
TRUE,60,10+0,1660,1450,210,D35,9,Resign,Black
TRUE,58,10+0,1486,1654,-168,B52,6,Resign,Black
TRUE,42,10+0,1390,1649,-259,B40,4,Mate,Black
TRUE,45,10+0,2013,1652,361,A40,3,Resign,White
TRUE,71,10+0,1643,1573,70,B12,3,Resign,White
TRUE,110,10+5,1652,1735,-83,B36,8,Resign,Black
TRUE,85,10+5,1726,1661,65,A40,6,Resign,White
TRUE,20,10+5,1672,1717,-45,A52,6,Resign,Black
TRUE,152,10+0,1643,1660,-17,C46,7,Out of Time,Black
TRUE,22,10+0,1415,1655,-240,A57,6,Resign,Black
TRUE,57,15+16,1669,1326,343,C00,3,Mate,White
TRUE,92,15+16,1329,1660,-331,A00,1,Mate,Black
TRUE,130,15+15,1674,1926,-252,C17,8,Mate,Black
FALSE,66,10+0,1674,1500,174,D60,12,Resign,Black
FALSE,76,10+0,1781,1674,107,B01,6,Out of Time,Black
FALSE,95,5+11,1529,1674,-145,C24,4,Resign,White
FALSE,80,10+10,1674,1708,-34,C40,6,Resign,Black
TRUE,21,30+0,1590,1640,-50,B20,3,Resign,Black
FALSE,91,15+10,2027,1640,387,D25,6,Resign,White
FALSE,84,15+10,2027,1640,387,B33,11,Draw,Draw
TRUE,86,9+5,1579,1416,163,C00,2,Mate,Black
TRUE,137,9+5,1577,1634,-57,C26,7,Draw,Draw
TRUE,103,9+5,1568,1509,59,B20,3,Out of Time,White
TRUE,47,9+5,1561,1380,181,B00,3,Mate,White
TRUE,29,9+5,1552,1471,81,C00,2,Out of Time,White
TRUE,63,9+5,1547,1330,217,C23,3,Out of Time,White
TRUE,39,9+5,1564,1386,178,C00,2,Resign,Black
TRUE,115,9+5,1563,1609,-46,B00,3,Draw,Draw
TRUE,99,9+5,1549,1609,-60,C23,3,Resign,White
TRUE,92,9+5,1562,1536,26,C23,3,Out of Time,Black
TRUE,48,10+0,1563,2139,-576,C26,7,Mate,Black
TRUE,90,10+0,1565,1947,-382,B20,3,Mate,Black
TRUE,102,10+0,1587,1553,34,A20,2,Out of Time,Black
TRUE,93,10+0,1712,1559,153,C45,7,Out of Time,White
TRUE,29,10+0,1547,1583,-36,B01,4,Mate,White
TRUE,60,10+0,1552,1763,-211,B20,3,Resign,Black
TRUE,54,10+0,1568,1439,129,C23,3,Mate,Black
TRUE,104,9+5,1534,1557,-23,D01,4,Resign,Black
TRUE,59,9+5,1550,1560,-10,C23,3,Mate,White
TRUE,69,9+5,1544,1350,194,C20,4,Resign,White
TRUE,96,9+5,1558,1519,39,B01,4,Mate,Black
TRUE,50,9+5,1569,1576,-7,C24,4,Mate,Black
TRUE,44,9+5,1577,1714,-137,C00,2,Mate,Black
TRUE,55,9+5,1596,1327,269,C23,3,Resign,Black
TRUE,105,9+5,1594,1238,356,C24,4,Mate,White
TRUE,72,9+5,1609,1485,124,B01,4,Mate,Black
TRUE,25,9+5,1605,1354,251,C26,7,Resign,White
TRUE,105,9+5,1594,1574,20,B00,3,Resign,White
TRUE,65,9+5,1582,1575,7,C24,4,Mate,White
TRUE,33,9+5,1575,1405,170,C24,4,Mate,White
TRUE,39,9+5,1572,1251,321,B00,2,Resign,White
TRUE,60,10+0,1140,1571,-431,C20,3,Mate,Black
TRUE,51,10+0,1993,1573,420,C21,6,Mate,White
TRUE,64,10+0,1576,1915,-339,B20,3,Resign,Black
TRUE,45,10+0,1990,1578,412,A00,1,Mate,White
TRUE,70,10+0,1591,1536,55,C26,6,Mate,Black
TRUE,23,10+0,1575,1725,-150,C23,3,Mate,White
TRUE,44,10+0,1581,1747,-166,C28,7,Resign,Black
TRUE,99,10+0,1569,1615,-46,C20,4,Mate,White
TRUE,56,9+5,1583,1482,101,C28,7,Resign,Black
TRUE,67,9+5,1593,1644,-51,C00,2,Resign,Black
TRUE,39,9+5,1589,1299,290,C23,3,Mate,White
TRUE,31,9+5,1605,1416,189,C00,2,Resign,Black
TRUE,222,9+5,1617,1614,3,B07,2,Mate,Black
TRUE,111,9+5,1611,1418,193,C23,4,Resign,White
TRUE,23,9+5,1606,1392,214,C24,4,Mate,White
TRUE,19,9+5,1601,1402,199,C23,3,Resign,White
TRUE,40,9+5,1451,1594,-143,C40,4,Resign,Black
TRUE,43,15+10,1475,1396,79,C30,4,Resign,Black
TRUE,92,5+10,1496,1229,267,C30,3,Resign,Black
TRUE,76,10+0,1393,1398,-5,C55,6,Mate,Black
TRUE,63,10+0,1418,1405,13,C02,7,Resign,White
TRUE,18,10+0,1422,1267,155,C41,5,Resign,Black
TRUE,73,10+0,1778,1425,353,C00,3,Resign,White
TRUE,20,10+0,1430,1669,-239,C50,6,Resign,Black
TRUE,84,10+0,1441,1474,-33,C55,6,Resign,Black
TRUE,27,10+0,1403,1455,-52,C01,9,Resign,White
TRUE,24,10+0,1523,1440,83,D06,4,Resign,Black
TRUE,68,10+0,1441,1620,-179,B01,4,Resign,Black
TRUE,51,10+0,1388,1456,-68,A45,3,Resign,White
TRUE,11,10+0,1447,1335,112,C57,7,Resign,White
FALSE,121,7+2,1968,1447,521,A45,2,Mate,White
FALSE,42,7+2,1447,1500,-53,C58,11,Mate,Black
TRUE,43,10+0,1492,1458,34,C10,6,Resign,White
TRUE,41,10+0,1446,1420,26,C50,6,Resign,White
TRUE,22,10+0,1216,1440,-224,C00,3,Resign,Black
TRUE,83,10+0,1432,1306,126,C42,5,Out of Time,White
TRUE,63,10+0,1419,1446,-27,A00,1,Mate,White
TRUE,76,10+0,1460,1457,3,B06,2,Mate,Black
TRUE,18,10+0,1277,1452,-175,C00,3,Resign,Black
TRUE,149,10+0,1421,1468,-47,C01,5,Out of Time,White
TRUE,157,10+0,1440,1272,168,C50,5,Mate,White
TRUE,41,10+0,1518,1452,66,C01,5,Mate,White
TRUE,44,10+0,1479,1056,423,C41,4,Mate,Black
TRUE,111,10+0,1383,1498,-115,C20,4,Mate,White
TRUE,51,10+0,1492,1248,244,C55,6,Resign,White
TRUE,56,10+0,1523,1491,32,C10,5,Draw,Draw
TRUE,65,10+0,1801,1496,305,C00,3,Resign,White
TRUE,126,10+0,1496,1496,0,C57,8,Draw,Draw
TRUE,40,10+0,1505,1650,-145,B40,4,Mate,Black
TRUE,158,10+0,1425,1492,-67,A15,2,Out of Time,Black
TRUE,120,10+0,1491,1520,-29,B30,4,Draw,Draw
TRUE,32,10+0,1509,1480,29,C57,11,Mate,Black
FALSE,19,10+0,1268,1158,110,C23,3,Mate,White
FALSE,33,15+0,1141,1268,-127,C40,4,Resign,White
FALSE,15,15+0,1268,1141,127,C20,3,Draw,Draw
TRUE,85,15+0,1189,1244,-55,A40,2,Mate,White
FALSE,17,10+0,1189,1443,-254,C20,3,Mate,White
TRUE,86,15+0,1271,1261,10,C24,4,Mate,Black
TRUE,7,20+0,1519,1324,195,A00,1,Resign,White
TRUE,73,10+0,1611,1423,188,C68,7,Mate,White
TRUE,65,10+0,1784,1538,246,C57,8,Mate,White
TRUE,130,10+0,1583,1567,16,D21,6,Out of Time,Black
FALSE,28,20+30,1583,2203,-620,D02,4,Mate,Black
TRUE,44,10+0,1729,1615,114,C21,9,Resign,Black
TRUE,54,10+0,1420,1402,18,C20,3,Out of Time,Black
TRUE,48,10+0,1500,1701,-201,D11,5,Mate,Black
TRUE,55,30+0,1700,1324,376,C41,5,Resign,White
TRUE,36,5+30,1331,1472,-141,D20,5,Resign,Black
TRUE,11,8+6,1463,1315,148,C41,6,Resign,Black
TRUE,59,9+0,1443,1323,120,A21,3,Resign,White
TRUE,16,10+1,1333,1382,-49,D30,4,Resign,Black
TRUE,63,15+0,1628,1337,291,C41,5,Mate,White
TRUE,44,5+5,1342,1556,-214,D20,5,Resign,Black
TRUE,60,5+5,1370,1353,17,C41,6,Resign,White
TRUE,33,30+0,1552,1359,193,D00,2,Resign,White
TRUE,66,10+10,1364,1632,-268,D06,3,Mate,Black
TRUE,30,8+0,1518,1371,147,C41,6,Resign,White
TRUE,18,10+3,1383,1383,0,B00,6,Resign,White
TRUE,36,7+9,1688,1386,302,C41,6,Resign,White
TRUE,82,10+3,1392,1612,-220,A51,4,Resign,Black
TRUE,102,10+0,1225,1385,-160,A40,3,Out of Time,Black
TRUE,51,8+0,1389,1675,-286,D20,5,Resign,Black
TRUE,30,10+3,1594,1395,199,C40,5,Resign,White
TRUE,82,10+0,1558,1360,198,C40,5,Out of Time,Black
TRUE,44,5+8,1369,1460,-91,A40,2,Resign,Black
TRUE,54,15+8,1374,1579,-205,E00,4,Resign,Black
TRUE,53,8+0,1430,1385,45,D06,4,Resign,White
TRUE,80,25+2,1489,1369,120,B00,6,Resign,Black
TRUE,14,5+5,1363,1514,-151,A40,2,Resign,Black
TRUE,11,60+0,1363,1559,-196,E20,6,Resign,White
TRUE,20,30+0,1469,1372,97,D20,5,Resign,White
TRUE,44,5+8,1646,1376,270,C41,5,Resign,White
TRUE,73,10+0,1365,1347,18,D30,4,Mate,White
TRUE,55,10+0,1368,1754,-386,D12,8,Resign,Black
TRUE,51,10+0,1962,1368,594,C30,3,Mate,White
TRUE,122,5+5,1375,1539,-164,E00,4,Resign,Black
TRUE,54,8+9,1604,1380,224,C41,5,Resign,White
TRUE,7,180+0,1554,1387,167,C20,3,Resign,White
TRUE,61,15+15,1394,1528,-134,D30,4,Resign,Black
TRUE,50,10+1,1679,1398,281,A00,1,Resign,White
TRUE,53,4+7,1519,1406,113,C42,5,Out of Time,White
TRUE,55,30+0,1394,1414,-20,D06,4,Resign,White
TRUE,15,7+2,1648,1399,249,C41,5,Mate,White
TRUE,27,7+2,1643,1404,239,C00,3,Mate,White
TRUE,82,7+2,1638,1409,229,C42,5,Resign,White
TRUE,32,7+2,1657,1389,268,C40,5,Mate,Black
TRUE,66,7+2,1653,1394,259,C42,5,Resign,White
TRUE,9,15+0,1601,1399,202,C23,4,Resign,White
TRUE,39,8+7,1543,1407,136,B06,2,Resign,White
TRUE,21,15+0,1394,1427,-33,D10,4,Resign,White
TRUE,80,40+15,1528,1402,126,D00,4,Resign,White
TRUE,63,15+10,1738,1405,333,C24,4,Resign,White
TRUE,84,10+5,1535,1413,122,C41,5,Resign,White
FALSE,62,10+10,1568,2060,-492,C00,3,Resign,Black
FALSE,15,15+0,1783,2060,-277,C01,7,Resign,Black
FALSE,104,5+5,2060,1614,446,B40,4,Resign,Black
FALSE,30,5+5,1527,2060,-533,C10,6,Mate,Black
FALSE,50,5+5,2060,1527,533,C34,5,Resign,Black
FALSE,45,10+0,1553,2060,-507,C01,5,Resign,White
FALSE,40,10+2,2060,1546,514,B00,2,Mate,Black
FALSE,30,20+0,1768,2060,-292,C02,9,Resign,Black
FALSE,95,10+0,1876,2060,-184,C00,3,Resign,White
FALSE,34,20+0,2060,1882,178,C34,6,Mate,Black
FALSE,37,10+0,2060,1500,560,B30,4,Out of Time,White
FALSE,63,10+0,1500,2060,-560,C00,3,Out of Time,White
FALSE,43,20+0,1500,2060,-560,C00,3,Resign,White
FALSE,95,5+8,2060,1932,128,B10,2,Resign,White
FALSE,37,10+0,2060,1754,306,C34,6,Resign,White
FALSE,53,10+2,1500,2060,-560,C00,2,Out of Time,White
FALSE,26,10+0,1500,2060,-560,C00,3,Resign,Black
FALSE,54,10+15,2060,1639,421,C34,6,Resign,Black
TRUE,72,20+0,1513,1569,-56,C42,5,Resign,Black
TRUE,46,20+0,1440,1553,-113,D91,9,Resign,Black
TRUE,40,20+0,1459,1532,-73,C53,8,Resign,Black
TRUE,58,30+8,1573,1356,217,D35,6,Resign,Black
TRUE,47,30+0,1672,1595,77,A08,5,Resign,White
TRUE,13,14+10,1507,1570,-63,D80,6,Resign,Black
TRUE,62,20+0,1741,1589,152,C24,4,Resign,White
TRUE,29,20+10,1409,1644,-235,C54,11,Resign,White
TRUE,67,20+8,1552,1649,-97,C46,7,Resign,White
TRUE,66,60+1,1679,1816,-137,D32,10,Resign,Black
TRUE,83,60+1,1833,1594,239,C68,10,Resign,Black
TRUE,67,60+0,1508,1681,-173,D35,6,Resign,White
TRUE,80,15+0,1340,1567,-227,A04,2,Mate,Black
TRUE,73,5+8,1502,1346,156,B20,2,Resign,White
TRUE,18,10+10,1354,1445,-91,A22,4,Out of Time,Black
TRUE,33,5+8,1312,1366,-54,B00,3,Resign,White
TRUE,50,8+1,1407,1354,53,D00,3,Mate,Black
TRUE,48,20+0,1366,1297,69,A04,2,Resign,Black
TRUE,95,20+0,1282,1380,-98,C40,4,Resign,White
TRUE,65,15+0,1460,1389,71,B27,3,Resign,White
TRUE,50,10+2,1379,1378,1,B32,5,Resign,Black
TRUE,27,10+2,1366,1391,-25,B50,4,Resign,White
TRUE,149,15+10,1357,1300,57,A35,4,Mate,White
TRUE,73,5+8,1365,1479,-114,A04,2,Resign,Black
TRUE,66,10+3,1374,1435,-61,A07,3,Mate,Black
TRUE,35,10+3,1425,1383,42,D00,3,Resign,White
TRUE,74,5+8,1395,1377,18,A04,2,Mate,Black
TRUE,92,5+5,1360,1384,-24,B20,3,Mate,Black
TRUE,103,10+0,1756,1387,369,B00,2,Resign,White
TRUE,105,8+2,1374,1462,-88,A10,2,Out of Time,White
TRUE,88,10+0,1401,1373,28,B21,3,Draw,Draw
TRUE,41,8+8,1383,1651,-268,A22,4,Resign,Black
TRUE,2,14+2,1383,1522,-139,A20,2,Out of Time,Black
TRUE,77,19+2,1352,1642,-290,A44,4,Mate,White
TRUE,47,8+8,1421,1361,60,A01,2,Resign,White
TRUE,106,15+0,1323,1351,-28,C46,6,Mate,Black
TRUE,79,5+6,1314,1355,-41,B00,3,Mate,White
TRUE,45,9+9,1362,1461,-99,B07,4,Resign,Black
TRUE,70,15+0,1371,1453,-82,C20,3,Resign,Black
TRUE,31,15+0,1442,1379,63,B00,3,Mate,White
FALSE,58,10+0,1368,1464,-96,C45,8,Resign,Black
FALSE,52,10+0,1464,1301,163,B00,2,Mate,Black
FALSE,27,10+5,1388,1464,-76,C55,6,Resign,White
FALSE,58,10+5,1204,1464,-260,C44,5,Mate,Black
FALSE,48,10+5,1464,1441,23,B27,4,Resign,Black
FALSE,29,15+0,1464,1540,-76,B13,5,Resign,White
FALSE,20,15+0,1337,1464,-127,C67,8,Resign,White
FALSE,134,15+0,1516,1464,52,C44,5,Mate,Black
TRUE,19,10+0,1526,1473,53,A00,1,Resign,White
TRUE,47,15+10,1413,1487,-74,C58,11,Mate,White
TRUE,53,30+0,1473,1587,-114,C70,6,Resign,White
TRUE,20,20+0,1479,1633,-154,C50,6,Resign,Black
TRUE,56,15+4,1417,1470,-53,A01,5,Resign,Black
TRUE,92,10+0,1263,1454,-191,C24,4,Out of Time,Black
TRUE,81,10+0,1442,1487,-45,C46,7,Mate,White
TRUE,95,10+0,1644,1447,197,D02,5,Mate,White
TRUE,110,10+0,1456,1767,-311,C61,6,Resign,Black
TRUE,49,10+0,1465,1523,-58,C00,3,Resign,Black
TRUE,123,10+0,1392,1479,-87,C68,7,Resign,White
TRUE,81,15+0,1463,1641,-178,C46,5,Mate,White
TRUE,66,15+0,1476,1386,90,B02,4,Mate,Black
TRUE,64,15+0,1615,1461,154,C45,8,Resign,Black
TRUE,87,15+0,1446,1579,-133,B01,6,Out of Time,White
TRUE,49,15+0,1382,1459,-77,C46,7,Mate,White
TRUE,36,15+0,1472,1406,66,C40,4,Resign,Black
TRUE,16,15+0,1480,1594,-114,C46,5,Mate,Black
TRUE,76,15+0,1309,1474,-165,C45,9,Resign,Black
TRUE,70,15+0,1328,1467,-139,C65,6,Mate,Black
TRUE,27,15+0,1469,1368,101,C48,9,Draw,Draw
TRUE,52,15+0,1632,1453,179,A01,4,Mate,Black
TRUE,66,15+0,1458,1666,-208,C41,4,Mate,Black
TRUE,2,15+0,1467,1510,-43,B20,2,Resign,Black
TRUE,78,15+0,1481,1380,101,C41,4,Mate,Black
TRUE,51,15+0,1535,1491,44,C57,10,Mate,White
TRUE,17,180+180,1564,1500,64,D06,8,Resign,White
TRUE,20,60+0,1505,1690,-185,C00,3,Mate,Black
TRUE,74,15+0,1496,1492,4,A00,1,Resign,Black
TRUE,67,15+0,1567,1500,67,C57,8,Resign,White
TRUE,16,25+0,1506,1662,-156,B28,8,Resign,Black
TRUE,56,5+5,1516,1546,-30,C45,7,Resign,Black
TRUE,90,10+2,1524,1597,-73,B06,2,Mate,Black
TRUE,63,6+4,1644,1532,112,C55,7,Resign,White
TRUE,47,5+5,1618,1540,78,C45,7,Mate,White
TRUE,115,10+0,1540,1543,-3,B01,4,Draw,Draw
TRUE,85,20+0,1512,1642,-130,C45,7,Resign,White
TRUE,39,10+3,1738,1517,221,D20,5,Resign,White
TRUE,212,8+0,1513,1634,-121,B30,4,Draw,Draw
TRUE,16,30+0,1561,1523,38,D20,5,Resign,White
TRUE,32,5+10,1533,1553,-20,A42,5,Resign,Black
TRUE,47,15+0,1592,1542,50,C44,6,Mate,White
TRUE,24,10+3,1726,1547,179,D20,5,Resign,White
TRUE,54,10+0,1606,1535,71,A40,2,Resign,Black
TRUE,163,15+0,1643,1542,101,C21,7,Mate,White
TRUE,42,20+0,1548,1710,-162,C40,4,Resign,Black
TRUE,129,8+0,1537,1575,-38,B54,6,Out of Time,White
TRUE,79,8+0,1603,1546,57,C45,7,Resign,White
FALSE,33,15+0,1546,1700,-154,B41,8,Resign,Black
FALSE,100,8+0,1500,1546,-46,D00,3,Mate,Black
FALSE,36,14+8,1546,1500,46,C45,8,Resign,Black
FALSE,15,15+8,1500,1546,-46,C57,11,Resign,White
FALSE,57,10+0,1546,1642,-96,C45,7,Mate,White
FALSE,120,5+8,1546,1533,13,C44,5,Resign,Black
TRUE,59,5+8,1604,1533,71,C42,5,Resign,Black
TRUE,41,10+0,1523,1508,15,C45,7,Mate,White
TRUE,118,10+8,1571,1510,61,C45,7,Resign,Black
TRUE,17,5+5,1683,1516,167,C20,2,Resign,White
TRUE,44,5+5,1649,1501,148,C20,3,Resign,Black
TRUE,30,10+0,1509,1617,-108,C41,7,Resign,Black
TRUE,114,10+0,1518,1560,-42,B32,11,Resign,Black
TRUE,61,5+8,1704,1523,181,D00,3,Resign,White
TRUE,133,8+0,1520,1637,-117,C45,7,Draw,Draw
TRUE,109,15+0,1624,1528,96,C45,7,Resign,White
TRUE,65,20+0,1513,1656,-143,C00,3,Mate,White
TRUE,143,8+0,1603,1521,82,C20,3,Mate,White
TRUE,127,10+0,1509,1585,-76,B00,13,Resign,White
TRUE,79,10+0,1618,1516,102,D20,6,Resign,White
TRUE,32,7+8,1522,1702,-180,C45,7,Resign,Black
TRUE,129,8+0,1555,1532,23,C45,7,Resign,White
TRUE,58,6+3,1651,1539,112,C45,7,Resign,White
TRUE,20,3+8,1545,1714,-169,C00,3,Resign,Black
TRUE,13,5+5,1567,1555,12,D20,4,Resign,White
TRUE,28,15+5,1565,1563,2,C44,5,Resign,Black
TRUE,77,12+0,1574,1632,-58,C45,7,Resign,Black
TRUE,36,15+0,1582,1663,-81,C46,6,Resign,Black
TRUE,69,15+0,1650,1590,60,C26,5,Mate,White
TRUE,47,15+2,1438,1436,2,C00,3,Resign,White
TRUE,42,20+0,1486,1420,66,A40,2,Resign,Black
TRUE,109,20+15,1418,1472,-54,C64,6,Draw,Draw
TRUE,71,20+0,1390,1470,-80,A00,1,Resign,White
TRUE,83,30+0,1428,1403,25,C00,3,Mate,White
TRUE,109,9+2,1384,1498,-114,A00,1,Mate,White
TRUE,75,10+0,1598,1391,207,C00,3,Out of Time,White
TRUE,74,10+0,1394,1764,-370,A00,1,Mate,Black
TRUE,104,10+0,1396,1889,-493,A00,2,Out of Time,Black
TRUE,85,10+0,1738,1399,339,C00,3,Mate,White
TRUE,53,10+0,1749,1403,346,C00,3,Mate,White
TRUE,82,10+0,1396,1389,7,C00,3,Mate,Black
TRUE,74,8+8,1380,1375,5,C00,5,Mate,Black
TRUE,83,8+8,1360,1395,-35,B10,4,Mate,White
TRUE,125,10+5,1345,1345,0,B01,2,Mate,White
TRUE,135,25+0,1473,1352,121,B06,2,Mate,White
TRUE,72,20+5,1365,1442,-77,A01,2,Mate,Black
TRUE,61,30+0,1474,1376,98,B06,4,Mate,White
TRUE,16,30+0,1389,1465,-76,A00,1,Resign,Black
TRUE,34,25+25,1375,1372,3,C21,3,Mate,Black
TRUE,87,25+25,1372,1375,-3,A00,4,Draw,Draw
TRUE,37,30+0,1430,1388,42,C50,5,Resign,White
TRUE,47,30+10,1516,1362,154,C55,7,Resign,Black
TRUE,47,25+0,1699,1378,321,D45,9,Resign,White
TRUE,27,20+10,1448,1394,54,B12,3,Resign,White
TRUE,34,30+15,1413,1431,-18,C20,3,Resign,Black
TRUE,62,15+0,1432,1477,-45,C00,3,Out of Time,Black
TRUE,26,15+0,1466,1453,13,C20,3,Resign,White
TRUE,59,20+0,1472,1550,-78,C40,4,Resign,Black
TRUE,61,15+5,1413,1449,-36,C20,3,Resign,Black
TRUE,81,15+1,1429,1500,-71,B07,2,Mate,White
TRUE,61,20+0,1484,1454,30,A00,1,Out of Time,White
TRUE,18,15+0,1495,1419,76,C20,3,Mate,Black
TRUE,57,20+0,1391,1360,31,C40,4,Mate,White
TRUE,118,25+0,1431,1350,81,C60,6,Mate,Black
TRUE,12,25+8,1416,1302,114,C44,5,Resign,Black
TRUE,39,30+0,1495,1240,255,C65,6,Resign,Black
TRUE,62,15+3,1276,1322,-46,C55,6,Resign,Black
TRUE,20,20+0,1298,1218,80,C44,5,Resign,Black
TRUE,67,20+4,1351,1258,93,D00,3,Resign,White
TRUE,72,10+0,1323,1293,30,C41,5,Out of Time,Black
TRUE,58,10+0,1628,1348,280,C20,4,Resign,White
TRUE,6,10+10,1357,1871,-514,A00,1,Resign,Black
TRUE,60,30+0,1385,1683,-298,B20,3,Resign,Black
TRUE,59,30+0,1558,1457,101,C60,6,Mate,White
TRUE,54,30+0,1462,1249,213,C44,4,Resign,Black
TRUE,53,10+0,2035,1757,278,A13,4,Resign,White
TRUE,56,10+0,2053,1840,213,A09,4,Mate,Black
TRUE,36,10+0,1468,2052,-584,E10,6,Mate,Black
TRUE,63,10+0,2043,1964,79,A15,4,Resign,White
TRUE,49,10+2,1994,2057,-63,B50,5,Mate,White
TRUE,36,10+0,1684,1717,-33,D00,4,Mate,Black
TRUE,83,10+0,1703,1783,-80,C55,6,Out of Time,White
TRUE,58,10+0,1807,1687,120,C77,9,Mate,Black
TRUE,35,10+0,1953,1691,262,C50,8,Resign,White
TRUE,25,10+0,1679,1698,-19,C34,6,Resign,White
TRUE,70,10+0,1398,1661,-263,C68,10,Resign,Black
TRUE,45,10+0,1873,1667,206,C30,3,Mate,White
TRUE,35,10+0,1664,1315,349,B03,6,Resign,White
TRUE,99,10+0,1646,1833,-187,B32,8,Resign,White
TRUE,65,10+0,1518,1582,-64,C33,5,Resign,White
TRUE,75,10+0,1575,1420,155,B01,2,Mate,White
TRUE,65,10+0,1563,1615,-52,C21,9,Mate,White
TRUE,135,10+5,1551,1585,-34,C24,7,Mate,White
FALSE,57,10+5,1551,1585,-34,C02,8,Mate,White
TRUE,61,10+2,1552,1538,14,C21,10,Mate,White
TRUE,63,10+2,1526,1564,-38,C24,4,Mate,White
TRUE,88,10+2,1569,1747,-178,C21,5,Resign,Black
TRUE,66,10+2,1577,1695,-118,C00,3,Resign,Black
TRUE,37,10+2,1603,1565,38,A00,1,Resign,Black
TRUE,62,10+0,1323,1560,-237,C55,7,Mate,Black
TRUE,110,10+2,1724,1544,180,D02,4,Resign,Black
TRUE,35,10+2,1532,1556,-24,D00,3,Resign,White
TRUE,97,10+2,1545,1543,2,C00,3,Mate,White
TRUE,96,10+2,1552,1705,-153,C44,11,Resign,Black
TRUE,57,10+0,1513,1575,-62,C55,6,Mate,White
TRUE,45,10+0,1566,1499,67,C21,10,Mate,White
TRUE,49,10+2,1555,1566,-11,C44,5,Resign,White
TRUE,23,10+2,1555,1566,-11,C44,4,Resign,White
TRUE,72,10+2,1567,1759,-192,C21,9,Out of Time,Black
FALSE,125,10+2,1576,1779,-203,C21,10,Out of Time,White
FALSE,31,10+2,1779,1576,203,C02,7,Mate,White
FALSE,25,10+2,1576,1669,-93,C21,10,Resign,White
FALSE,56,10+2,1600,1576,24,C00,3,Mate,Black
FALSE,104,10+2,1576,1600,-24,B40,8,Resign,Black
TRUE,47,10+2,1566,1520,46,C21,5,Mate,White
TRUE,29,10+2,1530,1556,-26,C42,5,Resign,Black
TRUE,37,10+2,1564,1567,-3,D30,4,Resign,White
TRUE,30,10+2,1578,1534,44,B00,2,Resign,Black
TRUE,60,10+2,1551,1568,-17,A40,4,Out of Time,Black
TRUE,79,10+0,1569,2101,-532,B30,4,Resign,Black
TRUE,54,10+0,1523,1559,-36,D20,4,Resign,Black
TRUE,71,10+0,1542,1815,-273,B54,6,Resign,White
FALSE,32,10+5,1600,1542,58,C62,6,Out of Time,Black
TRUE,107,10+2,1517,1553,-36,C00,2,Mate,White
TRUE,70,10+2,1565,1536,29,C21,5,Resign,Black
TRUE,48,10+2,1577,1512,65,C00,4,Mate,Black
TRUE,53,10+2,1714,1584,130,C43,6,Resign,White
TRUE,75,10+0,1578,1430,148,C00,4,Resign,White
TRUE,36,10+0,1437,1571,-134,B20,3,Mate,Black
TRUE,61,10+2,1559,1594,-35,C21,5,Resign,White
TRUE,95,15+0,1291,1464,-173,B01,4,Mate,White
TRUE,25,10+3,1657,1301,356,C50,8,Resign,White
TRUE,60,5+5,1303,1889,-586,C02,10,Mate,Black
TRUE,59,20+0,1303,1223,80,C70,6,Mate,White
FALSE,33,8+8,1418,1303,115,A80,3,Mate,White
FALSE,53,10+0,1303,1500,-197,C46,7,Mate,White
FALSE,38,6+8,1431,1312,119,C22,8,Mate,Black
TRUE,59,10+0,1699,1315,384,A01,2,Out of Time,White
TRUE,36,10+0,1626,1291,335,C20,3,Resign,Black
TRUE,60,10+0,1294,1669,-375,B10,2,Mate,Black
TRUE,15,5+5,1381,1305,76,C21,3,Resign,White
TRUE,34,5+5,1296,1544,-248,C45,7,Draw,Draw
TRUE,18,7+7,1693,1667,26,B01,4,Resign,Black
FALSE,3,4+6,1259,1693,-434,B01,2,Resign,Black
FALSE,9,4+6,1693,1259,434,C42,6,Mate,White
TRUE,55,4+6,1640,1706,-66,D02,4,Out of Time,White
TRUE,38,8+2,1712,1907,-195,B32,7,Resign,Black
TRUE,66,5+8,1621,1703,-82,C26,5,Resign,Black
TRUE,38,15+10,1704,2406,-702,C40,4,Resign,Black
TRUE,63,15+10,2406,1704,702,D15,7,Resign,White
TRUE,140,0+15,1549,1697,-148,D00,3,Resign,Black
TRUE,99,11+0,1683,1776,-93,C01,5,Resign,White
TRUE,42,15+10,1666,1872,-206,B90,11,Resign,White
TRUE,111,15+10,1867,1671,196,A28,6,Resign,White
TRUE,33,15+10,1664,1883,-219,B90,11,Resign,White
TRUE,38,3+10,1671,1806,-135,B43,9,Mate,Black
TRUE,45,7+2,2041,1674,367,C26,6,Out of Time,White
TRUE,21,10+0,1697,1684,13,C57,10,Resign,White
TRUE,71,8+0,1634,1698,-64,A00,1,Mate,White
TRUE,24,1+15,1818,1694,124,A20,2,Draw,Draw
TRUE,109,8+0,1700,1502,198,C01,5,Draw,Draw
TRUE,84,15+10,1696,1404,292,C01,5,Resign,White
TRUE,29,5+5,1962,1700,262,C34,6,Resign,White
TRUE,48,8+0,1706,1874,-168,C60,6,Out of Time,Black
TRUE,28,8+0,1907,1689,218,C26,7,Resign,Black
TRUE,41,5+8,1850,1696,154,C36,7,Resign,White
TRUE,60,5+5,1700,1991,-291,C62,6,Mate,Black
TRUE,48,11+9,1705,1889,-184,B01,8,Out of Time,Black
TRUE,49,10+0,1694,1721,-27,C64,6,Resign,White
TRUE,74,5+7,1704,1712,-8,C45,7,Out of Time,Black
TRUE,55,10+0,1767,1713,54,A00,1,Resign,White
TRUE,52,12+10,1726,1686,40,C63,7,Resign,Black
TRUE,32,12+10,1696,1715,-19,C55,7,Resign,Black
TRUE,93,7+7,2252,1716,536,C33,5,Mate,White
TRUE,78,7+2,1791,1714,77,C21,5,Draw,Draw
TRUE,38,8+0,1731,1875,-144,C00,3,Mate,Black
TRUE,43,6+6,1720,1738,-18,C41,4,Resign,White
TRUE,20,6+6,1750,1708,42,C23,5,Mate,Black
TRUE,80,10+10,1717,1745,-28,B70,10,Resign,Black
TRUE,94,8+0,1744,1717,27,A01,5,Draw,Draw
TRUE,51,10+8,1708,1649,59,B27,4,Resign,White
FALSE,106,7+5,1515,1885,-370,B02,4,Mate,Black
FALSE,68,7+5,1885,1515,370,A40,2,Mate,Black
FALSE,68,12+7,1710,1885,-175,A45,3,Resign,Black
FALSE,55,2+12,1500,1885,-385,D05,14,Resign,White
FALSE,96,2+12,1885,1500,385,B34,8,Resign,Black
FALSE,53,10+0,1885,1645,240,C64,6,Resign,White
FALSE,34,10+0,1645,1885,-240,B20,3,Resign,Black
FALSE,3,8+5,1546,1885,-339,B20,2,Out of Time,White
FALSE,54,8+0,1670,1885,-215,B30,5,Resign,Black
FALSE,64,10+1,1885,1500,385,C00,5,Resign,Black
TRUE,76,7+5,1743,1757,-14,B12,7,Resign,White
TRUE,50,45+15,1754,1772,-18,B21,6,Resign,Black
TRUE,84,10+15,1637,1746,-109,B20,3,Mate,Black
TRUE,47,10+15,1440,1742,-302,B32,8,Resign,Black
TRUE,51,10+15,1738,1462,276,C34,6,Mate,White
TRUE,28,10+15,1733,1487,246,C00,3,Resign,White
TRUE,66,10+15,1579,1726,-147,A00,1,Resign,Black
TRUE,45,10+15,1716,1657,59,B23,5,Resign,White
TRUE,73,10+15,1507,1735,-228,B21,3,Mate,White
TRUE,78,10+15,1512,1729,-217,A00,1,Resign,Black
TRUE,82,10+0,1773,1653,120,B00,2,Resign,Black
TRUE,13,10+0,1757,1874,-117,B12,3,Mate,White
TRUE,57,10+0,1747,1655,92,C01,5,Mate,White
TRUE,34,10+0,1755,1871,-116,C02,10,Mate,Black
TRUE,106,10+0,1732,1743,-11,B20,3,Mate,Black
TRUE,70,10+0,1756,1813,-57,C00,3,Out of Time,Black
TRUE,111,8+0,1772,1768,4,D01,4,Out of Time,White
TRUE,59,10+15,1762,1580,182,C35,6,Resign,White
TRUE,33,10+15,1563,1781,-218,D20,5,Resign,White
TRUE,20,10+15,1522,1776,-254,D02,4,Mate,Black
TRUE,42,10+0,1784,1904,-120,C40,4,Resign,Black
TRUE,35,10+0,2059,1789,270,A40,2,Resign,White
TRUE,24,10+0,1803,1744,59,C42,5,Resign,Black
TRUE,60,10+0,1777,1791,-14,B94,11,Mate,Black
TRUE,87,10+0,1803,1803,0,A40,2,Out of Time,White
TRUE,62,10+0,1811,1955,-144,C45,8,Resign,Black
TRUE,52,10+0,1830,1623,207,B27,3,Resign,Black
TRUE,59,10+0,1662,1849,-187,B21,5,Mate,White
TRUE,67,10+0,1832,1941,-109,B46,10,Mate,White
TRUE,88,10+0,1978,1814,164,A04,2,Mate,Black
TRUE,32,10+0,1298,1382,-84,C50,6,Resign,Black
TRUE,19,10+0,1367,1440,-73,C56,12,Resign,White
TRUE,174,10+0,1344,1368,-24,A00,2,Draw,Draw
TRUE,83,15+1,1351,1465,-114,C42,6,Resign,White
TRUE,85,15+5,1344,1140,204,C55,7,Resign,White
TRUE,69,10+0,1607,1349,258,C45,8,Resign,White
TRUE,79,10+0,1321,1510,-189,B12,3,Mate,White
TRUE,74,10+0,1325,1644,-319,C53,7,Mate,Black
TRUE,80,10+0,1322,1311,11,D02,4,Mate,Black
FALSE,101,15+0,1297,1500,-203,C61,6,Mate,White
TRUE,62,15+15,1081,1290,-209,A40,2,Mate,Black
TRUE,65,10+0,1277,1280,-3,C50,6,Resign,White
TRUE,83,10+0,1226,1293,-67,C24,4,Mate,White
TRUE,69,10+5,1500,1299,201,C80,11,Mate,White
TRUE,44,15+5,1110,1292,-182,B20,3,Resign,Black
TRUE,73,15+15,1277,1293,-16,C46,5,Resign,White
TRUE,12,20+0,1378,1492,-114,C20,3,Resign,Black
TRUE,21,6+3,1580,1501,79,C50,6,Resign,White
TRUE,30,10+0,1510,1545,-35,C41,7,Resign,Black
TRUE,170,15+5,1344,1487,-143,C44,4,Mate,Black
TRUE,47,15+0,1477,1441,36,C44,8,Resign,White
TRUE,42,8+4,1711,1729,-18,B01,4,Resign,Black
TRUE,56,8+4,1742,1700,42,C41,7,Mate,Black
TRUE,27,5+8,1726,1710,16,D00,3,Resign,White
TRUE,96,4+6,1779,1719,60,C20,4,Resign,White
TRUE,101,6+3,1709,1671,38,C24,4,Mate,White
TRUE,73,5+8,1696,1698,-2,A30,2,Resign,Black
TRUE,33,5+8,1687,1708,-21,C24,4,Resign,White
TRUE,70,5+8,1720,1675,45,D00,3,Resign,Black
TRUE,31,5+8,1662,1744,-82,C23,5,Out of Time,White
TRUE,72,5+5,1670,1764,-94,C00,3,Out of Time,Black
TRUE,52,5+5,1780,1656,124,C41,7,Resign,Black
TRUE,30,5+7,1629,1645,-16,C62,6,Mate,Black
TRUE,47,5+7,1634,1641,-7,C55,7,Resign,White
TRUE,50,5+7,1652,1623,29,C44,5,Resign,Black
TRUE,142,5+7,1622,1653,-31,C24,4,Draw,Draw
TRUE,99,5+5,1738,1629,109,A01,3,Resign,White
TRUE,64,20+2,1732,1615,117,C62,6,Resign,Black
TRUE,56,5+5,1622,1768,-146,C23,3,Resign,Black
TRUE,55,5+5,1609,1677,-68,B20,3,Resign,White
TRUE,55,10+5,1595,1696,-101,B20,3,Resign,White
TRUE,37,10+5,1688,1603,85,C41,8,Mate,White
TRUE,68,10+0,1611,1721,-110,B20,3,Resign,Black
TRUE,57,6+10,1597,1701,-104,B20,3,Resign,White
TRUE,42,6+10,1716,1582,134,C41,7,Mate,Black
TRUE,12,5+8,1587,1786,-199,C50,6,Resign,Black
TRUE,49,5+8,1780,1593,187,C23,3,Out of Time,White
TRUE,31,7+5,1799,1598,201,D06,4,Resign,White
TRUE,86,6+6,1606,1704,-98,C20,4,Resign,Black
TRUE,100,10+6,1615,1658,-43,C46,7,Resign,Black
TRUE,65,5+8,1731,1623,108,C62,6,Resign,White
TRUE,79,5+7,1610,1691,-81,B01,2,Resign,White
TRUE,79,5+8,1691,1618,73,C45,7,Resign,White
TRUE,51,5+5,1606,1655,-49,B12,5,Out of Time,White
TRUE,27,5+5,1712,1622,90,C50,6,Mate,White
TRUE,69,7+6,1607,1729,-122,B01,2,Resign,White
TRUE,33,10+6,1655,1617,38,C51,10,Mate,White
TRUE,55,10+6,1604,1668,-64,C42,5,Mate,White
TRUE,47,5+8,1759,1611,148,C45,8,Resign,White
TRUE,66,5+5,1752,1595,157,C50,8,Mate,Black
TRUE,101,5+8,1832,1600,232,C20,4,Resign,White
TRUE,63,5+5,1665,1609,56,C23,3,Resign,White
TRUE,63,5+8,1708,1617,91,C55,7,Out of Time,White
TRUE,71,8+0,1603,1688,-85,C33,5,Mate,White
TRUE,48,15+10,1730,1611,119,C41,5,Resign,White
TRUE,31,15+10,1596,1746,-150,C40,4,Mate,White
TRUE,105,15+10,1775,1602,173,D00,3,Resign,White
TRUE,41,8+5,1606,1828,-222,C33,5,Resign,Black
TRUE,41,6+8,1807,1612,195,C30,4,Resign,White
TRUE,63,10+12,1869,1616,253,C34,6,Resign,White
TRUE,49,10+0,2208,1885,323,C64,6,Mate,White
TRUE,180,10+0,2228,2193,35,C55,7,Resign,Black
TRUE,47,10+0,2187,1974,213,B72,13,Resign,White
TRUE,52,10+0,1879,2183,-304,C33,5,Resign,Black
TRUE,47,10+0,2168,2189,-21,B12,7,Resign,White
TRUE,29,10+0,2188,1763,425,C00,4,Mate,White
TRUE,68,10+0,2016,2180,-164,E24,9,Resign,Black
TRUE,35,10+0,2180,1494,686,B01,4,Resign,White
TRUE,24,10+0,1669,2178,-509,C02,8,Resign,Black
TRUE,61,10+0,2178,1414,764,A40,2,Mate,White
TRUE,71,5+5,2157,2355,-198,B34,9,Resign,White
TRUE,43,15+0,2071,2175,-104,C48,8,Resign,White
TRUE,48,10+0,1812,2172,-360,A46,3,Resign,Black
TRUE,31,10+0,2169,1736,433,B00,2,Mate,White
TRUE,25,10+0,2168,1650,518,B00,5,Mate,White
TRUE,38,10+0,1614,2167,-553,C00,3,Mate,Black
TRUE,15,10+0,2165,1651,514,B00,5,Resign,White
TRUE,50,10+0,1468,2165,-697,D01,4,Mate,Black
TRUE,69,10+0,2162,1814,348,B90,11,Out of Time,White
TRUE,20,15+5,1826,2159,-333,C45,9,Resign,Black
TRUE,102,10+5,2065,2149,-84,D02,4,Resign,Black
TRUE,83,10+0,2075,2165,-90,E00,5,Resign,White
TRUE,57,10+0,2154,2084,70,A04,2,Resign,White
TRUE,72,10+0,2093,2143,-50,D18,11,Resign,Black
TRUE,68,15+0,2000,2135,-135,B00,2,Resign,Black
TRUE,55,15+0,2126,2007,119,C50,8,Mate,White
TRUE,100,25+0,2020,2120,-100,B07,4,Draw,Draw
TRUE,51,25+0,2109,2028,81,C45,8,Resign,White
TRUE,67,20+10,2122,1859,263,A03,2,Resign,White
TRUE,42,30+0,1810,2118,-308,B10,2,Resign,Black
TRUE,88,15+0,2105,2104,1,B00,2,Out of Time,Black
TRUE,84,30+10,2062,2090,-28,C78,9,Resign,Black
TRUE,93,10+0,1786,2118,-332,A00,1,Out of Time,White
TRUE,100,10+0,2122,2446,-324,A10,2,Out of Time,Black
TRUE,41,10+0,2113,1954,159,A10,2,Mate,White
TRUE,56,10+0,1778,2109,-331,B00,3,Mate,Black
TRUE,59,10+0,2099,1974,125,A11,2,Resign,White
TRUE,66,15+0,1865,2092,-227,B00,3,Resign,Black
TRUE,72,10+0,1782,1602,180,C00,3,Out of Time,Black
TRUE,89,10+0,1767,1921,-154,B50,5,Out of Time,White
FALSE,98,5+8,1411,1702,-291,B25,4,Mate,Black
TRUE,32,10+0,1700,1263,437,C60,6,Resign,White
TRUE,37,10+0,1772,1710,62,B72,11,Mate,White
TRUE,47,5+5,1693,1834,-141,C70,8,Resign,White
FALSE,113,5+8,1693,1500,193,C65,8,Resign,White
TRUE,45,10+0,1957,1923,34,B50,4,Resign,Black
TRUE,113,8+0,1980,1967,13,B07,3,Out of Time,White
TRUE,66,8+0,1996,1955,41,D05,7,Out of Time,Black
TRUE,64,5+5,1949,1957,-8,E76,9,Resign,Black
TRUE,54,5+5,1969,1938,31,B42,9,Resign,Black
TRUE,22,8+0,2058,1955,103,C00,3,Resign,Black
TRUE,73,8+0,1944,1947,-3,B00,4,Resign,White
TRUE,51,5+5,1930,2032,-102,B45,10,Resign,White
TRUE,50,2+10,2004,1918,86,E61,6,Resign,Black
TRUE,46,10+0,2088,1902,186,E70,7,Resign,Black
TRUE,45,15+5,1906,2161,-255,B10,2,Resign,Black
TRUE,37,5+10,2146,1911,235,D02,4,Resign,White
TRUE,19,15+0,1957,1920,37,C46,5,Resign,White
TRUE,55,15+0,1938,1930,8,E00,4,Resign,White
TRUE,71,5+5,1917,2002,-85,B07,6,Resign,White
TRUE,64,5+6,1928,1920,8,C88,13,Out of Time,Black
TRUE,36,15+0,1954,1938,16,C68,10,Resign,White
TRUE,10,15+0,1941,1948,-7,A45,2,Resign,White
TRUE,3,12+3,1953,1999,-46,A02,3,Draw,Draw
TRUE,65,15+0,1952,1954,-2,B50,4,Mate,White
TRUE,42,15+0,1943,1963,-20,B32,7,Resign,White
TRUE,42,10+5,1974,1961,13,D00,3,Resign,Black
TRUE,57,15+10,2035,1983,52,C41,5,Resign,White
TRUE,85,60+0,1972,1973,-1,C61,6,Draw,Draw
TRUE,70,20+2,1973,1973,0,A80,2,Draw,Draw
TRUE,140,15+0,1980,2085,-105,B21,5,Resign,Black
TRUE,61,15+0,2022,1989,33,D20,4,Resign,White
TRUE,78,15+0,2000,1917,83,E21,7,Resign,Black
TRUE,37,10+10,1991,1930,61,C00,3,Mate,White
TRUE,79,10+0,2186,1996,190,A80,2,Resign,White
TRUE,80,20+0,1958,1987,-29,A82,4,Resign,Black
TRUE,9,8+0,1932,1989,-57,A80,3,Mate,White
TRUE,31,8+0,1980,1946,34,C50,6,Resign,White
FALSE,53,10+3,1500,1165,335,A54,6,Mate,White
TRUE,62,10+0,1464,1513,-49,C00,3,Mate,Black
TRUE,52,5+5,1681,1520,161,C20,3,Resign,White
TRUE,61,5+5,1674,1528,146,B10,2,Resign,White
TRUE,84,10+0,1542,1472,70,E77,8,Resign,Black
TRUE,81,45+0,1708,1549,159,B11,4,Mate,White
TRUE,25,35+10,1528,1873,-345,D06,4,Resign,White
TRUE,55,35+10,1870,1531,339,B00,3,Resign,White
TRUE,42,15+10,1538,1683,-145,D94,9,Resign,Black
TRUE,67,10+10,1628,1547,81,A02,1,Mate,White
TRUE,117,15+15,1754,1553,201,B10,2,Resign,White
TRUE,56,15+0,1558,1768,-210,E12,10,Resign,Black
TRUE,58,15+0,1762,1564,198,B13,5,Resign,White
TRUE,23,15+1,1549,1664,-115,D20,4,Resign,White
TRUE,98,10+10,1557,1664,-107,D10,5,Resign,Black
TRUE,48,15+5,1607,1543,64,B12,5,Mate,Black
TRUE,94,10+10,1547,1832,-285,A53,4,Mate,Black
TRUE,49,10+0,1550,1927,-377,D30,4,Resign,Black
TRUE,83,10+0,1737,1562,175,B10,2,Resign,White
TRUE,36,7+2,1568,1752,-184,D30,4,Resign,Black
TRUE,58,15+10,1572,1874,-302,D43,8,Resign,Black
TRUE,77,8+0,1920,1575,345,B13,5,Mate,White
TRUE,39,8+0,1578,1916,-338,E34,8,Resign,Black
TRUE,101,8+0,1911,1581,330,B15,7,Out of Time,White
TRUE,111,19+18,1728,1588,140,B13,5,Mate,White
TRUE,52,10+20,1597,1659,-62,A40,2,Resign,Black
FALSE,30,15+10,1750,1155,595,C00,3,Resign,Black
TRUE,16,10+5,1857,1734,123,B21,5,Resign,Black
TRUE,32,45+30,1556,1728,-172,A03,2,Resign,Black
TRUE,95,10+0,1717,1740,-23,B57,8,Out of Time,White
TRUE,37,10+0,1752,1752,0,B28,5,Resign,Black
TRUE,74,5+10,1771,1447,324,B40,8,Resign,Black
TRUE,54,30+30,1500,1766,-266,B90,11,Resign,Black
TRUE,58,30+30,1634,1759,-125,B57,8,Resign,Black
TRUE,80,30+30,1771,1722,49,C44,5,Resign,Black
TRUE,53,30+30,1829,1757,72,B50,4,Resign,Black
TRUE,44,30+30,1654,1750,-96,A49,4,Mate,Black
TRUE,71,30+30,1741,1661,80,B90,11,Mate,White
TRUE,64,30+30,1414,1737,-323,B50,4,Mate,Black
TRUE,47,30+30,1730,1577,153,C41,7,Resign,White
TRUE,74,30+30,1650,1721,-71,B53,7,Mate,Black
TRUE,33,30+30,1715,1524,191,B01,4,Mate,White
TRUE,34,30+30,1415,1734,-319,B20,3,Resign,White
TRUE,53,30+30,1721,1785,-64,C44,6,Resign,White
TRUE,13,30+30,1711,1683,28,C41,5,Mate,White
TRUE,61,30+30,1725,1637,88,B77,16,Resign,Black
TRUE,40,30+30,1635,1716,-81,B50,4,Mate,Black
TRUE,8,30+30,1675,1729,-54,A45,2,Resign,White
TRUE,36,30+30,1723,1522,201,B07,4,Resign,White
TRUE,16,30+30,1730,1877,-147,B32,8,Resign,Black
TRUE,50,30+30,1778,1717,61,E61,4,Resign,Black
TRUE,59,30+30,1693,1729,-36,B50,4,Resign,White
TRUE,41,30+30,1716,1758,-42,C40,4,Mate,White
TRUE,55,30+30,1779,1725,54,B50,5,Resign,White
TRUE,22,30+30,1471,1721,-250,B20,3,Resign,Black
TRUE,45,30+30,1717,1443,274,C44,5,Mate,White
TRUE,36,30+30,1701,1837,-136,B00,5,Resign,White
TRUE,54,15+10,1533,1855,-322,B30,5,Resign,Black
TRUE,63,10+0,2156,2058,98,B06,2,Resign,White
TRUE,30,10+0,1688,2154,-466,A40,2,Resign,Black
TRUE,54,10+0,2168,1872,296,A48,5,Resign,Black
TRUE,48,30+0,1659,1625,34,C20,3,Resign,Black
TRUE,49,30+0,1523,1673,-150,D20,6,Mate,White
TRUE,109,10+8,1767,1566,201,A11,2,Mate,White
TRUE,68,30+0,1192,1539,-347,B06,2,Out of Time,Black
FALSE,106,20+0,1539,1500,39,C21,5,Mate,Black
FALSE,54,15+15,1844,1539,305,D30,4,Resign,Black
FALSE,33,15+15,1539,1844,-305,D38,9,Resign,White
FALSE,36,15+15,1844,1539,305,D06,4,Resign,Black
FALSE,28,15+15,1539,1844,-305,D00,5,Mate,Black
FALSE,29,15+16,1855,1539,316,C41,5,Resign,White
FALSE,30,5+8,1539,1802,-263,C20,3,Resign,Black
FALSE,6,15+0,1315,1539,-224,B00,3,Resign,Black
FALSE,73,15+0,1528,1539,-11,C42,4,Resign,White
FALSE,22,10+5,1539,1229,310,C00,3,Resign,Black
FALSE,58,10+0,1539,1500,39,A45,5,Resign,Black
TRUE,80,15+2,1657,1644,13,D00,3,Mate,Black
TRUE,50,17+0,1463,1500,-37,B30,4,Mate,Black
FALSE,26,15+0,1826,1500,326,B20,3,Resign,Black
FALSE,89,20+0,1266,1500,-234,B00,2,Draw,Draw
FALSE,98,2+15,1500,1457,43,C10,7,Resign,Black
FALSE,41,8+6,1750,1500,250,B00,2,Mate,White
FALSE,45,15+10,1500,1741,-241,A06,3,Resign,White
FALSE,10,11+1,1500,1569,-69,B20,2,Resign,Black
FALSE,54,10+0,1500,1591,-91,C21,9,Resign,Black
FALSE,28,6+8,1500,1500,0,C21,5,Resign,Black
FALSE,30,15+0,1500,1756,-256,A46,5,Resign,Black
FALSE,52,10+0,1302,1500,-198,C46,7,Out of Time,Black
FALSE,75,10+0,1559,1500,59,B00,2,Out of Time,White
TRUE,32,10+12,1566,1580,-14,C00,3,Resign,White
FALSE,35,10+5,1636,1580,56,D15,7,Resign,White
FALSE,38,3+10,1580,1595,-15,B01,4,Mate,Black
FALSE,28,15+0,1580,1500,80,D20,5,Resign,Black
TRUE,78,10+0,1589,1650,-61,B01,6,Resign,Black
TRUE,50,10+0,1438,1583,-145,C00,3,Resign,Black
TRUE,36,10+0,1592,1624,-32,C65,6,Mate,Black
TRUE,55,6+3,1621,1602,19,A49,4,Mate,White
FALSE,57,15+5,1602,1579,23,B01,4,Resign,White
FALSE,65,15+0,1602,1628,-26,D85,13,Resign,White
FALSE,30,10+0,1591,1602,-11,B27,4,Resign,Black
TRUE,48,5+8,1618,1591,27,B20,2,Resign,Black
TRUE,71,7+7,1614,1601,13,B22,3,Resign,White
TRUE,54,10+0,1595,1590,5,C01,5,Resign,Black
TRUE,35,7+10,1600,1621,-21,C60,5,Resign,Black
FALSE,41,10+10,1600,1609,-9,C65,7,Resign,White
FALSE,31,8+7,1600,1631,-31,B32,7,Resign,White
FALSE,99,15+0,1600,1603,-3,C30,3,Resign,White
FALSE,56,10+3,1619,1600,19,C02,9,Resign,White
FALSE,33,10+10,1600,1581,19,C77,9,Resign,Black
FALSE,48,5+5,1500,1600,-100,A00,1,Resign,Black
FALSE,30,10+5,1600,1720,-120,B32,7,Resign,Black
FALSE,27,10+5,1720,1600,120,B21,3,Resign,White
TRUE,34,9+2,1608,1589,19,C00,3,Resign,Black
FALSE,95,10+5,1589,1553,36,C68,7,Resign,White
FALSE,40,10+5,1589,1664,-75,C62,6,Resign,White
FALSE,163,10+5,1538,1589,-51,B02,2,Mate,White
FALSE,87,5+10,1589,1595,-6,A10,2,Resign,White
TRUE,79,5+8,1599,1599,0,D02,4,Resign,White
TRUE,44,10+2,1594,1589,5,C00,3,Mate,Black
FALSE,70,10+5,1691,1589,102,C02,7,Resign,Black
FALSE,15,10+5,1589,1691,-102,C65,8,Resign,White
FALSE,46,10+5,1500,1589,-89,B40,8,Resign,Black
TRUE,37,5+20,1579,1577,2,C00,3,Resign,White
TRUE,105,15+5,1568,1569,-1,C41,7,Out of Time,White
FALSE,32,15+0,1565,1568,-3,B12,7,Resign,White
TRUE,50,10+2,1585,1557,28,A45,3,Mate,Black
TRUE,25,10+5,1513,1569,-56,C20,4,Resign,White
TRUE,28,10+5,1581,1514,67,B33,11,Resign,Black
FALSE,66,10+5,1581,1597,-16,D06,4,Out of Time,Black
TRUE,37,8+4,1598,1592,6,C00,3,Resign,White
FALSE,138,15+5,1500,1592,-92,B07,2,Mate,Black
TRUE,67,10+0,1190,936,254,C25,4,Resign,White
TRUE,121,10+0,1597,1192,405,C57,8,Resign,White
TRUE,57,10+0,1524,1176,348,C46,7,Resign,White
FALSE,89,30+8,2109,2270,-161,A46,4,Resign,White
FALSE,67,15+0,2270,1890,380,C41,8,Mate,White
FALSE,40,45+0,2154,2270,-116,B13,10,Resign,Black
TRUE,70,30+8,2115,2276,-161,A46,4,Draw,Draw
TRUE,55,15+15,2191,2294,-103,B15,10,Resign,White
FALSE,93,20+0,2294,2280,14,C40,4,Resign,White
TRUE,39,15+10,1877,1080,797,C20,3,Mate,White
TRUE,118,120+5,1097,1305,-208,D00,3,Resign,Black
TRUE,66,10+10,1112,1368,-256,C00,3,Mate,Black
TRUE,47,180+0,1374,1129,245,A40,3,Mate,White
TRUE,81,40+8,1604,1135,469,B01,2,Mate,White
TRUE,75,20+0,1364,1156,208,A40,3,Mate,White
TRUE,80,10+0,1954,2158,-204,B40,4,Out of Time,Black
TRUE,37,10+0,2151,1696,455,B33,8,Mate,White
TRUE,85,10+0,1853,2229,-376,D00,3,Mate,White
TRUE,35,10+0,2224,1695,529,B29,5,Mate,White
TRUE,38,10+0,1859,2212,-353,B07,6,Mate,Black
TRUE,42,10+0,1920,2194,-274,C42,5,Mate,Black
TRUE,72,10+0,2092,2147,-55,A08,4,Resign,Black
TRUE,55,10+0,2094,2024,70,B40,11,Resign,White
TRUE,52,10+0,1543,2087,-544,A00,1,Mate,Black
TRUE,54,10+0,1952,2021,-69,D04,6,Resign,Black
TRUE,78,8+0,1496,1525,-29,A00,2,Resign,Black
TRUE,47,8+0,1500,1503,-3,B21,5,Resign,White
TRUE,85,8+0,1515,1514,1,D00,5,Resign,White
TRUE,62,8+0,1524,1515,9,A10,1,Resign,Black
TRUE,49,8+0,1512,1576,-64,A01,2,Mate,White
TRUE,108,8+0,1590,1499,91,D01,4,Out of Time,Black
TRUE,116,8+0,1532,1488,44,B23,3,Resign,Black
TRUE,38,8+0,1497,1535,-38,A01,2,Resign,Black
TRUE,79,8+0,1525,1507,18,B01,2,Resign,White
TRUE,41,8+0,1495,1536,-41,A04,2,Resign,White
TRUE,62,8+0,1503,1587,-84,A04,2,Resign,Black
TRUE,50,8+0,1530,1492,38,B50,4,Mate,Black
TRUE,116,8+0,1501,1541,-40,A00,1,Resign,Black
TRUE,60,8+0,1512,1488,24,A43,3,Mate,Black
TRUE,140,8+0,1501,1501,0,B90,11,Mate,Black
TRUE,60,8+0,1510,1564,-54,A04,2,Resign,Black
TRUE,74,8+0,1520,1549,-29,A04,3,Resign,Black
TRUE,43,8+0,1566,1529,37,A20,2,Resign,White
TRUE,82,8+0,1539,1555,-16,A85,5,Out of Time,Black
TRUE,119,8+0,1544,1549,-5,A15,2,Resign,White
TRUE,45,8+0,1596,1558,38,C55,7,Resign,White
TRUE,66,10+0,1532,1548,-16,A40,1,Resign,Black
TRUE,138,15+0,1559,1564,-5,A43,2,Resign,Black
TRUE,115,10+0,1546,1610,-64,A04,2,Mate,White
TRUE,40,10+10,1566,1535,31,D00,3,Mate,Black
TRUE,51,8+5,1523,1545,-22,B20,3,Mate,White
TRUE,50,10+8,1557,1526,31,D02,3,Resign,Black
TRUE,75,8+0,1590,1556,34,B94,11,Draw,Draw
TRUE,65,8+0,1522,1567,-45,B20,3,Resign,White
TRUE,66,8+0,1577,1596,-19,D41,9,Resign,Black
TRUE,135,8+0,1579,1525,54,A01,2,Draw,Draw
TRUE,111,8+0,1632,1588,44,D15,7,Resign,White
TRUE,48,7+3,1627,1576,51,A40,1,Mate,Black
TRUE,96,7+3,1585,1616,-31,A06,3,Resign,Black
TRUE,144,8+0,1519,1577,-58,B11,4,Mate,Black
FALSE,73,60+0,2032,1719,313,D45,9,Resign,White
TRUE,44,15+0,1118,1482,-364,C00,3,Mate,Black
TRUE,62,12+0,1120,1775,-655,C68,8,Mate,Black
TRUE,84,25+0,1143,1128,15,B29,5,Mate,Black
TRUE,63,10+7,1051,1363,-312,C48,7,Mate,White
TRUE,107,10+0,1684,1053,631,C77,9,Out of Time,White
TRUE,59,10+5,1012,1222,-210,C41,5,Mate,White
FALSE,83,60+0,1500,1012,488,C44,5,Resign,White
TRUE,40,15+0,1028,1097,-69,C40,4,Mate,Black
TRUE,77,4+6,1442,1034,408,C24,4,Mate,White
FALSE,84,30+10,1347,1034,313,C44,5,Mate,Black
FALSE,41,10+0,1500,1034,466,B00,5,Resign,White
FALSE,44,10+0,1034,1500,-466,B00,3,Resign,Black
TRUE,54,10+0,1405,1041,364,C65,6,Resign,White
TRUE,55,10+0,1054,1303,-249,B00,2,Resign,Black
TRUE,71,10+5,1580,1058,522,C20,3,Resign,White
TRUE,17,10+0,1467,1372,95,C64,6,Resign,White
TRUE,64,15+15,1381,1401,-20,C57,8,Resign,Black
TRUE,90,10+10,1042,1381,-339,A20,2,Resign,Black
FALSE,25,15+0,1500,1381,119,C53,9,Resign,White
FALSE,139,7+2,1510,1381,129,C20,3,Mate,White
FALSE,127,7+2,1381,1372,9,B06,2,Mate,White
FALSE,72,7+2,1381,1510,-129,C41,4,Mate,Black
FALSE,9,8+1,1288,1381,-93,D01,4,Resign,White
FALSE,44,5+5,1381,1722,-341,B40,4,Mate,Black
TRUE,52,10+10,1392,1437,-45,B00,4,Resign,Black
TRUE,121,10+10,1635,1397,238,C50,6,Mate,White
TRUE,130,15+15,1405,1548,-143,C50,6,Mate,Black
FALSE,30,10+10,1406,1405,1,C45,7,Resign,White
FALSE,76,15+3,1405,1785,-380,C00,3,Mate,Black
FALSE,46,30+8,1728,1405,323,C44,4,Mate,Black
FALSE,99,15+3,1505,1405,100,C42,5,Mate,White
FALSE,18,10+5,1405,1550,-145,C00,3,Resign,Black
FALSE,76,30+0,1500,1405,95,C22,8,Resign,Black
TRUE,50,19+19,1340,1420,-80,C20,4,Resign,White
TRUE,45,10+0,1432,1451,-19,C40,4,Resign,Black
TRUE,20,10+0,1448,1340,108,C41,4,Resign,Black
TRUE,59,10+0,1715,1453,262,C50,6,Resign,White
TRUE,47,10+0,1450,1121,329,C46,7,Resign,White
TRUE,59,10+0,1715,1455,260,C51,8,Mate,White
TRUE,57,10+0,1096,1478,-382,D00,5,Resign,White
TRUE,54,10+0,1480,1847,-367,B20,3,Out of Time,Black
TRUE,35,10+0,1932,1482,450,C30,3,Resign,White
TRUE,20,10+0,1390,1473,-83,C50,11,Resign,Black
TRUE,106,10+0,1486,1451,35,C50,5,Mate,Black
TRUE,33,10+0,1484,1088,396,C41,4,Mate,White
TRUE,96,10+0,1319,1477,-158,D02,4,Out of Time,Black
TRUE,23,10+1,1461,1553,-92,B20,3,Resign,White
TRUE,60,10+0,1481,1225,256,C42,5,Mate,Black
TRUE,63,10+0,1890,1483,407,C30,3,Mate,White
TRUE,44,10+0,1387,1499,-112,C46,7,Resign,White
TRUE,131,10+0,1892,1475,417,C50,8,Mate,White
TRUE,56,10+0,1602,1888,-286,A48,5,Resign,Black
TRUE,51,10+0,1886,1464,422,C00,3,Mate,White
TRUE,137,10+0,1907,1898,9,C02,9,Mate,White
TRUE,93,10+0,1822,1934,-112,E76,9,Out of Time,White
TRUE,66,10+0,1946,1955,-9,B30,4,Mate,Black
TRUE,159,10+0,1722,1976,-254,C00,3,Mate,White
TRUE,27,10+0,1971,1711,260,A43,2,Resign,White
TRUE,95,10+0,1878,1987,-109,A00,1,Mate,White
TRUE,51,10+0,1983,1699,284,D06,4,Mate,White
TRUE,38,10+0,1779,1976,-197,C01,5,Resign,Black
TRUE,43,10+0,1969,1834,135,D31,5,Resign,White
TRUE,77,10+0,1919,1983,-64,A00,5,Mate,White
TRUE,32,10+0,1801,1976,-175,A85,5,Resign,Black
TRUE,93,10+0,1968,1825,143,D06,4,Resign,White
TRUE,34,10+0,1842,1960,-118,A84,4,Resign,Black
TRUE,81,10+0,1950,1849,101,A40,2,Resign,White
TRUE,30,10+0,2012,1934,78,C07,6,Resign,Black
TRUE,65,8+2,1909,1406,503,D02,4,Resign,White
FALSE,48,5+8,1500,1909,-409,C02,6,Resign,Black
TRUE,55,8+0,1904,1498,406,D05,9,Resign,White
FALSE,43,5+8,1904,1500,404,D05,6,Resign,White
TRUE,61,5+5,1903,1302,601,D02,3,Resign,White
TRUE,20,5+5,1571,1897,-326,C11,7,Resign,Black
TRUE,52,8+0,1941,1362,579,A40,2,Resign,Black
TRUE,74,5+8,1356,1939,-583,C02,6,Mate,Black
TRUE,74,5+8,1293,1938,-645,A00,4,Resign,Black
TRUE,26,5+8,1471,1935,-464,C00,2,Resign,Black
TRUE,57,5+8,1931,1475,456,D02,3,Out of Time,White
FALSE,26,30+6,1675,1656,19,D06,4,Resign,Black
FALSE,57,30+6,1675,1716,-41,D82,7,Mate,White
TRUE,112,5+5,2123,2219,-96,B12,7,Mate,Black
TRUE,35,5+5,2210,2131,79,A00,1,Resign,White
TRUE,69,10+10,2110,2395,-285,C65,6,Resign,White
TRUE,83,10+0,1585,2131,-546,B07,2,Resign,White
TRUE,58,10+0,1655,2130,-475,E60,5,Resign,Black
FALSE,32,10+0,1190,1500,-310,C40,4,Mate,Black
FALSE,9,10+0,1500,1190,310,C20,3,Mate,White
FALSE,52,10+0,1190,1500,-310,C40,4,Resign,Black
FALSE,19,10+0,1500,1190,310,C20,3,Mate,White
FALSE,20,10+0,1190,1257,-67,C44,5,Resign,Black
FALSE,35,10+0,1500,1190,310,C65,6,Resign,White
FALSE,21,10+0,1190,1500,-310,C46,6,Mate,White
FALSE,33,10+0,1500,1190,310,C42,7,Resign,White
FALSE,88,10+0,1332,1190,142,C44,4,Mate,Black
TRUE,40,10+0,1190,2133,-943,C46,5,Resign,Black
TRUE,14,10+0,1205,1349,-144,B07,5,Resign,Black
TRUE,7,10+0,1500,1213,287,C20,3,Resign,White
TRUE,12,10+0,1214,1964,-750,C41,4,Resign,Black
TRUE,67,10+0,1460,1224,236,B27,3,Mate,White
TRUE,54,10+0,1237,1431,-194,C46,7,Mate,Black
TRUE,49,10+0,1425,1252,173,C42,4,Resign,White
FALSE,72,10+0,1252,1319,-67,C40,4,Mate,Black
FALSE,24,10+0,1252,1500,-248,B27,4,Resign,Black
FALSE,55,10+0,1252,1500,-248,C41,5,Resign,Black
FALSE,23,10+0,1340,1252,88,C55,7,Resign,White
TRUE,27,10+0,1272,1381,-109,C46,5,Resign,Black
TRUE,9,10+0,1345,1297,48,D20,5,Resign,White
TRUE,28,10+0,1328,1300,28,C00,5,Resign,Black
TRUE,80,10+0,1256,1294,-38,C20,3,Out of Time,Black
TRUE,58,10+0,1399,1233,166,C65,6,Mate,Black
TRUE,27,10+0,1159,1414,-255,C40,3,Mate,White
TRUE,9,10+0,1476,1173,303,C20,3,Mate,White
TRUE,60,10+0,1189,1471,-282,C41,7,Resign,Black
TRUE,82,10+0,1205,1500,-295,C46,7,Resign,Black
TRUE,17,10+0,1450,1231,219,C20,3,Resign,White
TRUE,7,10+0,1444,1264,180,C20,3,Resign,White
TRUE,44,10+0,1313,1437,-124,B01,2,Mate,Black
TRUE,25,10+0,1340,1426,-86,C20,3,Mate,White
TRUE,65,10+0,1292,1339,-47,C27,3,Mate,White
TRUE,69,10+0,1421,1500,-79,C42,6,Resign,White
TRUE,53,12+10,1821,2236,-415,B30,4,Resign,Black
TRUE,55,15+0,2225,2015,210,E59,19,Resign,White
TRUE,40,12+10,1843,2220,-377,A46,5,Mate,Black
TRUE,86,7+2,1541,2219,-678,D01,5,Resign,Black
TRUE,47,12+10,1936,2236,-300,C17,9,Resign,Black
TRUE,16,12+10,2233,1772,461,A91,8,Resign,White
TRUE,29,12+10,2209,2030,179,A04,2,Resign,White
TRUE,27,12+10,2209,1320,889,B00,6,Mate,White
TRUE,74,12+10,1900,2200,-300,B20,3,Mate,Black
TRUE,39,12+10,1856,2192,-336,B56,10,Resign,Black
TRUE,50,12+10,1818,2185,-367,B50,4,Resign,Black
TRUE,53,12+10,2182,1688,494,D31,5,Resign,White
TRUE,40,12+10,1690,2178,-488,B10,2,Resign,Black
TRUE,21,12+10,2174,1692,482,D02,4,Resign,White
TRUE,40,12+10,1957,2151,-194,B21,6,Resign,Black
TRUE,17,12+10,1741,2145,-404,B20,3,Resign,Black
TRUE,61,12+10,2191,1599,592,D02,5,Mate,White
TRUE,19,12+10,2181,1830,351,C60,6,Resign,White
TRUE,62,12+10,1640,2177,-537,C02,10,Resign,Black
TRUE,45,12+10,2174,1641,533,D21,6,Resign,White
TRUE,44,12+10,1439,2172,-733,A00,1,Mate,Black
TRUE,38,12+10,1959,2151,-192,E20,7,Mate,Black
TRUE,43,12+10,2138,1819,319,E94,14,Resign,White
TRUE,14,12+10,1822,2123,-301,B57,12,Resign,Black
TRUE,23,12+10,2123,1108,1015,A50,4,Mate,White
TRUE,41,12+10,2119,1571,548,D30,7,Mate,White
TRUE,118,12+10,1968,2083,-115,D00,4,Out of Time,Black
TRUE,58,12+10,2069,1707,362,D31,5,Resign,White
FALSE,43,10+10,2016,2069,-53,B20,3,Resign,Black
TRUE,66,10+10,2076,1990,86,A06,3,Resign,Black
TRUE,51,8+0,1979,1537,442,B01,4,Mate,White
TRUE,72,8+0,2071,2002,69,C01,4,Resign,Black
TRUE,69,15+0,1999,1890,109,D07,5,Resign,White
TRUE,32,15+0,1916,1830,86,C42,5,Mate,Black
TRUE,108,15+0,1726,1500,226,C45,13,Mate,Black
FALSE,94,15+0,1450,1500,-50,A10,1,Mate,Black
FALSE,34,15+0,1264,1500,-236,B20,3,Resign,Black
FALSE,77,15+0,2011,1500,511,B21,6,Out of Time,White
TRUE,133,10+0,2300,2198,102,D00,4,Draw,Draw
TRUE,82,10+3,2103,2294,-191,B06,2,Resign,Black
TRUE,67,10+0,2290,2004,286,D03,10,Resign,White
TRUE,80,10+0,2008,2286,-278,A80,3,Resign,Black
TRUE,68,10+0,2303,2108,195,A46,5,Resign,Black
TRUE,119,10+0,2299,2015,284,D02,5,Mate,White
TRUE,95,10+0,2270,2312,-42,B12,3,Resign,White
TRUE,46,5+5,2321,2300,21,A00,2,Out of Time,Black
TRUE,47,5+5,2287,2335,-48,A40,2,Resign,White
TRUE,41,10+0,2225,2301,-76,C01,5,Resign,White
TRUE,65,12+9,2179,2317,-138,D20,4,Resign,White
TRUE,61,10+0,2305,2311,-6,D02,3,Out of Time,White
TRUE,144,10+0,2074,2300,-226,D20,4,Resign,Black
TRUE,105,9+3,2290,2235,55,B06,7,Resign,White
TRUE,43,10+0,2287,1956,331,D02,3,Mate,White
TRUE,20,10+0,1959,2283,-324,B06,2,Resign,Black
TRUE,89,10+0,2279,2037,242,A45,2,Resign,White
TRUE,55,8+0,2267,2247,20,A45,2,Resign,White
TRUE,101,5+5,2320,2278,42,C03,5,Resign,White
TRUE,83,10+0,2274,2004,270,D02,3,Resign,White
TRUE,102,5+5,2282,2393,-111,A46,4,Resign,Black
TRUE,66,6+5,2293,2326,-33,A45,2,Resign,Black
TRUE,45,3+8,2000,2289,-289,C89,28,Resign,Black
FALSE,161,5+5,2280,2276,4,A01,2,Resign,White
TRUE,62,5+5,2293,2264,29,B06,7,Resign,Black
TRUE,81,5+5,2280,2303,-23,A43,4,Resign,White
TRUE,52,5+5,2291,2342,-51,A45,2,Resign,Black
TRUE,46,7+7,2052,2286,-234,D20,5,Mate,Black
TRUE,46,10+0,2255,2274,-19,D00,3,Mate,Black
TRUE,27,10+0,2270,1968,302,A40,6,Resign,White
TRUE,68,10+0,1941,2266,-325,D20,4,Resign,Black
TRUE,53,10+0,2264,1842,422,C66,8,Mate,White
TRUE,70,10+0,1902,2261,-359,C65,6,Resign,Black
TRUE,32,10+5,2163,2252,-89,D20,5,Resign,Black
TRUE,71,10+0,2249,1877,372,D25,7,Resign,White
TRUE,59,5+5,2362,2245,117,B06,5,Draw,Draw
TRUE,44,10+0,2264,2072,192,D00,3,Resign,Black
TRUE,89,10+0,2259,2017,242,D00,3,Out of Time,White
TRUE,43,10+0,2255,2272,-17,A00,1,Resign,White
TRUE,74,5+5,2287,2070,217,D00,3,Resign,Black
TRUE,74,10+0,2007,2283,-276,B13,10,Resign,Black
TRUE,135,17+0,1537,1552,-15,C60,5,Resign,Black
TRUE,128,15+1,1354,1546,-192,C23,3,Mate,Black
TRUE,40,15+0,1629,1555,74,C41,5,Resign,White
TRUE,57,15+8,1543,1572,-29,B40,4,Mate,White
TRUE,49,15+20,1552,1607,-55,C41,4,Resign,Black
TRUE,61,15+0,1348,1569,-221,A00,1,Resign,White
TRUE,49,10+5,1446,1592,-146,B00,2,Mate,White
TRUE,69,15+1,1582,1556,26,C41,7,Resign,White
TRUE,110,7+10,1589,1721,-132,C55,7,Mate,Black
TRUE,32,8+8,1555,1601,-46,A41,2,Resign,White
TRUE,95,8+8,1591,1565,26,C41,4,Resign,White
TRUE,111,11+5,1583,1513,70,C41,5,Out of Time,White
TRUE,47,11+5,1523,1574,-51,D00,3,Resign,Black
TRUE,42,10+0,1560,1563,-3,C68,7,Resign,Black
TRUE,51,10+5,1553,1552,1,C00,3,Mate,White
FALSE,66,5+10,1500,1731,-231,C00,4,Mate,Black
FALSE,29,9+15,1500,1461,39,B20,3,Resign,Black
FALSE,79,9+15,1464,1500,-36,B07,4,Mate,White
FALSE,82,9+15,1500,1461,39,D02,4,Resign,Black
FALSE,169,30+0,1631,1500,131,A00,1,Resign,White
FALSE,58,9+7,1500,1606,-106,C27,3,Mate,Black
FALSE,41,5+5,1704,1500,204,B00,3,Mate,White
FALSE,48,4+7,1856,1500,356,C44,5,Resign,White
FALSE,86,4+7,1500,1693,-193,C46,6,Mate,Black
TRUE,52,8+1,1380,1236,144,A40,3,Mate,Black
TRUE,44,5+5,1037,1377,-340,D00,4,Mate,Black
TRUE,22,5+8,1006,1375,-369,C21,3,Mate,Black
TRUE,31,10+1,1361,1429,-68,D35,6,Resign,White
TRUE,82,10+0,1345,1373,-28,C50,5,Resign,White
TRUE,28,15+0,1161,1368,-207,A00,1,Resign,Black
TRUE,39,5+5,1357,1337,20,C01,4,Mate,White
TRUE,102,12+0,1667,1723,-56,C53,12,Resign,Black
TRUE,72,15+15,1829,1807,22,B19,14,Resign,Black
TRUE,59,15+15,1816,1877,-61,D50,7,Resign,White
TRUE,57,15+15,1868,1826,42,A36,8,Out of Time,White
TRUE,29,15+15,1821,1838,-17,C00,7,Resign,White
TRUE,46,15+15,1851,1803,48,A43,4,Resign,Black
TRUE,178,15+15,1861,1910,-49,D10,5,Resign,Black
TRUE,44,15+15,1886,1836,50,C00,3,Resign,Black
TRUE,66,5+5,2102,1816,286,B50,5,Mate,Black
FALSE,34,5+5,2105,1816,289,B90,11,Resign,White
FALSE,71,5+5,1816,2105,-289,A85,5,Resign,Black
FALSE,26,5+5,2105,1816,289,C06,15,Resign,White
FALSE,90,5+5,1816,2105,-289,A85,5,Resign,Black
TRUE,60,5+5,2052,1797,255,A43,2,Resign,Black
TRUE,37,5+5,2047,1802,245,B13,7,Resign,White
TRUE,60,5+5,1807,2042,-235,C89,22,Resign,Black
TRUE,23,10+0,1883,1816,67,B13,5,Resign,White
TRUE,55,4+6,1810,1623,187,C62,6,Resign,White
TRUE,36,8+5,1816,1995,-179,B90,11,Resign,Black
TRUE,121,8+5,1988,1823,165,C53,9,Resign,White
TRUE,80,15+5,1828,2052,-224,B35,14,Resign,Black
TRUE,121,8+5,1809,2059,-250,B90,11,Resign,White
TRUE,24,6+8,1970,1816,154,C02,7,Resign,White
TRUE,24,6+8,1824,1962,-138,B32,8,Resign,Black
TRUE,48,20+2,1828,2072,-244,B12,5,Resign,Black
TRUE,104,15+15,1864,1827,37,D50,7,Draw,Draw
TRUE,135,10+0,1788,1892,-104,D02,3,Mate,White
TRUE,132,10+0,1768,1896,-128,B40,6,Draw,Draw
TRUE,67,10+0,1888,1776,112,D86,13,Resign,White
TRUE,39,10+0,1760,1904,-144,C78,9,Resign,White
TRUE,90,10+0,1756,1897,-141,C50,9,Out of Time,Black
TRUE,96,10+3,1910,1849,61,D35,7,Resign,Black
TRUE,165,10+0,1539,1920,-381,B32,6,Draw,Draw
TRUE,74,10+0,1611,1914,-303,B20,3,Mate,Black
TRUE,113,10+0,1910,1658,252,A85,5,Resign,White
TRUE,102,10+0,1449,1908,-459,B32,6,Out of Time,Black
TRUE,107,10+0,1726,1354,372,C42,6,Mate,White
TRUE,64,10+0,1401,1717,-316,D00,3,Resign,Black
TRUE,85,10+0,1704,1500,204,C50,5,Out of Time,White
TRUE,74,5+30,1035,1703,-668,C22,7,Resign,Black
FALSE,93,10+0,1703,1500,203,C57,11,Mate,White
FALSE,142,10+0,1500,1703,-203,C68,9,Mate,Black
FALSE,79,10+0,1703,1500,203,C42,7,Out of Time,White
TRUE,37,10+0,1141,1762,-621,C33,5,Resign,White
TRUE,42,5+8,1145,1760,-615,C48,7,Resign,Black
TRUE,23,5+5,1758,1166,592,C50,6,Resign,White
FALSE,100,0+30,1466,1501,-35,C50,8,Mate,Black
TRUE,61,10+0,1983,1500,483,C44,5,Mate,White
TRUE,137,180+180,1337,1662,-325,A00,1,Resign,White
TRUE,59,180+180,1500,1500,0,C20,3,Mate,White
TRUE,50,9+10,2003,1985,18,C62,6,Resign,Black
TRUE,37,9+10,1979,1826,153,C70,8,Resign,White
TRUE,63,9+10,1969,1928,41,B12,5,Mate,White
TRUE,52,9+10,1984,1857,127,B57,8,Resign,Black
TRUE,53,9+10,1976,1875,101,C50,6,Mate,White
TRUE,57,9+10,1860,1991,-131,C68,7,Mate,White
TRUE,81,9+10,1984,1846,138,C50,5,Out of Time,White
TRUE,46,9+10,1848,1977,-129,C55,11,Out of Time,Black
TRUE,23,9+8,1969,1871,98,B01,4,Resign,White
TRUE,74,9+8,1947,1958,-11,C44,9,Resign,Black
TRUE,23,9+8,1947,1958,-11,C23,4,Resign,White
FALSE,34,30+0,1500,1947,-447,C42,4,Mate,Black
FALSE,32,30+0,1500,1947,-447,C20,3,Resign,Black
FALSE,26,30+0,1500,1947,-447,C20,3,Out of Time,Black
TRUE,122,15+0,1946,1976,-30,C55,6,Draw,Draw
TRUE,81,15+0,1965,1957,8,B30,5,Resign,White
TRUE,87,5+30,1964,2087,-123,B06,5,Resign,Black
TRUE,58,9+8,1837,1956,-119,A28,7,Resign,Black
TRUE,152,10+3,1837,1948,-111,B30,4,Resign,Black
TRUE,34,12+5,1929,1938,-9,B30,4,Resign,Black
TRUE,74,9+8,1994,1924,70,B20,3,Resign,Black
TRUE,70,9+8,1935,1924,11,B32,7,Resign,Black
TRUE,48,9+8,1938,1923,15,B23,5,Resign,Black
TRUE,94,9+8,1935,1924,11,B46,10,Mate,Black
TRUE,51,9+8,1938,1923,15,B23,4,Resign,Black
TRUE,21,9+8,1913,1849,64,B32,8,Resign,White
TRUE,42,9+8,1901,1918,-17,C55,8,Resign,White
TRUE,89,9+8,1891,1832,59,C55,6,Mate,White
TRUE,78,9+8,1842,1881,-39,B30,5,Resign,Black
TRUE,73,9+8,1870,1839,31,C41,5,Resign,White
TRUE,53,9+8,1860,1801,59,C41,6,Resign,White
TRUE,74,9+8,1871,1878,-7,C00,3,Out of Time,Black
TRUE,43,9+8,1793,1862,-69,A02,1,Resign,Black
TRUE,93,9+8,1864,1786,78,B44,9,Draw,Draw
TRUE,111,9+8,1770,1880,-110,D30,6,Resign,White
TRUE,82,9+8,1891,1910,-19,C54,13,Mate,Black
TRUE,63,9+8,1882,1775,107,B44,9,Mate,White
TRUE,58,9+8,1729,1874,-145,D05,6,Resign,Black
TRUE,61,10+2,1863,1818,45,B29,5,Resign,White
TRUE,92,9+8,1876,1869,7,C53,7,Resign,Black
TRUE,34,9+8,1865,1804,61,B02,4,Resign,White
TRUE,70,15+8,1754,1856,-102,B20,3,Resign,Black
TRUE,70,15+10,1842,1858,-16,C58,11,Resign,White
TRUE,50,15+8,1603,1836,-233,C11,7,Resign,Black
TRUE,19,15+8,1830,1609,221,B07,4,Mate,White
TRUE,65,7+9,1273,1477,-204,A00,1,Resign,White
TRUE,196,7+9,1285,1271,14,A00,1,Mate,Black
TRUE,138,7+9,1295,1361,-66,A00,1,Mate,Black
TRUE,114,7+9,1299,1580,-281,A00,1,Resign,Black
TRUE,111,7+9,1285,1336,-51,A00,1,Resign,White
TRUE,135,7+9,1283,1351,-68,A00,1,Draw,Draw
TRUE,45,7+9,1264,1520,-256,A00,1,Resign,White
TRUE,35,7+9,1251,1302,-51,A00,1,Resign,White
TRUE,54,7+9,1262,1289,-27,A00,1,Resign,Black
TRUE,104,7+9,1276,1201,75,A00,1,Mate,Black
TRUE,70,7+9,1285,1362,-77,A00,1,Mate,Black
TRUE,84,7+9,1287,1702,-415,A00,1,Mate,Black
TRUE,86,7+9,1289,1701,-412,A00,1,Resign,Black
TRUE,209,7+9,1272,1469,-197,A00,1,Out of Time,White
TRUE,118,7+9,1276,1512,-236,A00,1,Mate,Black
TRUE,94,7+9,1285,1371,-86,A00,1,Mate,Black
TRUE,89,7+9,1267,1484,-217,A00,1,Resign,White
TRUE,165,7+9,1264,1368,-104,A00,1,Draw,Draw
TRUE,48,7+9,1272,1378,-106,C20,3,Mate,Black
TRUE,102,7+9,1265,1503,-238,B01,4,Draw,Draw
TRUE,142,7+9,1256,1785,-529,A00,1,Mate,Black
TRUE,80,7+9,1267,1270,-3,A00,1,Resign,Black
TRUE,46,7+9,1271,1433,-162,A00,1,Out of Time,Black
TRUE,38,7+9,1282,1261,21,A00,1,Resign,Black
TRUE,58,7+9,1289,1415,-126,A00,1,Mate,Black
TRUE,68,7+9,1301,1291,10,A00,1,Mate,Black
TRUE,120,7+9,1307,1524,-217,A00,1,Mate,Black
TRUE,94,7+9,1295,1328,-33,A00,1,Resign,White
TRUE,130,7+9,1297,1655,-358,A00,1,Mate,Black
TRUE,167,7+9,1296,1341,-45,A00,1,Draw,Draw
TRUE,76,7+9,1297,1830,-533,A00,1,Mate,Black
TRUE,72,7+9,1303,1480,-177,A00,1,Resign,Black
TRUE,80,7+9,1290,1337,-47,A00,1,Resign,White
TRUE,104,7+9,1297,1464,-167,A00,1,Resign,Black
TRUE,48,7+9,1298,1801,-503,C00,3,Resign,Black
TRUE,36,7+9,1307,1389,-82,C20,3,Resign,Black
TRUE,144,7+9,1309,1737,-428,A00,1,Mate,Black
TRUE,110,7+9,1320,1309,11,A00,1,Mate,Black
TRUE,44,7+9,1330,1385,-55,A00,1,Mate,Black
TRUE,132,7+9,1343,1284,59,A00,1,Mate,Black
TRUE,53,7+9,1329,1427,-98,A00,1,Mate,White
TRUE,100,7+9,1341,1323,18,C20,3,Resign,Black
TRUE,85,7+9,1332,1252,80,A00,1,Resign,White
TRUE,80,7+9,1338,1527,-189,A00,1,Mate,Black
TRUE,36,7+9,1346,1456,-110,A00,1,Resign,Black
TRUE,25,7+9,1333,1376,-43,A00,1,Resign,White
TRUE,156,7+9,1345,1347,-2,A00,1,Mate,Black
TRUE,72,7+9,1341,1053,288,A00,1,Resign,White
FALSE,58,10+5,1484,1711,-227,A00,1,Mate,Black
TRUE,65,10+0,1617,1563,54,B09,11,Resign,White
TRUE,88,10+0,1574,1607,-33,B20,3,Mate,Black
TRUE,45,2+10,1612,1618,-6,B20,3,Resign,White
TRUE,107,7+2,1657,1636,21,A21,4,Resign,Black
TRUE,63,10+3,1657,1640,17,A10,2,Draw,Draw
TRUE,34,10+0,1991,1984,7,C10,5,Resign,Black
FALSE,110,7+2,1991,2073,-82,B01,4,Draw,Draw
TRUE,113,10+0,2100,2212,-112,B94,11,Resign,White
FALSE,29,20+60,2260,2212,48,B78,20,Out of Time,White
TRUE,65,10+0,2200,2188,12,B19,15,Resign,White
TRUE,45,10+0,2182,2201,-19,D78,12,Draw,Draw
TRUE,28,10+0,2213,2224,-11,B34,9,Resign,Black
TRUE,30,10+0,2089,2218,-129,B78,20,Draw,Draw
TRUE,73,10+0,2223,2084,139,D11,7,Draw,Draw
TRUE,23,10+0,2213,2105,108,D13,8,Out of Time,White
TRUE,45,10+0,2205,2072,133,B48,11,Resign,White
TRUE,59,10+0,2201,1835,366,B94,11,Mate,White
TRUE,73,10+0,2197,1875,322,A45,2,Mate,White
TRUE,58,10+0,2148,2185,-37,A03,2,Resign,Black
TRUE,57,10+0,2200,2183,17,C14,13,Resign,White
FALSE,43,15+5,2334,1346,988,B00,3,Mate,White
TRUE,29,2+10,1368,1239,129,A00,1,Resign,White
TRUE,9,8+0,1446,1247,199,B20,3,Resign,White
TRUE,86,8+7,1260,1326,-66,A28,7,Resign,Black
TRUE,52,15+3,1233,1500,-267,A21,4,Resign,White
TRUE,75,15+3,1491,1240,251,C02,5,Resign,White
FALSE,91,15+5,1240,1312,-72,C20,3,Resign,White
TRUE,75,10+0,1548,1245,303,C02,5,Resign,White
TRUE,27,10+0,1232,1547,-315,D10,4,Draw,Draw
TRUE,77,10+0,1188,1245,-57,C20,3,Mate,White
TRUE,16,10+0,1517,1193,324,B07,4,Resign,White
FALSE,8,5+10,1193,1430,-237,B01,2,Out of Time,White
TRUE,77,20+5,1351,1204,147,C00,3,Resign,White
TRUE,22,20+0,1209,1581,-372,B28,5,Resign,Black
TRUE,53,15+10,1369,1221,148,A40,2,Mate,White
TRUE,22,45+0,1227,1524,-297,B06,2,Resign,Black
TRUE,42,2+20,1634,1231,403,C02,5,Resign,White
TRUE,66,6+30,1236,1618,-382,B10,3,Resign,Black
TRUE,105,20+0,1353,1251,102,C00,2,Mate,White
TRUE,157,20+0,1220,1368,-148,C20,3,Mate,White
TRUE,17,20+0,1361,1235,126,C00,2,Mate,White
TRUE,47,45+0,1456,1246,210,C02,5,Mate,White
TRUE,6,4+6,1254,1543,-289,B10,3,Resign,Black
TRUE,16,4+6,1265,1501,-236,C44,5,Resign,Black
TRUE,47,4+6,1829,1267,562,C01,5,Resign,White
TRUE,24,4+6,1269,1828,-559,B10,2,Resign,Black
TRUE,49,15+0,1596,1277,319,E00,4,Mate,White
FALSE,12,30+30,1427,1236,191,C20,4,Resign,White
TRUE,13,20+0,1291,1368,-77,C20,4,Resign,White
TRUE,68,35+35,1450,1637,-187,C15,6,Mate,Black
TRUE,16,10+0,2081,2095,-14,B21,3,Resign,Black
TRUE,14,10+0,1653,2079,-426,C42,5,Mate,Black
TRUE,85,10+0,2076,2123,-47,B08,8,Draw,Draw
TRUE,60,10+0,1917,2069,-152,D30,7,Resign,Black
TRUE,94,10+0,1986,2059,-73,B21,3,Resign,Black
TRUE,31,10+0,2051,1941,110,C10,6,Mate,White
TRUE,95,10+0,2041,1987,54,C62,6,Resign,White
TRUE,24,10+0,1900,2034,-134,E20,6,Mate,Black
TRUE,52,10+0,2007,2023,-16,B20,3,Resign,Black
TRUE,33,10+0,2015,1876,139,A10,1,Resign,White
TRUE,95,10+0,2184,1998,186,D36,11,Resign,Black
TRUE,21,10+0,1992,1765,227,A30,2,Resign,White
TRUE,84,10+0,2083,1977,106,B62,13,Resign,Black
TRUE,23,10+0,1970,1823,147,A04,2,Resign,White
TRUE,24,10+0,1746,1989,-243,B56,10,Resign,White
TRUE,59,10+0,1975,2034,-59,D76,14,Resign,White
TRUE,89,10+0,1988,1987,1,B50,4,Resign,White
TRUE,24,10+0,1905,1977,-72,B56,10,Resign,Black
TRUE,75,10+0,1974,1636,338,B10,2,Mate,White
TRUE,37,10+0,1973,1399,574,B01,8,Resign,White
TRUE,48,10+0,1613,1970,-357,D00,2,Mate,Black
TRUE,49,10+0,1963,1837,126,C40,6,Resign,White
TRUE,76,10+0,1612,1960,-348,A00,1,Mate,Black
TRUE,41,10+0,1955,1696,259,D25,7,Resign,White
TRUE,49,10+0,1943,1983,-40,A46,4,Mate,White
TRUE,85,10+0,1933,1881,52,A04,2,Mate,White
TRUE,171,10+0,1894,1946,-52,D15,8,Out of Time,White
TRUE,72,10+0,2121,1929,192,B21,3,Resign,Black
TRUE,91,10+0,1916,1943,-27,C45,7,Resign,White
TRUE,40,10+0,1550,1913,-363,B02,4,Resign,Black
TRUE,32,10+0,1963,1924,39,B02,4,Resign,White
TRUE,45,10+0,1907,2051,-144,D08,7,Mate,White
TRUE,119,10+0,1961,1905,56,D00,3,Draw,Draw
TRUE,57,10+0,1899,1702,197,A08,4,Resign,White
TRUE,66,10+0,1902,1886,16,B02,5,Mate,Black
TRUE,65,10+0,1881,1671,210,B01,6,Mate,White
TRUE,49,10+0,1875,1680,195,B00,2,Mate,White
TRUE,74,10+0,1871,1500,371,A04,2,Resign,White
TRUE,124,10+0,2106,1852,254,E34,8,Mate,Black
TRUE,125,10+0,1844,2110,-266,A57,6,Draw,Draw
TRUE,111,10+4,1500,1262,238,D06,4,Mate,White
TRUE,60,15+0,1780,1846,-66,C00,3,Resign,Black
TRUE,65,15+0,1750,1863,-113,A00,1,Resign,White
TRUE,70,15+0,1628,1857,-229,B20,3,Mate,Black
TRUE,151,15+0,1841,1929,-88,B40,4,Mate,White
TRUE,120,15+0,1624,1835,-211,B80,10,Out of Time,Black
TRUE,82,15+0,1301,1123,178,A00,1,Mate,Black
TRUE,33,15+0,1395,1309,86,B00,4,Mate,White
TRUE,39,10+5,1300,1321,-21,A40,2,Mate,White
TRUE,91,10+4,1328,1429,-101,A00,1,Resign,Black
TRUE,79,10+1,1415,1337,78,C00,2,Out of Time,White
TRUE,51,15+0,1502,1343,159,C00,4,Mate,White
TRUE,96,30+10,1320,1333,-13,C00,3,Resign,Black
TRUE,39,30+10,1345,1308,37,A00,1,Resign,Black
TRUE,53,20+0,1339,1177,162,A00,1,Mate,White
TRUE,86,8+5,1349,1368,-19,A00,1,Resign,Black
TRUE,34,8+5,1380,1337,43,C00,3,Resign,Black
TRUE,46,30+10,1173,1331,-158,C01,4,Resign,Black
TRUE,17,10+6,1327,1211,116,A00,1,Resign,White
TRUE,69,10+0,1313,1339,-26,B00,5,Mate,White
TRUE,38,10+2,1351,1298,53,A00,1,Mate,Black
TRUE,48,10+0,1292,1342,-50,C48,8,Resign,Black
TRUE,87,8+10,1480,1349,131,C60,6,Resign,White
TRUE,56,8+10,1357,1472,-115,A00,1,Resign,Black
TRUE,52,60+0,1295,1347,-52,A00,1,Mate,Black
TRUE,61,10+2,1570,1352,218,C00,3,Draw,Draw
TRUE,36,10+2,1357,1565,-208,A00,1,Mate,Black
TRUE,59,10+10,1427,1343,84,C00,3,Resign,Black
TRUE,85,10+0,1486,1350,136,A00,1,Mate,White
TRUE,33,15+0,1325,1362,-37,A40,2,Mate,White
TRUE,67,15+5,1627,1366,261,C00,3,Resign,White
TRUE,16,8+0,1421,1354,67,C00,3,Resign,Black
TRUE,66,10+10,1277,1345,-68,C00,3,Resign,Black
TRUE,45,15+1,1377,1355,22,C01,4,Mate,White
TRUE,38,5+5,1365,1388,-23,A00,1,Mate,Black
TRUE,54,8+0,1459,1351,108,A00,1,Mate,Black
TRUE,47,30+0,1340,1341,-1,D00,3,Mate,White
TRUE,88,8+8,1353,1288,65,D00,4,Resign,Black
TRUE,25,9+0,1317,1343,-26,A10,2,Resign,Black
TRUE,115,6+5,1418,1343,75,C00,2,Out of Time,White
TRUE,50,15+0,1354,1360,-6,D00,4,Mate,Black
TRUE,53,15+5,1373,1357,16,B01,4,Resign,White
TRUE,102,10+8,1363,1238,125,D00,5,Resign,Black
TRUE,52,20+0,1254,1354,-100,B02,3,Resign,Black
TRUE,55,3+20,1179,1371,-192,A00,1,Mate,White
TRUE,46,5+10,1381,1359,22,A04,2,Out of Time,Black
TRUE,56,7+3,1374,1272,102,D00,3,Mate,Black
TRUE,109,8+0,1639,1656,-17,B40,4,Out of Time,White
TRUE,35,15+0,1641,1490,151,A00,1,Mate,White
TRUE,63,15+0,1636,1260,376,A00,1,Mate,White
TRUE,20,20+0,1625,1378,247,A00,1,Resign,White
TRUE,59,5+5,1845,1638,207,B00,3,Mate,White
TRUE,64,5+5,1654,1839,-185,D45,9,Mate,Black
TRUE,70,5+5,1696,1563,133,A00,1,Mate,Black
TRUE,130,10+0,1661,1664,-3,A45,2,Mate,Black
TRUE,78,10+0,1630,1642,-12,A49,4,Mate,Black
TRUE,76,10+0,1284,1639,-355,B08,8,Mate,Black
TRUE,36,10+0,1636,1260,376,B23,3,Resign,White
TRUE,37,10+0,1629,1450,179,C40,3,Resign,White
TRUE,31,10+0,1615,1673,-58,C34,6,Mate,White
TRUE,117,10+0,1666,1626,40,B07,2,Mate,White
TRUE,60,15+10,864,1651,-787,C42,6,Resign,White
TRUE,29,15+10,1650,864,786,B13,7,Resign,White
TRUE,51,20+0,1305,1671,-366,B21,3,Resign,White
TRUE,39,20+0,1669,1308,361,C55,6,Mate,White
TRUE,89,10+0,1591,1671,-80,B07,2,Draw,Draw
TRUE,85,15+15,1632,1684,-52,B07,2,Resign,White
TRUE,61,15+15,1777,1693,84,B08,12,Mate,White
TRUE,126,15+15,1523,1687,-164,B07,4,Resign,Black
TRUE,15,15+15,1680,1530,150,C60,7,Mate,White
TRUE,55,15+15,1632,1693,-61,A48,5,Resign,White
TRUE,113,15+15,1711,1693,18,B08,9,Draw,Draw
TRUE,56,15+15,1708,1615,93,B21,5,Mate,Black
TRUE,30,15+15,1999,1712,287,B08,8,Resign,White
TRUE,85,15+15,1636,1727,-91,E87,13,Resign,White
TRUE,125,15+15,1743,1622,121,C02,9,Resign,Black
TRUE,48,15+15,1614,1735,-121,A45,2,Resign,Black
TRUE,65,10+0,1561,1299,262,A41,2,Mate,White
TRUE,62,10+0,1301,1687,-386,D00,2,Resign,Black
TRUE,96,10+0,1630,1305,325,C00,4,Resign,White
TRUE,36,10+0,1320,1223,97,A00,1,Mate,Black
TRUE,62,10+0,1327,1506,-179,A40,2,Out of Time,Black
TRUE,75,10+0,1517,1333,184,C44,5,Resign,White
TRUE,160,10+0,1336,1705,-369,A00,2,Mate,Black
TRUE,48,10+0,1345,1448,-103,D00,2,Resign,Black
TRUE,86,10+0,1465,1287,178,C20,3,Resign,Black
TRUE,71,10+0,1559,1292,267,C00,4,Resign,White
TRUE,57,10+0,1404,1300,104,C00,4,Mate,White
TRUE,58,10+0,1304,1646,-342,A00,1,Resign,Black
TRUE,126,10+0,1307,1631,-324,A43,2,Mate,Black
TRUE,98,10+0,1306,1325,-19,A00,1,Draw,Draw
TRUE,155,10+0,1471,1314,157,C41,6,Mate,White
TRUE,48,10+0,1266,1302,-36,A00,1,Resign,Black
TRUE,31,10+0,1291,1246,45,D00,3,Resign,White
TRUE,20,10+0,1307,1212,95,A00,2,Resign,Black
TRUE,20,10+0,1297,1308,-11,C20,3,Draw,Draw
TRUE,118,10+0,1319,1368,-49,D00,4,Mate,Black
TRUE,70,10+0,1639,1296,343,A50,3,Resign,Black
TRUE,32,10+0,1286,1730,-444,D00,2,Mate,Black
TRUE,47,10+0,1715,1289,426,B07,2,Resign,White
TRUE,103,10+0,1264,1792,-528,A00,1,Mate,White
TRUE,111,10+0,1239,1211,28,A40,2,Resign,White
TRUE,57,10+0,1455,1245,210,C00,2,Mate,White
TRUE,86,10+0,1261,1639,-378,A00,1,Resign,Black
TRUE,83,10+0,1238,1665,-427,C42,4,Out of Time,White
TRUE,25,10+0,1425,1220,205,C40,3,Resign,Black
TRUE,114,10+0,1224,1506,-282,A45,2,Resign,Black
TRUE,123,10+0,1205,1421,-216,A00,2,Out of Time,White
TRUE,65,10+0,1605,1207,398,A40,2,Mate,White
TRUE,69,10+0,1943,1207,736,C00,3,Mate,White
TRUE,74,10+0,1210,1604,-394,A00,1,Mate,Black
TRUE,51,10+0,1682,1211,471,A41,2,Mate,White
TRUE,102,10+0,1212,1946,-734,A00,2,Resign,Black
TRUE,25,10+0,1397,1218,179,C20,3,Mate,White
TRUE,43,10+0,1609,1203,406,C40,3,Mate,White
TRUE,124,10+0,1204,1170,34,D00,2,Draw,Draw
TRUE,123,10+0,1306,1212,94,A01,1,Out of Time,White
TRUE,16,10+0,1558,1882,-324,C42,9,Resign,Black
TRUE,45,10+0,1859,1895,-36,C42,9,Resign,White
TRUE,69,20+5,1951,1893,58,C42,15,Resign,White
TRUE,41,10+0,1887,1699,188,A08,4,Out of Time,White
FALSE,37,5+5,2209,1887,322,C42,9,Resign,White
TRUE,55,10+0,1725,1905,-180,C42,5,Resign,White
FALSE,71,5+8,1500,1451,49,A00,1,Mate,White
TRUE,136,10+0,1401,1618,-217,A00,1,Out of Time,Black
TRUE,74,10+0,1632,1533,99,C46,5,Resign,Black
TRUE,45,10+0,1530,1635,-105,B13,5,Draw,Draw
TRUE,50,10+0,1654,1368,286,C44,5,Resign,Black
TRUE,95,10+0,1647,1531,116,C46,5,Resign,White
TRUE,154,10+0,1494,1640,-146,A07,3,Resign,Black
TRUE,108,10+0,1539,1632,-93,C41,4,Resign,Black
TRUE,118,10+0,1820,1616,204,D15,7,Out of Time,Draw
TRUE,109,10+0,1606,1594,12,C46,6,Mate,White
TRUE,55,10+0,1594,1608,-14,D30,4,Resign,White
TRUE,115,10+0,1621,1605,16,D00,3,Mate,White
FALSE,43,30+4,1605,1593,12,C50,7,Resign,Black
TRUE,100,10+0,1589,1928,-339,B50,4,Mate,Black
TRUE,39,10+0,1581,1493,88,B02,3,Resign,White
TRUE,36,10+0,1523,1571,-48,B10,3,Resign,Black
TRUE,10,10+0,1248,1568,-320,D01,4,Resign,Black
TRUE,59,10+0,1564,1318,246,B01,4,Mate,White
TRUE,92,10+0,1582,1590,-8,C41,4,Resign,Black
TRUE,210,10+0,1600,1571,29,C41,4,Mate,Black
TRUE,83,10+0,1555,1711,-156,B25,4,Mate,White
FALSE,29,10+25,2621,1555,1066,B15,10,Out of Time,White
TRUE,120,10+0,1584,1543,41,C41,4,Mate,Black
TRUE,147,10+0,1536,1500,36,B00,5,Mate,White
TRUE,45,30+0,1594,1545,49,B17,8,Mate,White
TRUE,63,20+0,1546,1522,24,C41,4,Draw,Draw
TRUE,71,10+0,1575,1566,9,B50,4,Resign,White
TRUE,116,20+0,1562,1554,8,C41,4,Mate,Black
TRUE,40,20+0,1567,1520,47,D35,6,Resign,Black
FALSE,73,15+0,1500,1567,-67,D31,5,Out of Time,White
TRUE,107,10+0,1566,1585,-19,C46,6,Draw,Draw
FALSE,2,30+20,2430,1566,864,B10,2,Resign,White
TRUE,72,10+0,1538,1556,-18,A00,1,Mate,Black
TRUE,183,10+4,1714,1705,9,D02,4,Mate,White
TRUE,88,10+0,1587,1557,30,C55,6,Resign,Black
TRUE,14,10+0,1653,1566,87,A01,5,Resign,White
TRUE,52,10+0,1546,1579,-33,D00,8,Resign,White
TRUE,74,10+0,1596,1441,155,C41,4,Resign,Black
TRUE,25,10+0,1582,1634,-52,C41,4,Resign,White
TRUE,59,10+0,1586,1863,-277,C41,4,Resign,Black
TRUE,45,10+0,1717,1595,122,C66,8,Mate,White
TRUE,39,10+0,2029,1597,432,C44,6,Mate,White
TRUE,43,10+0,1686,1606,80,C55,6,Resign,White
TRUE,169,10+0,1604,1681,-77,C48,8,Draw,Draw
TRUE,56,10+0,1615,1623,-8,C34,6,Resign,White
TRUE,154,10+0,1628,1856,-228,C41,4,Mate,Black
FALSE,42,10+0,1319,2296,-977,C20,3,Mate,Black
FALSE,35,10+0,2296,1319,977,C23,3,Mate,White
FALSE,44,10+0,1319,2296,-977,C20,3,Mate,Black
FALSE,41,10+0,2296,1319,977,C60,5,Mate,White
TRUE,57,10+0,2294,1742,552,B27,6,Resign,White
FALSE,48,10+0,1319,2294,-975,D00,3,Mate,Black
FALSE,39,10+0,2294,1319,975,C60,5,Mate,White
FALSE,32,10+0,1319,2294,-975,A45,2,Mate,Black
FALSE,19,10+0,2294,1319,975,C45,7,Mate,White
FALSE,35,10+0,2294,1319,975,C40,4,Mate,White
FALSE,32,10+0,1319,2294,-975,D02,4,Mate,Black
FALSE,9,10+0,2294,1319,975,C42,6,Mate,White
FALSE,185,30+5,1363,1095,268,C46,7,Resign,White
FALSE,76,5+8,1095,1187,-92,C42,5,Mate,Black
TRUE,8,10+10,1175,1111,64,C20,3,Resign,White
TRUE,39,14+2,1076,1440,-364,C23,3,Resign,White
TRUE,28,15+0,1221,1088,133,C44,4,Resign,White
FALSE,46,5+30,1059,1368,-309,C41,4,Mate,Black
FALSE,56,5+30,1368,1059,309,C42,6,Mate,Black
FALSE,60,10+5,1059,1500,-441,C41,4,Resign,Black
TRUE,53,10+0,1080,1080,0,C23,4,Resign,Black
TRUE,19,15+0,1793,1081,712,C00,2,Resign,White
TRUE,43,25+0,2364,1703,661,E01,7,Resign,White
TRUE,48,25+0,1704,2363,-659,C02,9,Resign,Black
TRUE,35,60+0,2008,2358,-350,C04,8,Resign,Black
TRUE,79,5+10,2010,2353,-343,C04,8,Resign,Black
TRUE,80,8+0,1982,2348,-366,D00,4,Resign,Black
TRUE,73,8+0,2344,1984,360,D30,4,Resign,White
TRUE,70,8+0,1987,2339,-352,D00,7,Resign,Black
TRUE,90,5+8,1837,2337,-500,C01,5,Resign,Black
FALSE,52,20+15,1750,1438,312,B21,5,Mate,Black
FALSE,12,20+10,2199,1837,362,D02,4,Draw,Draw
TRUE,123,20+0,1976,1925,51,B00,2,Resign,White
TRUE,59,20+0,1687,2043,-356,A01,2,Resign,White
TRUE,98,25+8,1557,1823,-266,C24,4,Draw,Draw
TRUE,33,10+0,1831,1572,259,B01,5,Draw,Draw
FALSE,141,10+0,1767,1831,-64,A53,4,Mate,White
FALSE,62,4+9,1351,1831,-480,A45,2,Resign,Black
TRUE,32,10+5,1162,1830,-668,A40,3,Mate,Black
TRUE,187,10+0,1829,1874,-45,B01,4,Draw,Draw
TRUE,74,10+0,1772,1818,-46,C24,4,Resign,Black
TRUE,170,10+0,1827,1924,-97,B43,9,Mate,Black
TRUE,46,10+0,1805,1815,-10,C78,9,Resign,Black
TRUE,134,10+0,1818,2221,-403,C11,13,Mate,Black
TRUE,63,10+0,2162,1821,341,C53,9,Mate,White
TRUE,89,10+0,1811,1728,83,C41,8,Resign,White
TRUE,68,10+0,1531,1807,-276,C31,6,Resign,Black
TRUE,156,10+0,1847,1793,54,C31,5,Mate,Black
TRUE,26,10+0,1781,1791,-10,C41,5,Resign,White
TRUE,141,10+0,1648,1785,-137,C74,9,Out of Time,Draw
FALSE,60,60+30,2477,1785,692,C78,9,Resign,White
FALSE,41,60+30,2105,1785,320,C50,8,Resign,White
FALSE,118,60+30,1785,2105,-320,B13,5,Resign,Black
FALSE,119,90+0,2197,1785,412,C45,9,Resign,White
FALSE,106,60+30,2477,1785,692,C48,7,Resign,White
TRUE,120,5+5,1782,1874,-92,C02,11,Draw,Draw
TRUE,95,10+10,1764,1919,-155,C40,4,Mate,White
FALSE,36,15+0,2015,1764,251,C68,14,Resign,Black
TRUE,38,5+5,1858,1748,110,E76,9,Out of Time,Black
FALSE,63,20+0,1748,1841,-93,C53,9,Mate,White
TRUE,48,10+1,1090,1747,-657,C44,4,Resign,Black
FALSE,40,15+30,2443,1747,696,C78,9,Out of Time,Black
TRUE,76,10+0,1678,1737,-59,A45,3,Out of Time,Black
TRUE,103,10+0,1732,1460,272,A06,3,Mate,White
TRUE,81,10+0,1732,1752,-20,C50,6,Draw,Draw
TRUE,20,7+2,1735,2082,-347,B35,13,Resign,Black
TRUE,144,10+0,1742,1918,-176,B34,8,Mate,Black
TRUE,79,10+0,2020,1746,274,E61,6,Resign,White
TRUE,38,10+0,1878,1729,149,C78,9,Resign,Black
TRUE,51,8+0,2061,2007,54,B30,5,Mate,White
TRUE,123,8+3,1483,1500,-17,C02,5,Resign,White
TRUE,44,10+0,1539,1656,-117,C55,6,Resign,Black
TRUE,67,180+0,1301,1535,-234,B01,2,Resign,Black
TRUE,57,180+0,1530,1306,224,C41,5,Resign,White
TRUE,54,180+0,1548,1287,261,A25,4,Mate,Black
TRUE,38,180+0,1268,1566,-298,C26,5,Resign,White
TRUE,74,10+0,1576,1591,-15,C20,4,Mate,Black
TRUE,37,10+0,1572,1565,7,A20,2,Resign,Black
TRUE,62,10+0,1578,1505,73,C55,6,Resign,Black
TRUE,84,10+0,1565,1567,-2,C55,6,Mate,Black
TRUE,51,10+0,1570,1319,251,B32,8,Resign,White
TRUE,25,10+0,1925,1573,352,C55,7,Resign,White
TRUE,107,10+0,1557,1706,-149,C40,4,Resign,White
TRUE,70,10+0,1411,1549,-138,C24,4,Out of Time,Black
TRUE,137,10+0,1539,1492,47,C45,7,Resign,White
TRUE,128,10+0,1560,1185,375,B21,3,Resign,Black
TRUE,26,10+0,1144,1538,-394,C42,5,Mate,Black
TRUE,33,10+0,1931,1541,390,A80,2,Resign,White
TRUE,91,10+0,1727,1535,192,A36,5,Draw,Draw
TRUE,60,10+0,1532,1631,-99,C45,7,Draw,Draw
TRUE,66,10+0,1546,1465,81,C44,5,Resign,Black
TRUE,27,10+0,1535,1501,34,B45,9,Resign,White
TRUE,33,10+0,1769,1540,229,A00,1,Resign,White
TRUE,53,10+0,1348,1557,-209,A00,5,Mate,White
TRUE,129,10+0,1554,1651,-97,B01,6,Out of Time,Draw
FALSE,32,15+10,1554,1510,44,C45,7,Resign,Black
TRUE,52,10+0,1645,1540,105,A80,3,Mate,Black
TRUE,52,10+0,1552,1540,12,C45,7,Resign,Black
TRUE,79,10+0,1584,1562,22,C42,9,Resign,White
TRUE,79,10+0,1556,1391,165,C41,8,Mate,White
TRUE,101,10+0,1615,1565,50,C42,5,Resign,White
TRUE,33,10+0,1720,1572,148,C42,9,Resign,White
TRUE,73,10+0,1842,1577,265,C46,7,Resign,White
TRUE,89,10+0,1568,1488,80,C45,7,Resign,White
TRUE,43,10+0,1574,1758,-184,B06,2,Resign,Black
TRUE,36,10+0,1168,1572,-404,A80,3,Resign,Black
TRUE,67,10+0,1567,1317,250,C41,7,Mate,White
TRUE,74,10+0,1395,1561,-166,C26,5,Out of Time,Black
TRUE,94,10+0,1575,1474,101,C40,4,Resign,Black
TRUE,62,10+0,1554,1564,-10,C47,8,Resign,Black
TRUE,78,10+0,1581,1382,199,B01,4,Resign,Black
TRUE,93,10+0,1851,1585,266,C42,5,Resign,White
TRUE,11,10+0,1570,1724,-154,B32,7,Out of Time,White
TRUE,48,10+0,1586,1558,28,C42,4,Mate,Black
TRUE,29,10+0,1547,1517,30,B29,5,Resign,White
TRUE,74,10+0,1665,1527,138,C21,5,Resign,Black
TRUE,39,10+0,1507,1848,-341,C45,8,Resign,White
TRUE,95,10+0,1723,1512,211,C42,7,Resign,White
TRUE,34,10+0,1513,2199,-686,B33,11,Resign,Black
TRUE,32,10+0,1512,1502,10,A28,7,Mate,Black
TRUE,98,10+0,1508,1683,-175,B07,5,Resign,Black
TRUE,73,10+0,1568,1775,-207,C00,3,Resign,White
TRUE,78,15+15,1784,1852,-68,A40,1,Resign,Black
TRUE,52,10+0,1797,1740,57,B18,8,Resign,Black
TRUE,15,10+0,1793,1523,270,E61,6,Resign,White
TRUE,37,10+0,1895,1801,94,C07,6,Resign,White
TRUE,55,15+15,1859,1810,49,D30,4,Mate,White
TRUE,49,20+0,1774,1822,-48,C01,5,Mate,White
TRUE,37,10+0,1847,1832,15,D00,3,Resign,White
TRUE,30,10+0,1841,1902,-61,A52,7,Mate,Black
TRUE,48,15+15,1847,2036,-189,A51,4,Resign,Black
TRUE,47,10+0,1854,1858,-4,D00,3,Resign,White
TRUE,91,10+10,1851,1716,135,A40,2,Resign,White
TRUE,102,10+10,1617,1846,-229,C02,7,Mate,Black
TRUE,94,10+10,1774,1837,-63,D51,11,Resign,Black
TRUE,98,10+10,1853,1658,195,D15,9,Resign,Black
TRUE,62,10+10,1846,1725,121,D06,4,Resign,White
TRUE,92,10+10,1732,1838,-106,C02,8,Mate,Black
TRUE,109,10+10,1831,1705,126,D06,4,Mate,White
TRUE,101,10+10,1819,1842,-23,C01,5,Resign,White
TRUE,66,10+10,1851,1830,21,C02,7,Resign,Black
TRUE,120,10+10,1823,1686,137,D31,6,Resign,White
TRUE,80,10+10,1680,1816,-136,C00,3,Resign,Black
TRUE,55,10+10,1809,1688,121,D02,4,Resign,White
TRUE,68,10+10,1823,1676,147,D10,5,Mate,Black
TRUE,30,10+10,1869,1811,58,D77,11,Resign,Black
TRUE,86,10+10,1808,1660,148,D43,8,Draw,Draw
TRUE,59,10+10,1711,1821,-110,C00,3,Resign,White
TRUE,40,10+10,1796,1810,-14,C17,8,Resign,Black
TRUE,40,10+10,1796,1892,-96,E90,11,Resign,White
TRUE,59,10+10,1789,1661,128,D20,4,Resign,White
TRUE,53,10+3,1831,1799,32,C02,6,Mate,White
TRUE,71,10+5,1789,1752,37,A40,2,Out of Time,White
TRUE,100,5+8,1771,1778,-7,C00,2,Resign,Black
TRUE,110,10+0,1783,1996,-213,D55,13,Out of Time,Black
TRUE,44,5+8,1798,1630,168,A40,2,Resign,Black
TRUE,46,5+8,1637,1792,-155,A00,1,Out of Time,Black
TRUE,78,10+0,1672,1680,-8,C42,5,Out of Time,Black
TRUE,47,10+0,1847,1678,169,D06,4,Resign,White
TRUE,24,10+0,1063,1678,-615,C44,5,Resign,Black
TRUE,92,10+0,1688,1730,-42,B20,3,Resign,Black
TRUE,77,10+0,1493,1706,-213,D01,4,Mate,White
TRUE,77,10+0,1700,1497,203,C46,7,Resign,White
TRUE,36,5+8,1564,1639,-75,C50,6,Mate,Black
TRUE,42,5+5,1659,1550,109,C44,5,Mate,Black
FALSE,73,15+0,1612,1550,62,C69,9,Mate,White
TRUE,40,5+5,1559,1604,-45,B00,2,Mate,Black
TRUE,62,3+8,1578,1547,31,A00,1,Resign,Black
TRUE,124,5+8,1645,1555,90,D00,3,Resign,White
TRUE,83,5+6,1636,1564,72,C44,5,Resign,White
TRUE,133,5+5,1568,1575,-7,C46,5,Mate,White
TRUE,105,5+5,1583,1586,-3,C20,3,Mate,White
TRUE,17,5+5,1574,1594,-20,C40,4,Resign,White
TRUE,128,8+8,1629,1573,56,C20,2,Draw,Draw
TRUE,38,8+5,1550,1562,-12,D06,4,Resign,Black
TRUE,39,5+5,1625,1571,54,C50,6,Resign,White
FALSE,73,5+12,1420,1571,-151,C69,9,Resign,White
TRUE,48,5+7,1565,1773,-208,C44,5,Mate,Black
TRUE,29,8+0,1605,1583,22,D00,3,Resign,White
TRUE,43,5+5,1709,1590,119,C50,6,Resign,White
TRUE,49,5+5,1621,1600,21,D00,3,Mate,White
TRUE,57,5+5,1609,1699,-90,B30,4,Resign,Black
TRUE,68,5+5,1716,1617,99,D00,2,Resign,White
TRUE,30,5+5,1677,1603,74,C44,9,Mate,Black
TRUE,129,5+5,1891,1607,284,D50,7,Resign,White
TRUE,50,5+7,1768,1613,155,D01,4,Resign,White
TRUE,70,5+7,1620,1760,-140,C50,7,Mate,Black
TRUE,77,5+8,1606,1731,-125,C41,6,Resign,White
TRUE,53,8+8,1614,1694,-80,B02,2,Resign,Black
FALSE,33,12+7,1831,1614,217,C50,6,Resign,White
FALSE,112,12+7,1614,1831,-217,C50,8,Draw,Draw
FALSE,62,12+7,1831,1614,217,A84,5,Mate,Black
FALSE,66,12+7,1614,1831,-217,C50,8,Mate,Black
FALSE,64,12+7,1831,1614,217,D06,4,Resign,Black
FALSE,80,12+7,1614,1831,-217,C50,8,Mate,Black
FALSE,150,10+14,1614,1587,27,A04,4,Mate,Black
TRUE,27,5+6,1673,1624,49,C23,3,Mate,White
TRUE,83,5+8,1822,1629,193,C34,6,Resign,White
TRUE,84,5+8,1728,1637,91,A25,4,Resign,White
TRUE,140,5+8,1646,1709,-63,C41,6,Mate,Black
FALSE,33,10+14,1646,1554,92,B07,2,Mate,White
FALSE,46,10+14,1554,1646,-92,A00,1,Resign,Black
FALSE,47,15+5,1533,1746,-213,B20,3,Resign,White
TRUE,57,10+0,1519,1153,366,B20,3,Resign,White
TRUE,112,10+0,1527,1706,-179,B06,2,Out of Time,Black
FALSE,79,10+0,1344,1527,-183,C20,3,Out of Time,White
FALSE,17,10+0,1527,1344,183,C24,4,Resign,White
FALSE,26,10+0,1344,1527,-183,C46,6,Mate,Black
TRUE,96,10+0,1533,1777,-244,B90,11,Out of Time,Black
TRUE,88,10+0,914,1532,-618,C50,5,Resign,Black
TRUE,138,10+0,1535,1868,-333,C55,6,Mate,Black
TRUE,60,10+0,1825,1502,323,C50,5,Mate,Black
TRUE,70,10+0,1508,1769,-261,B56,10,Mate,Black
TRUE,64,10+0,1510,1976,-466,B01,2,Mate,Black
TRUE,62,10+0,1527,1438,89,C26,6,Mate,Black
TRUE,28,10+0,1369,1517,-148,D00,3,Resign,Black
TRUE,98,10+0,1522,1821,-299,B27,3,Mate,Black
TRUE,94,10+0,1505,1832,-327,C26,5,Mate,Black
FALSE,50,10+0,1500,1505,-5,C40,3,Mate,Black
TRUE,82,10+0,1565,1485,80,A00,1,Out of Time,Black
FALSE,46,15+10,1000,1951,-951,C45,7,Mate,Black
FALSE,31,10+5,1951,1875,76,A04,3,Mate,White
FALSE,52,10+5,1951,2227,-276,A06,3,Resign,Black
FALSE,48,15+15,1621,1951,-330,B12,6,Resign,Black
FALSE,46,15+15,1951,1621,330,A84,4,Resign,Black
FALSE,21,15+10,1951,1621,330,A85,5,Resign,White
TRUE,27,15+2,1334,1443,-109,C20,3,Resign,White
TRUE,95,10+0,1442,1507,-65,C01,5,Draw,Draw
TRUE,136,10+0,1411,1430,-19,C64,6,Resign,Black
TRUE,55,10+0,1487,1441,46,C20,3,Mate,White
TRUE,1,10+0,1431,1367,64,B00,1,Resign,White
TRUE,36,10+0,1448,1302,146,C50,9,Mate,Black
TRUE,54,10+0,1444,1435,9,C65,6,Resign,Black
TRUE,41,10+0,1425,1371,54,B00,2,Resign,White
TRUE,97,10+5,1454,1423,31,C20,4,Resign,White
TRUE,84,10+0,1412,1411,1,C50,9,Mate,Black
TRUE,81,10+0,1396,1439,-43,C41,4,Resign,White
TRUE,91,10+0,1283,1414,-131,C45,7,Mate,White
TRUE,167,10+0,1400,1412,-12,C50,8,Mate,White
TRUE,43,10+0,1389,1333,56,C46,7,Mate,White
TRUE,42,10+0,1353,1377,-24,C24,4,Resign,Black
TRUE,70,10+0,1391,1366,25,C00,3,Resign,Black
TRUE,100,10+0,1404,1437,-33,C55,6,Out of Time,Black
TRUE,40,10+0,1422,1389,33,C50,8,Mate,Black
TRUE,114,10+0,1139,1383,-244,C46,6,Out of Time,Black
TRUE,118,10+0,1401,1311,90,B01,4,Out of Time,Black
TRUE,25,10+0,1371,1384,-13,C41,4,Mate,White
TRUE,27,6+4,1500,1379,121,C64,6,Resign,White
TRUE,54,15+10,1302,1366,-64,D30,4,Mate,Black
FALSE,87,5+8,1954,1500,454,D06,4,Resign,White
TRUE,62,13+0,1500,1621,-121,C62,6,Mate,Black
TRUE,46,10+0,1645,1748,-103,B23,3,Mate,Black
TRUE,51,10+0,1542,1659,-117,A25,4,Out of Time,White
TRUE,32,10+0,1746,1645,101,D20,4,Resign,Black
TRUE,62,10+0,1655,1673,-18,C00,3,Mate,Black
TRUE,120,16+0,1667,1659,8,C40,4,Out of Time,Black
TRUE,49,15+0,1654,1693,-39,B30,4,Mate,White
TRUE,77,10+0,1748,1671,77,C48,9,Out of Time,White
FALSE,35,13+0,1671,1500,171,C40,4,Mate,White
FALSE,14,13+0,1671,1500,171,C40,3,Resign,Black
TRUE,11,17+0,1681,1738,-57,B23,3,Resign,White
TRUE,91,15+0,1731,1691,40,C24,4,Resign,White
TRUE,62,15+0,1707,1678,29,C44,5,Mate,Black
TRUE,25,15+0,1663,1790,-127,B25,4,Mate,White
TRUE,47,10+2,1705,1674,31,D06,4,Out of Time,White
TRUE,58,10+3,1717,1460,257,B00,2,Resign,Black
TRUE,55,8+0,1712,1499,213,B01,4,Resign,White
TRUE,38,15+5,1730,1473,257,C57,8,Mate,Black
TRUE,43,15+0,1704,1731,-27,C79,10,Resign,White
TRUE,50,10+0,1801,1717,84,C55,6,Resign,Black
FALSE,57,14+0,1714,1718,-4,C55,6,Out of Time,White
TRUE,69,15+0,1803,1723,80,D00,2,Out of Time,White
TRUE,90,10+0,1732,1785,-53,B02,4,Mate,Black
TRUE,173,15+0,1719,1758,-39,C62,6,Mate,White
TRUE,43,15+0,1748,1730,18,C36,6,Resign,White
TRUE,66,15+0,1741,1743,-2,B23,4,Mate,Black
TRUE,103,15+0,1264,1763,-499,D20,4,Mate,White
TRUE,40,10+5,1232,1761,-529,D01,4,Resign,Black
TRUE,90,15+0,1742,1750,-8,C66,8,Resign,Black
TRUE,107,15+0,1747,1424,323,C40,3,Mate,White
TRUE,34,15+0,1735,1763,-28,B07,2,Resign,White
TRUE,126,14+6,1755,1722,33,D02,4,Resign,Black
TRUE,108,14+0,1757,1709,48,D00,3,Out of Time,Black
TRUE,100,14+0,1720,1748,-28,B01,4,Mate,Black
TRUE,64,10+5,1773,1706,67,D02,5,Mate,Black
TRUE,66,10+0,1717,1709,8,B40,4,Out of Time,Black
TRUE,45,10+0,2247,1718,529,C55,6,Resign,White
FALSE,8,20+15,1586,2481,-895,C50,6,Out of Time,Black
TRUE,46,30+0,1306,1275,31,B10,2,Resign,White
TRUE,35,30+0,1259,1319,-60,C42,4,Mate,White
TRUE,40,15+5,1272,1169,103,B10,2,Out of Time,Black
TRUE,8,10+0,1278,1500,-222,B00,2,Resign,Black
TRUE,53,10+0,1265,1500,-235,B00,4,Resign,White
FALSE,120,10+5,1265,1500,-235,C41,4,Resign,Black
FALSE,73,15+0,1265,1500,-235,C40,4,Resign,Black
TRUE,22,30+0,1264,1268,-4,C40,4,Draw,Draw
TRUE,66,10+0,1278,1280,-2,B02,4,Out of Time,Black
TRUE,85,12+10,1282,1293,-11,B10,5,Resign,White
TRUE,30,10+5,1500,1279,221,B00,3,Mate,Black
TRUE,49,20+15,1271,1096,175,C68,7,Mate,White
TRUE,70,180+0,964,1267,-303,B00,3,Resign,Black
TRUE,19,20+3,1270,1179,91,A06,3,Draw,Draw
TRUE,80,10+0,1277,1490,-213,B29,5,Mate,Black
TRUE,123,10+0,1919,1858,61,A10,2,Out of Time,White
TRUE,48,10+0,2089,1819,270,A49,4,Resign,Black
TRUE,69,10+0,1794,1791,3,C66,8,Out of Time,White
TRUE,65,10+10,1949,1811,138,B21,3,Out of Time,White
TRUE,97,15+15,1835,1839,-4,B20,3,Resign,White
TRUE,83,10+0,1803,1874,-71,B90,10,Out of Time,White
TRUE,56,15+0,1904,1927,-23,C62,6,Resign,Black
TRUE,81,10+5,1944,1938,6,B90,11,Resign,White
TRUE,68,20+0,1922,1688,234,C70,8,Resign,White
TRUE,98,20+0,1693,1903,-210,B50,4,Resign,Black
TRUE,45,20+0,1880,1699,181,C41,4,Resign,White
TRUE,28,10+5,1853,1828,25,E80,9,Resign,Black
FALSE,59,15+4,1838,1828,10,E71,9,Out of Time,White
FALSE,91,15+0,1828,1471,357,B00,3,Draw,Draw
FALSE,32,7+2,1828,1796,32,B30,5,Resign,Black
FALSE,69,8+2,1828,1500,328,A30,2,Out of Time,White
TRUE,70,10+0,1850,1757,93,A46,5,Mate,Black
FALSE,49,30+5,1942,1757,185,A45,2,Resign,White
TRUE,4,15+0,1616,1708,-92,B50,4,Resign,Black
TRUE,37,15+0,1630,1626,4,C70,8,Resign,White
TRUE,69,15+3,1415,1571,-156,B50,4,Resign,Black
TRUE,121,15+10,1365,1586,-221,C66,8,Resign,White
FALSE,19,10+5,1365,1551,-186,B32,5,Mate,White
FALSE,45,15+0,1796,1365,431,B50,5,Resign,White
FALSE,35,8+8,1418,1365,53,A45,2,Resign,White
FALSE,59,15+0,1796,1365,431,A17,4,Out of Time,White
FALSE,92,15+0,1405,1365,40,D00,4,Mate,Black
FALSE,19,8+10,1365,1593,-228,D06,4,Mate,White
FALSE,40,5+8,1500,1365,135,A04,2,Mate,Black
FALSE,28,5+10,1205,1365,-160,C69,9,Mate,Black
FALSE,39,10+0,1365,1796,-431,B12,5,Resign,White
FALSE,43,7+2,1500,1365,135,C20,3,Mate,White
FALSE,66,10+0,1500,1365,135,B20,3,Out of Time,Black
TRUE,98,15+0,1500,1574,-74,D43,8,Mate,Black
FALSE,33,10+5,1500,1308,192,D20,5,Resign,White
FALSE,38,7+2,1500,1796,-296,A45,3,Resign,Black
FALSE,24,7+2,1796,1500,296,A10,2,Resign,Black
FALSE,168,7+2,1500,1796,-296,E00,4,Mate,Black
TRUE,76,15+2,1381,1407,-26,A00,1,Draw,Draw
TRUE,51,15+2,1408,1380,28,C03,5,Draw,Draw
TRUE,47,15+2,1366,1420,-54,A40,3,Mate,White
TRUE,102,10+0,1242,1413,-171,D05,6,Mate,Black
TRUE,33,10+0,1418,1235,183,C41,5,Draw,Draw
TRUE,36,30+5,1609,1401,208,C50,9,Resign,Black
TRUE,25,30+10,1207,1406,-199,A00,1,Draw,Draw
TRUE,25,30+10,1399,1223,176,B00,2,Resign,White
TRUE,9,35+8,1406,1525,-119,B10,2,Resign,Black
TRUE,67,8+5,1397,1319,78,B01,4,Mate,White
TRUE,67,8+5,1317,1400,-83,C26,7,Draw,Draw
TRUE,61,8+5,1391,1306,85,C41,5,Mate,White
TRUE,36,8+5,1314,1382,-68,C20,3,Mate,Black
TRUE,35,15+5,1380,1436,-56,B52,9,Draw,Draw
FALSE,83,5+6,1503,1366,137,C58,11,Resign,White
TRUE,37,12+0,1794,1368,426,B00,2,Resign,White
FALSE,23,8+0,1623,1368,255,D10,5,Draw,Draw
TRUE,89,8+0,1459,1376,83,C24,4,Out of Time,White
TRUE,27,8+0,1373,1461,-88,C40,4,Draw,Draw
TRUE,77,10+5,1364,1292,72,B02,5,Resign,White
FALSE,47,5+8,1364,1500,-136,C55,6,Resign,Black
TRUE,24,20+8,1374,1387,-13,C40,4,Resign,Black
TRUE,63,2+10,1441,1367,74,C20,3,Mate,White
TRUE,44,7+6,1405,1545,-140,B01,4,Mate,Black
TRUE,28,8+5,1424,1519,-95,C23,4,Mate,Black
TRUE,117,8+5,1311,1534,-223,C22,6,Mate,White
TRUE,105,8+5,1441,1500,-59,B01,6,Mate,White
TRUE,101,13+40,1978,2139,-161,A84,4,Resign,White
TRUE,72,13+40,1905,2133,-228,B50,6,Mate,Black
TRUE,69,13+40,2126,1981,145,D00,3,Resign,White
TRUE,145,13+40,2159,2136,23,B87,14,Mate,White
TRUE,83,10+10,1972,2153,-181,B22,3,Resign,White
TRUE,85,13+40,2149,1868,281,E40,7,Resign,White
TRUE,55,15+5,1904,2143,-239,B08,12,Resign,Black
TRUE,87,13+40,2138,1900,238,D08,7,Resign,White
TRUE,89,13+40,1881,2157,-276,B21,3,Resign,White
TRUE,77,13+40,2153,1868,285,D35,7,Resign,White
TRUE,5,150+0,2151,1717,434,D06,4,Out of Time,White
TRUE,65,13+40,2143,2003,140,A58,17,Resign,White
TRUE,103,13+40,2137,1944,193,D87,16,Mate,White
TRUE,76,12+10,1222,1234,-12,C50,5,Mate,Black
TRUE,65,16+15,1695,1627,68,C01,5,Resign,White
TRUE,56,16+15,1568,1688,-120,C57,9,Resign,Black
TRUE,123,15+10,1688,1699,-11,B07,3,Draw,Draw
TRUE,23,15+10,1560,1703,-143,D06,4,Resign,White
TRUE,99,15+10,1714,1671,43,B00,2,Resign,Black
TRUE,36,15+10,1706,1633,73,C55,6,Resign,White
TRUE,32,15+10,1633,1697,-64,C68,8,Resign,Black
TRUE,96,15+10,1586,1690,-104,C68,8,Mate,Black
TRUE,56,15+10,1699,1751,-52,B50,4,Resign,Black
TRUE,38,15+10,1570,1692,-122,D20,5,Resign,Black
TRUE,40,15+10,1680,1725,-45,C50,5,Resign,White
TRUE,36,15+10,1690,1690,0,D00,3,Resign,White
TRUE,138,15+10,1685,1680,5,A00,1,Mate,Black
TRUE,162,15+15,1715,1668,47,B50,4,Mate,Black
TRUE,38,15+10,1633,1658,-25,B20,3,Mate,Black
TRUE,53,15+10,1649,1583,66,B90,11,Resign,White
TRUE,29,15+10,1612,1662,-50,C68,8,Mate,White
TRUE,57,15+10,1662,1642,20,B40,6,Draw,Draw
TRUE,50,15+10,1673,1679,-6,C00,4,Resign,Black
TRUE,29,15+10,1668,1684,-16,B20,6,Resign,White
TRUE,142,15+10,1694,1709,-15,B00,5,Resign,Black
TRUE,58,15+10,1600,1708,-108,D02,5,Resign,White
TRUE,97,15+10,1699,1621,78,B50,4,Mate,White
TRUE,61,15+10,1691,1622,69,B01,6,Resign,White
TRUE,133,15+10,1830,1698,132,B35,14,Resign,White
TRUE,65,15+10,1601,1710,-109,B50,5,Resign,White
TRUE,32,15+10,1703,1587,116,B30,4,Resign,White
TRUE,58,15+10,1597,1695,-98,B56,10,Resign,Black
TRUE,12,15+10,1716,1637,79,C50,6,Resign,Black
TRUE,85,15+10,1720,1726,-6,D00,4,Resign,White
TRUE,53,15+10,1719,1610,109,B00,6,Resign,White
TRUE,51,15+10,1710,1645,65,C41,4,Out of Time,White
TRUE,60,15+10,1723,1644,79,C21,5,Mate,Black
TRUE,52,15+10,1640,1715,-75,B21,3,Resign,Black
TRUE,31,15+10,1648,1728,-80,C21,5,Resign,White
TRUE,15,15+10,1719,1655,64,C55,6,Mate,White
TRUE,35,15+10,1706,1801,-95,B30,4,Out of Time,White
TRUE,60,15+10,1675,1687,-12,D00,3,Resign,Black
TRUE,53,15+10,1696,1731,-35,C51,9,Resign,Black
TRUE,88,15+10,1704,1685,19,C24,4,Mate,Black
TRUE,54,15+10,1699,1594,105,C52,11,Resign,Black
TRUE,69,15+10,1769,1698,71,B54,6,Resign,White
TRUE,92,15+10,1709,1718,-9,C55,6,Mate,Black
TRUE,26,15+10,1720,1693,27,C55,6,Resign,Black
TRUE,41,15+10,1730,1735,-5,C57,9,Resign,Black
TRUE,77,15+10,1793,1857,-64,C02,7,Mate,White
TRUE,91,15+10,1871,1804,67,B21,3,Resign,White
TRUE,81,15+10,1790,1853,-63,C42,8,Resign,White
TRUE,59,15+10,1775,1754,21,C15,6,Resign,White
TRUE,29,15+10,1741,1792,-51,B54,9,Resign,White
FALSE,8,10+5,1500,1792,-292,B50,4,Draw,Draw
FALSE,37,10+5,1500,1792,-292,A21,3,Resign,White
FALSE,61,15+0,1858,1792,66,B20,3,Out of Time,White
FALSE,50,15+0,1792,1858,-66,C67,8,Mate,Black
TRUE,55,15+10,1779,1703,76,B12,7,Resign,White
TRUE,154,15+10,1703,1765,-62,B40,5,Draw,Draw
TRUE,70,10+10,1281,1427,-146,C77,9,Mate,Black
TRUE,44,10+10,1454,1260,194,C77,9,Mate,Black
TRUE,57,15+15,1440,1347,93,B00,2,Mate,White
TRUE,47,20+8,1053,1474,-421,D00,3,Mate,White
TRUE,36,10+0,1246,1465,-219,A27,5,Resign,Black
TRUE,42,10+8,1362,1449,-87,C20,3,Mate,Black
TRUE,44,10+1,1255,1437,-182,C55,7,Resign,Black
TRUE,157,5+5,1429,1165,264,B50,4,Mate,White
FALSE,93,15+0,1429,1500,-71,B06,2,Resign,White
TRUE,99,11+4,1405,1423,-18,B10,2,Resign,White
TRUE,47,14+4,1348,1432,-84,B20,3,Mate,White
TRUE,73,14+4,1417,1260,157,B10,5,Resign,White
TRUE,45,14+2,1395,1331,64,C55,6,Resign,White
TRUE,107,14+2,1370,1334,36,B01,4,Mate,White
TRUE,56,15+0,1152,1355,-203,A00,1,Mate,Black
TRUE,74,15+0,1175,1338,-163,D00,4,Mate,Black
TRUE,29,15+0,1314,1244,70,B01,4,Mate,White
TRUE,80,15+0,1271,1279,-8,C44,6,Mate,Black
TRUE,24,15+0,1222,1417,-195,C50,8,Resign,White
TRUE,70,15+0,1236,1500,-264,C46,5,Resign,Black
TRUE,61,15+0,1187,1231,-44,C40,4,Out of Time,White
FALSE,114,5+8,1187,1393,-206,C41,4,Mate,Black
FALSE,44,5+8,1393,1187,206,C41,5,Resign,Black
TRUE,78,15+15,1195,1260,-65,C40,3,Mate,Black
TRUE,89,30+0,1146,1208,-62,C20,3,Mate,White
TRUE,74,20+0,1216,1310,-94,B20,2,Mate,Black
TRUE,72,9+6,1159,1207,-48,C41,5,Mate,Black
TRUE,37,6+8,1152,1198,-46,A00,1,Resign,Black
TRUE,19,6+8,1188,1163,25,B00,2,Mate,White
TRUE,37,8+0,1177,1172,5,C41,4,Resign,White
TRUE,68,8+8,1184,1301,-117,C41,4,Mate,Black
TRUE,88,10+9,1099,1176,-77,A00,1,Out of Time,Black
TRUE,115,15+5,1182,1176,6,C41,4,Draw,Draw
TRUE,30,15+5,1185,1231,-46,C44,4,Mate,Black
TRUE,45,15+5,1219,1196,23,D02,5,Mate,White
TRUE,71,15+5,1195,1220,-25,C44,4,Draw,Draw
TRUE,78,16+8,1374,1179,195,C27,3,Mate,Black
TRUE,24,7+12,1144,1164,-20,C20,3,Resign,Black
TRUE,69,15+10,1150,1253,-103,B01,2,Resign,White
TRUE,56,10+3,1162,1139,23,B00,2,Out of Time,Black
TRUE,99,10+3,1119,1175,-56,A02,1,Out of Time,White
TRUE,79,20+0,1302,1183,119,A04,2,Mate,White
TRUE,66,10+3,1135,1172,-37,A02,1,Out of Time,Black
TRUE,53,10+3,1147,1185,-38,A02,1,Mate,White
TRUE,142,15+2,1190,1410,-220,C44,4,Mate,Black
TRUE,144,15+2,1416,1183,233,C41,5,Draw,Draw
TRUE,56,8+3,1172,1181,-9,C44,4,Resign,White
TRUE,30,5+8,1162,1121,41,C41,6,Resign,White
TRUE,102,5+8,1135,1151,-16,D02,4,Mate,Black
FALSE,70,5+8,1151,1469,-318,C41,4,Mate,Black
TRUE,59,30+5,1368,1156,212,C41,5,Mate,White
TRUE,52,10+3,1169,1144,25,C41,5,Out of Time,Black
TRUE,46,10+3,1155,1147,8,C42,4,Out of Time,Black
TRUE,130,10+9,1113,1145,-32,D00,3,Resign,Black
TRUE,100,20+0,1143,1192,-49,B01,2,Mate,Black
TRUE,67,12+0,1042,1159,-117,A01,3,Out of Time,White
FALSE,52,10+3,1142,1900,-758,B20,2,Mate,Black
TRUE,32,15+10,2073,1890,183,A58,9,Resign,Black
TRUE,33,15+10,2056,2062,-6,B12,7,Resign,Black
TRUE,85,15+10,2055,1924,131,E11,8,Resign,White
TRUE,56,15+10,1865,2049,-184,D43,8,Resign,Black
TRUE,55,15+10,2043,1871,172,E15,8,Resign,White
TRUE,65,10+5,2168,2050,118,B19,24,Out of Time,White
TRUE,56,10+5,2065,1960,105,A40,2,Out of Time,Black
TRUE,24,10+5,1928,2050,-122,D11,7,Mate,Black
TRUE,119,10+5,2038,2065,-27,E61,6,Resign,White
TRUE,54,10+5,2051,1995,56,A40,2,Resign,Black
TRUE,35,10+5,1909,2065,-156,B18,8,Resign,White
TRUE,86,10+5,2075,2138,-63,D07,6,Mate,Black
TRUE,117,15+10,2061,2122,-61,D31,5,Resign,White
TRUE,108,15+10,1809,2056,-247,B18,8,Mate,Black
TRUE,141,15+10,2046,1984,62,E21,8,Mate,White
TRUE,67,15+10,1879,2061,-182,B53,7,Resign,White
TRUE,28,15+10,2057,1795,262,D20,5,Resign,White
TRUE,138,30+30,2042,2058,-16,A35,6,Resign,White
TRUE,86,30+30,1961,2044,-83,B38,11,Draw,Draw
TRUE,62,45+45,1902,2037,-135,D17,12,Resign,Black
TRUE,53,30+30,2022,2162,-140,A15,6,Resign,White
TRUE,77,30+30,2335,2025,310,B23,5,Resign,White
TRUE,55,30+30,2013,2035,-22,B01,8,Resign,White
TRUE,107,45+45,2016,1943,73,A22,4,Draw,Draw
TRUE,34,15+15,1727,2012,-285,D11,5,Resign,Black
TRUE,16,30+30,2008,1744,264,A21,4,Resign,White
TRUE,59,45+45,2109,2016,93,B38,11,Resign,White
TRUE,69,30+30,2150,2023,127,B27,4,Resign,White
FALSE,49,5+8,2023,1640,383,D12,8,Resign,White
FALSE,31,5+8,2023,1640,383,D45,9,Out of Time,White
TRUE,111,30+30,2006,2232,-226,E12,10,Resign,White
TRUE,112,45+45,2131,1991,140,D14,12,Resign,Black
TRUE,38,30+30,1650,1988,-338,B12,7,Resign,Black
TRUE,55,45+45,1979,1913,66,C01,7,Resign,White
TRUE,77,30+30,1975,2104,-129,A28,7,Draw,Draw
TRUE,102,45+45,2097,1960,137,B27,4,Resign,Black
TRUE,43,10+0,1845,1975,-130,B27,4,Resign,White
TRUE,50,45+45,1984,1964,20,D11,5,Resign,Black
TRUE,77,45+45,1954,1899,55,A10,2,Resign,White
TRUE,49,45+45,1962,2080,-118,A70,13,Resign,Black
TRUE,96,45+45,1943,1951,-8,D17,12,Mate,Black
TRUE,40,45+45,1966,1939,27,B21,12,Resign,Black
TRUE,45,45+45,1926,1982,-56,A28,6,Resign,White
TRUE,83,8+8,1820,1940,-120,C20,3,Resign,White
TRUE,107,10+10,1941,1893,48,A34,3,Draw,Draw
TRUE,27,10+2,1867,1932,-65,B34,9,Resign,Black
TRUE,50,5+8,1860,1922,-62,B21,3,Mate,Black
TRUE,42,11+3,1937,1805,132,A10,2,Resign,Black
TRUE,81,15+5,1930,1807,123,A13,2,Mate,White
TRUE,68,5+6,1848,1921,-73,B36,8,Resign,Black
TRUE,5,10+15,1815,1688,127,A02,1,Resign,Black
FALSE,12,15+15,1236,1815,-579,A00,1,Mate,Black
TRUE,93,8+0,1806,1736,70,C64,6,Resign,White
TRUE,66,10+0,1679,1799,-120,B07,2,Resign,Black
TRUE,75,10+0,1791,1687,104,B32,7,Resign,White
TRUE,53,10+1,1816,1801,15,B01,2,Resign,White
TRUE,50,10+10,1758,1791,-33,B08,9,Mate,Black
TRUE,91,8+0,1949,1966,-17,D00,3,Out of Time,White
TRUE,112,15+0,1908,1956,-48,D45,9,Resign,Black
TRUE,71,15+16,1726,1713,13,C10,5,Resign,White
TRUE,110,15+15,1841,1712,129,B20,3,Resign,Black
TRUE,54,8+0,1721,1773,-52,B40,5,Out of Time,Black
TRUE,62,10+0,1737,1582,155,B22,3,Mate,Black
TRUE,65,10+0,1730,1560,170,B01,6,Resign,White
TRUE,39,10+0,1836,1739,97,C00,2,Mate,White
TRUE,58,10+0,1639,1730,-91,D45,9,Resign,Black
TRUE,23,10+0,1725,1537,188,C41,5,Resign,White
TRUE,73,10+0,1812,1733,79,B36,8,Mate,White
TRUE,62,10+0,1757,1877,-120,B22,3,Resign,Black
TRUE,99,10+0,1742,1897,-155,B30,4,Mate,White
TRUE,28,10+0,1795,1751,44,B32,5,Resign,White
TRUE,58,10+0,1771,1739,32,A00,1,Mate,Black
TRUE,36,10+0,1727,2084,-357,B23,3,Resign,Black
TRUE,100,10+0,1739,1906,-167,B25,4,Mate,Black
TRUE,35,10+0,1787,1726,61,C07,6,Resign,Black
TRUE,59,10+0,1446,1739,-293,A45,2,Out of Time,White
TRUE,43,10+0,1818,1748,70,B21,3,Resign,White
TRUE,61,10+0,1737,1740,-3,E76,9,Out of Time,White
TRUE,23,10+0,1728,1642,86,D00,8,Resign,White
TRUE,46,10+0,1746,1507,239,D85,13,Out of Time,Black
TRUE,15,10+0,1903,1752,151,A45,2,Resign,White
TRUE,111,10+0,1694,1763,-69,A80,2,Mate,White
TRUE,92,10+0,1761,1857,-96,A46,6,Mate,Black
TRUE,52,10+0,1770,1853,-83,A45,3,Mate,Black
TRUE,42,10+0,1805,1758,47,A80,2,Resign,Black
TRUE,72,10+0,1778,1746,32,D35,6,Resign,Black
TRUE,65,10+0,1735,1725,10,A43,2,Resign,White
TRUE,92,10+0,1739,1980,-241,C54,13,Mate,Black
TRUE,149,10+0,1783,1749,34,C00,3,Resign,White
FALSE,56,8+0,1859,2417,-558,C59,16,Resign,Black
TRUE,111,3+8,1853,1629,224,C00,4,Mate,White
TRUE,86,8+0,1861,1547,314,C41,8,Draw,Draw
TRUE,76,30+30,2081,1691,390,C51,8,Resign,White
TRUE,40,15+0,1967,2074,-107,A70,13,Out of Time,Black
TRUE,117,30+10,1838,2080,-242,A57,6,Draw,Draw
TRUE,35,30+10,2072,1964,108,C50,6,Mate,White
FALSE,78,20+10,2072,1500,572,B43,9,Resign,Black
TRUE,61,30+10,1904,2089,-185,A70,15,Resign,White
TRUE,64,30+10,1857,2084,-227,B20,3,Resign,Black
TRUE,102,30+10,1814,2080,-266,C50,6,Resign,Black
TRUE,27,25+10,2037,2070,-33,B22,3,Resign,Black
TRUE,59,30+10,2064,1897,167,C55,6,Resign,White
TRUE,59,30+10,1867,2064,-197,A22,6,Resign,White
TRUE,104,30+10,2077,2011,66,C42,9,Resign,Black
TRUE,69,30+10,2085,2077,8,B23,3,Draw,Draw
TRUE,133,30+10,2073,1837,236,B06,2,Resign,White
TRUE,36,30+10,1848,2068,-220,B21,3,Resign,Black
TRUE,137,30+10,2070,1975,95,B32,8,Draw,Draw
TRUE,115,30+10,1899,2076,-177,A45,2,Draw,Draw
TRUE,49,30+10,2065,2068,-3,B33,16,Mate,White
TRUE,102,30+10,1976,2056,-80,D05,9,Resign,Black
TRUE,61,30+10,2051,1810,241,C55,7,Resign,White
FALSE,84,60+60,1426,1341,85,B21,3,Resign,Black
TRUE,53,10+0,1466,1532,-66,D02,4,Mate,White
TRUE,45,15+0,997,1500,-503,C02,5,Resign,Black
TRUE,71,10+0,1515,1879,-364,A00,1,Resign,Black
TRUE,139,10+0,1875,1568,307,A43,3,Resign,White
TRUE,161,10+0,1859,2004,-145,D26,10,Resign,White
TRUE,44,10+0,1862,2199,-337,A84,4,Resign,Black
TRUE,29,10+0,1530,1872,-342,B50,4,Mate,White
TRUE,51,10+0,1870,1430,440,A40,2,Mate,White
TRUE,74,10+0,1691,1858,-167,B84,12,Resign,Black
TRUE,48,10+0,1860,1815,45,D07,6,Draw,Draw
TRUE,131,10+0,1855,1615,240,D30,4,Mate,White
FALSE,96,10+0,2068,1500,568,D30,4,Resign,Black
TRUE,134,10+0,1910,2060,-150,C07,8,Resign,Black
TRUE,61,10+0,2058,1616,442,D20,4,Resign,White
TRUE,62,10+0,1693,2055,-362,E15,8,Out of Time,Black
TRUE,58,10+0,1273,2054,-781,C02,6,Resign,Black
TRUE,49,10+0,2038,2141,-103,A57,6,Mate,White
TRUE,71,10+0,2034,1747,287,E12,6,Resign,White
TRUE,73,10+0,1979,2049,-70,E12,6,Resign,White
TRUE,87,10+0,2044,2027,17,E12,6,Draw,Draw
TRUE,63,10+0,2014,2023,-9,D02,8,Resign,White
TRUE,38,10+0,2094,1997,97,C02,11,Resign,Black
TRUE,43,10+0,1996,1403,593,E88,14,Mate,White
TRUE,73,10+0,1994,1522,472,A40,2,Resign,White
TRUE,151,10+0,1733,2016,-283,E20,6,Mate,White
TRUE,47,10+0,2014,1585,429,D30,7,Mate,White
TRUE,58,10+0,1535,2012,-477,C00,3,Resign,Black
TRUE,53,10+0,2008,1735,273,E81,10,Out of Time,White
TRUE,75,10+0,1646,2031,-385,D35,6,Resign,White
TRUE,36,10+0,1913,2020,-107,C00,2,Resign,Black
FALSE,32,5+10,2173,2240,-67,B92,11,Out of Time,Black
TRUE,77,15+5,2228,2228,0,C02,9,Resign,White
FALSE,68,40+60,2078,2228,-150,B20,5,Resign,Black
TRUE,140,180+5,2069,2223,-154,B50,4,Mate,Black
TRUE,124,10+15,2229,2004,225,B50,5,Draw,Draw
TRUE,57,10+10,2233,2540,-307,C53,9,Resign,Black
TRUE,67,30+15,2229,1947,282,B50,5,Resign,White
TRUE,51,15+15,2052,2222,-170,B20,3,Resign,Black
TRUE,43,15+10,2164,2212,-48,E10,6,Resign,Black
TRUE,137,10+15,2207,1993,214,B92,16,Out of Time,White
TRUE,72,15+15,2222,2029,193,C02,12,Resign,Black
FALSE,31,20+60,2364,2222,142,A15,4,Resign,White
TRUE,76,12+15,2157,2213,-56,E10,6,Resign,Black
TRUE,71,15+5,2206,2046,160,C02,11,Resign,White
TRUE,158,5+5,2214,2336,-122,C02,11,Resign,Black
TRUE,43,10+10,2252,2224,28,A45,2,Mate,White
TRUE,66,10+10,2136,2215,-79,B91,11,Resign,Black
TRUE,40,10+10,2277,2201,76,A45,2,Out of Time,Black
TRUE,38,7+14,2220,1973,247,B01,4,Resign,Black
TRUE,91,20+20,2215,1998,217,B12,7,Mate,White
FALSE,58,15+10,2064,2215,-151,B90,11,Resign,Black
FALSE,13,20+60,2228,2203,25,B94,11,Resign,Black
TRUE,115,15+10,2228,2203,25,A01,2,Mate,White
TRUE,38,10+5,2103,2194,-91,A46,6,Resign,Black
TRUE,59,15+10,2207,2206,1,E68,15,Resign,White
FALSE,69,10+15,2621,2206,415,B90,11,Resign,White
TRUE,72,15+15,1829,1807,22,B19,14,Resign,Black
TRUE,83,10+0,1803,1542,261,C00,4,Resign,White
TRUE,54,10+8,1751,1793,-42,A11,2,Resign,Black
TRUE,152,15+10,1807,1719,88,B21,5,Mate,Black
TRUE,40,15+10,1728,1798,-70,B10,2,Mate,Black
TRUE,60,15+10,1812,1714,98,A10,2,Mate,Black
TRUE,57,10+0,1397,1376,21,B01,4,Mate,White
TRUE,98,10+0,1490,1474,16,C41,5,Out of Time,Black
TRUE,143,25+10,1354,1405,-51,B50,4,Mate,White
TRUE,139,10+0,1503,1494,9,C26,5,Mate,White
FALSE,41,10+15,2246,1494,752,B03,10,Mate,White
TRUE,142,10+0,1504,1578,-74,C41,5,Mate,Black
TRUE,60,10+0,1507,1490,17,C50,8,Resign,Black
TRUE,83,10+0,1652,1498,154,A00,1,Resign,White
TRUE,100,10+0,1507,1649,-142,C53,7,Resign,Black
TRUE,52,10+0,1482,1493,-11,B02,4,Resign,Black
FALSE,29,15+10,1493,2108,-615,B00,4,Resign,White
TRUE,67,15+15,1946,1772,174,D37,7,Resign,White
TRUE,71,30+30,2057,1782,275,D55,13,Resign,White
TRUE,60,10+0,1793,1783,10,D94,9,Resign,Black
FALSE,34,20+5,1793,2227,-434,E61,4,Resign,Black
TRUE,56,10+0,1783,1781,2,E61,4,Resign,White
TRUE,39,10+0,1791,1876,-85,D32,10,Resign,Black
TRUE,53,10+0,1877,1799,78,D02,3,Mate,White
TRUE,86,30+30,1935,1784,151,C07,8,Resign,Black
TRUE,23,10+0,1795,1798,-3,A40,2,Resign,Black
TRUE,63,10+0,1794,1806,-12,A13,4,Mate,White
TRUE,62,10+0,1803,1900,-97,A53,4,Draw,Draw
TRUE,44,30+30,1802,1858,-56,E14,7,Draw,Draw
TRUE,111,10+0,1802,1781,21,A40,2,Draw,Draw
TRUE,80,10+0,1722,1794,-72,C02,8,Resign,Black
TRUE,50,10+0,1784,1783,1,C00,3,Resign,Black
TRUE,12,10+0,1795,1753,42,D10,4,Resign,Black
FALSE,61,5+60,1500,1795,-295,C11,7,Resign,White
TRUE,40,10+0,1757,1785,-28,A00,1,Mate,Black
TRUE,104,7+2,1389,1307,82,C20,5,Mate,Black
FALSE,33,10+0,1678,1299,379,C21,10,Resign,White
TRUE,64,10+5,1152,1299,-147,C20,3,Mate,Black
TRUE,62,10+0,1303,1634,-331,C60,6,Out of Time,Black
TRUE,47,10+0,1278,1530,-252,C60,6,Mate,White
TRUE,30,10+0,1595,1281,314,C22,6,Resign,White
TRUE,24,10+0,1267,1344,-77,C68,8,Resign,White
TRUE,20,45+1,1332,1277,55,C50,8,Resign,White
FALSE,66,30+0,1213,1277,-64,C50,8,Resign,Black
FALSE,12,120+10,1277,1047,230,C40,3,Out of Time,Black
FALSE,63,120+10,1047,1277,-230,D00,3,Resign,Black
TRUE,82,30+0,1393,1285,108,D00,3,Resign,White
TRUE,87,30+0,1279,1090,189,B02,2,Resign,White
TRUE,19,8+0,1268,1255,13,C40,4,Resign,White
TRUE,59,15+10,1186,1283,-97,C20,3,Mate,White
FALSE,124,8+0,1283,1267,16,B30,5,Mate,Black
TRUE,96,10+4,1290,1270,20,A00,1,Resign,Black
TRUE,53,12+0,1331,1281,50,D00,4,Out of Time,White
TRUE,39,10+0,1304,1292,12,A00,1,Mate,White
TRUE,10,10+0,1305,1293,12,C00,3,Mate,Black
TRUE,51,10+0,1308,1317,-9,C22,8,Mate,White
TRUE,18,15+0,1296,1305,-9,C54,13,Resign,Black
FALSE,106,30+0,968,1305,-337,C50,8,Mate,Black
FALSE,38,15+15,1293,1466,-173,C41,5,Mate,Black
TRUE,59,7+2,1500,1299,201,C68,7,Mate,White
TRUE,111,7+2,1288,1232,56,B12,3,Mate,White
TRUE,28,7+2,1289,2108,-819,C77,9,Resign,Black
FALSE,101,7+2,1431,1289,142,C22,6,Out of Time,White
FALSE,15,7+2,1806,1289,517,C45,7,Mate,White
FALSE,42,7+2,1289,1311,-22,C41,5,Resign,White
FALSE,118,7+2,1431,1289,142,A40,3,Resign,Black
FALSE,34,7+2,1289,1484,-195,C50,6,Resign,Black
FALSE,60,7+2,1289,1810,-521,A42,5,Resign,Black
FALSE,66,7+2,1806,1289,517,C44,5,Resign,Black
FALSE,21,5+8,1289,1500,-211,C41,5,Out of Time,White
TRUE,73,15+1,1409,1297,112,C70,8,Mate,White
TRUE,159,15+1,1280,1485,-205,C55,6,Mate,White
FALSE,74,15+0,1280,1211,69,B01,4,Resign,White
FALSE,28,15+0,1211,1280,-69,A00,3,Mate,Black
TRUE,112,10+0,1281,1765,-484,C41,6,Mate,Black
TRUE,55,10+0,1825,1232,593,A40,2,Resign,White
TRUE,52,10+0,1492,1191,301,C00,3,Mate,Black
TRUE,72,10+0,1419,1151,268,A00,1,Out of Time,Black
TRUE,106,10+0,1346,1112,234,C02,7,Resign,Black
TRUE,2,5+5,1118,1456,-338,B02,2,Resign,Black
TRUE,2,8+2,1126,1450,-324,B20,2,Resign,Black
TRUE,2,10+0,1154,1147,7,C20,2,Resign,Black
TRUE,2,10+0,1227,1179,48,A00,1,Resign,White
TRUE,2,10+0,1507,1188,319,B01,2,Resign,White
TRUE,2,10+1,1196,1547,-351,C20,2,Resign,Black
TRUE,2,5+8,1467,1209,258,A40,2,Resign,White
TRUE,2,8+0,1226,1431,-205,A00,1,Resign,Black
TRUE,2,10+0,1362,1252,110,B07,2,Resign,White
TRUE,2,3+8,1076,1319,-243,C00,2,Resign,White
TRUE,2,13+0,1346,1503,-157,C20,2,Resign,Black
TRUE,2,7+5,1369,1581,-212,A00,2,Resign,Black
TRUE,2,10+3,1567,1400,167,B00,2,Resign,White
TRUE,2,30+0,1445,1546,-101,A00,1,Resign,Black
TRUE,2,15+0,1538,1516,22,B00,2,Resign,White
TRUE,3,10+3,1630,1556,74,A00,1,Resign,Black
TRUE,2,8+0,1834,1709,125,C00,2,Resign,White
TRUE,54,10+0,1778,1779,-1,A15,4,Resign,Black
FALSE,43,60+180,1881,1963,-82,B51,5,Resign,White
FALSE,23,60+180,1963,1881,82,C00,3,Resign,Black
FALSE,7,60+180,1963,1881,82,A10,2,Resign,White
FALSE,10,60+180,1963,1881,82,A10,2,Resign,White
FALSE,2,60+180,1963,1881,82,A00,2,Resign,White
FALSE,48,45+45,1881,1963,-82,B31,6,Resign,White
TRUE,45,15+15,1918,1904,14,A81,6,Resign,White
TRUE,55,15+15,1903,1920,-17,B12,7,Draw,Draw
TRUE,71,15+15,1881,1800,81,B31,6,Mate,White
FALSE,36,45+45,1973,1881,92,C06,15,Mate,Black
FALSE,18,45+45,1881,1973,-92,B01,6,Resign,White
FALSE,33,45+45,1973,1881,92,A04,3,Resign,Black
FALSE,32,45+45,1881,1973,-92,B12,7,Resign,White
FALSE,31,45+45,1973,1881,92,C00,3,Resign,White
FALSE,2,45+45,1973,1881,92,A10,2,Resign,Black
FALSE,57,45+45,1881,1973,-92,B30,5,Resign,White
FALSE,37,45+45,1973,1881,92,A10,2,Resign,Black
FALSE,15,45+45,1881,1973,-92,B31,6,Resign,White
TRUE,73,15+15,1863,1713,150,B40,5,Mate,White
TRUE,53,15+15,1839,1765,74,B12,5,Mate,White
TRUE,55,15+15,1810,1749,61,C70,8,Resign,White
FALSE,60,45+45,1973,1810,163,C90,17,Mate,Black
FALSE,14,45+45,1810,1973,-163,B39,14,Resign,Black
FALSE,54,45+45,1973,1810,163,C53,9,Resign,Black
FALSE,38,45+45,1810,1973,-163,B90,12,Resign,White
FALSE,57,45+45,1973,1810,163,C84,10,Draw,Draw
FALSE,11,45+45,1973,1810,163,C67,8,Resign,White
FALSE,28,45+45,1810,1973,-163,B30,5,Resign,Black
FALSE,39,45+45,1973,1810,163,A10,2,Resign,Black
FALSE,11,45+45,1973,1810,163,A13,2,Resign,White
FALSE,15,45+45,1973,1810,163,A82,4,Resign,White
FALSE,27,45+45,1810,1973,-163,E20,8,Resign,White
FALSE,31,45+45,1973,1810,163,A00,1,Resign,White
FALSE,41,45+45,1973,1810,163,B10,8,Draw,Draw
FALSE,35,45+45,1973,1810,163,C06,15,Resign,White
FALSE,30,45+45,1973,1810,163,C00,3,Resign,Black
FALSE,26,45+45,1973,1810,163,A13,3,Resign,White
FALSE,23,45+45,1973,1810,163,A13,2,Resign,White
TRUE,24,15+15,1828,2035,-207,C92,18,Resign,Black
TRUE,42,15+15,1900,1774,126,C01,5,Resign,Black
TRUE,24,15+15,1808,1894,-86,C64,7,Resign,Black
TRUE,10,15+15,1973,1840,133,C17,8,Resign,White
TRUE,92,8+0,1892,1770,122,A40,2,Mate,Black
TRUE,75,8+0,1884,1784,100,A46,3,Resign,White
TRUE,116,8+0,1900,1702,198,A40,2,Out of Time,Black
TRUE,70,8+0,1888,1918,-30,A49,4,Resign,White
TRUE,69,8+0,1881,1753,128,D02,4,Resign,White
TRUE,54,8+0,1874,1742,132,D02,4,Resign,White
TRUE,68,8+0,1888,1780,108,D04,5,Out of Time,Black
TRUE,58,8+0,1904,1740,164,D12,8,Out of Time,Black
TRUE,79,8+0,1894,1862,32,A40,2,Out of Time,White
TRUE,115,8+0,1888,1700,188,D05,6,Resign,White
TRUE,158,8+0,1902,1810,92,A40,3,Out of Time,Black
TRUE,131,8+0,1892,1861,31,A40,2,Out of Time,White
TRUE,65,8+0,1885,1742,143,A40,1,Out of Time,White
TRUE,77,8+0,1877,1780,97,D02,4,Out of Time,White
TRUE,108,8+0,1882,1722,160,A40,2,Draw,Draw
TRUE,43,8+0,1873,1809,64,D04,5,Resign,White
TRUE,87,8+0,1866,1737,129,A40,1,Mate,White
TRUE,29,8+0,1859,1744,115,A40,1,Mate,White
TRUE,64,8+0,1874,1700,174,D02,4,Out of Time,Black
TRUE,79,8+0,1865,1823,42,A40,2,Resign,White
TRUE,76,8+0,1881,1703,178,D02,4,Out of Time,Black
TRUE,59,8+0,1891,1713,178,D02,3,Mate,White
TRUE,80,8+0,1905,1803,102,D02,4,Out of Time,Black
TRUE,125,8+0,1897,1793,104,D02,3,Out of Time,White
TRUE,121,8+0,1890,1755,135,D04,5,Mate,White
TRUE,76,8+0,1903,1842,61,A46,3,Mate,Black
TRUE,68,8+0,1917,1795,122,D02,4,Out of Time,Black
TRUE,64,8+0,1931,1803,128,A40,2,Out of Time,Black
TRUE,67,8+0,1926,1736,190,A40,1,Mate,White
TRUE,59,8+0,1918,1823,95,A40,2,Resign,White
TRUE,51,8+0,1910,1813,97,D02,4,Resign,White
TRUE,45,8+0,1903,1787,116,A40,2,Resign,White
TRUE,45,8+0,1895,1798,97,D02,3,Resign,White
TRUE,96,8+0,1888,1765,123,D02,4,Resign,White
TRUE,72,8+0,1903,1744,159,A49,4,Out of Time,Black
TRUE,117,8+0,1897,1730,167,D02,4,Out of Time,White
TRUE,63,8+0,1890,1768,122,D02,4,Mate,White
TRUE,36,8+0,1905,1745,160,D02,3,Mate,Black
TRUE,81,8+0,1895,1899,-4,D02,3,Resign,White
TRUE,72,8+0,1906,1888,18,A80,2,Out of Time,Black
TRUE,104,8+0,1917,1822,95,A40,2,Out of Time,Black
TRUE,75,8+0,1908,1862,46,D02,3,Mate,White
TRUE,77,8+0,1898,1881,17,A40,2,Out of Time,White
TRUE,128,8+0,1909,1914,-5,A43,2,Out of Time,Black
TRUE,80,8+0,1922,1821,101,D02,3,Out of Time,Black
TRUE,76,8+0,1931,1977,-46,A46,4,Mate,Black
TRUE,73,8+0,1922,1872,50,D02,4,Resign,White
TRUE,71,8+0,1914,1829,85,A40,2,Out of Time,White
TRUE,70,10+0,1375,1500,-125,C62,6,Resign,Black
FALSE,33,10+2,1384,1325,59,B07,2,Resign,Black
FALSE,29,30+0,1384,1265,119,A06,3,Resign,Black
FALSE,55,2+10,1384,1950,-566,A04,2,Resign,Black
TRUE,91,20+10,1377,1249,128,B01,4,Resign,White
TRUE,53,9+0,1375,1389,-14,C20,4,Resign,White
TRUE,49,10+2,1378,1361,17,C41,5,Mate,White
TRUE,48,10+2,1261,1371,-110,B07,4,Mate,Black
TRUE,20,10+9,1380,1429,-49,B30,4,Resign,Black
TRUE,87,10+0,1369,1368,1,C42,6,Mate,White
TRUE,11,10+0,1290,1371,-81,C77,9,Resign,White
TRUE,110,15+3,1372,1326,46,B00,2,Draw,Draw
TRUE,24,6+7,1361,1383,-22,A00,1,Resign,White
TRUE,23,15+15,1217,1399,-182,A22,4,Resign,White
TRUE,81,15+30,1387,1447,-60,C60,5,Mate,White
FALSE,34,20+0,1474,1387,87,B01,2,Resign,Black
TRUE,103,15+2,1377,1351,26,C41,4,Mate,White
TRUE,29,30+10,1389,1339,50,C40,4,Resign,Black
FALSE,22,30+15,1389,1400,-11,C41,4,Resign,Black
FALSE,38,10+0,1849,1389,460,C44,5,Resign,White
TRUE,46,8+0,1395,1378,17,C50,9,Mate,Black
TRUE,23,5+5,1370,1257,113,C61,6,Out of Time,White
TRUE,31,10+3,1360,1332,28,B00,5,Resign,White
FALSE,51,10+0,1311,1360,-49,C21,4,Resign,White
FALSE,87,20+0,1714,1360,354,C64,6,Mate,White
TRUE,31,45+30,1354,1217,137,C50,5,Mate,White
TRUE,38,15+15,1245,1346,-101,D20,5,Resign,Black
FALSE,43,10+4,1346,1099,247,C55,6,Resign,White
TRUE,105,9+2,1336,1287,49,A07,4,Resign,White
FALSE,53,16+0,1698,1254,444,D14,12,Draw,Draw
FALSE,13,10+25,1254,2344,-1090,D43,8,Resign,Black
FALSE,22,30+30,2454,1254,1200,A06,2,Resign,White
FALSE,2,45+0,1500,1233,267,B20,2,Resign,White
FALSE,25,5+14,1233,1664,-431,C45,7,Resign,Black
FALSE,22,10+5,1902,1233,669,B23,3,Resign,White
TRUE,57,10+0,1158,1155,3,C41,7,Mate,White
TRUE,100,10+0,1158,1158,0,D00,3,Draw,Draw
FALSE,23,10+1,1158,1324,-166,C45,8,Resign,White
FALSE,31,0+180,1158,1324,-166,C45,8,Resign,Black
FALSE,7,0+180,1324,1158,166,C42,5,Resign,White
FALSE,6,0+180,1158,1324,-166,C44,5,Resign,Black
TRUE,26,10+0,1101,1148,-47,C22,7,Resign,Black
TRUE,16,10+0,1159,1165,-6,B57,8,Resign,Black
TRUE,14,10+0,1166,1295,-129,C41,8,Resign,Black
TRUE,78,10+0,1227,1164,63,C42,4,Draw,Draw
TRUE,4,10+0,1500,1168,332,C26,4,Resign,White
TRUE,85,10+0,1157,1156,1,B00,4,Resign,White
TRUE,7,10+0,1156,1157,-1,C20,3,Draw,Draw
TRUE,44,10+0,984,1151,-167,C26,4,Resign,Black
TRUE,61,10+0,1141,1127,14,C42,6,Mate,White
TRUE,47,10+0,1150,1223,-73,C41,7,Resign,Black
TRUE,27,10+0,1127,1166,-39,C40,4,Out of Time,White
TRUE,36,10+0,1177,1137,40,C42,5,Resign,White
TRUE,92,10+0,1155,1125,30,C42,4,Resign,Black
TRUE,24,10+0,1087,1096,-9,C50,5,Mate,Black
TRUE,32,10+0,1054,1100,-46,C44,5,Resign,White
TRUE,122,10+0,1105,1386,-281,B21,3,Resign,Black
TRUE,24,10+0,1056,1119,-63,A30,2,Resign,White
TRUE,15,10+0,1463,1122,341,C65,8,Resign,White
TRUE,64,10+0,1124,1573,-449,C41,5,Resign,Black
TRUE,23,10+0,1572,1126,446,C23,3,Resign,White
TRUE,22,10+0,1135,1209,-74,B21,3,Resign,Black
TRUE,48,10+0,1143,1269,-126,B01,2,Mate,Black
TRUE,46,10+0,1398,1148,250,D30,4,Resign,White
TRUE,32,10+0,1158,1196,-38,C46,7,Resign,Black
TRUE,57,10+0,1393,1163,230,C65,8,Resign,White
TRUE,46,10+0,1172,1286,-114,C46,7,Mate,Black
TRUE,51,10+0,1068,1188,-120,C46,5,Resign,White
TRUE,58,10+0,1207,981,226,B25,4,Resign,Black
TRUE,26,10+0,1208,1194,14,C44,6,Mate,Black
TRUE,50,10+0,1265,1179,86,D00,3,Mate,Black
TRUE,12,10+0,1189,1245,-56,B00,2,Resign,Black
TRUE,23,10+0,1174,1266,-92,C50,8,Mate,White
TRUE,62,10+0,1339,1181,158,C20,3,Resign,White
TRUE,44,10+0,1191,1265,-74,C40,3,Mate,Black
TRUE,52,10+0,1351,1172,179,D01,4,Mate,Black
TRUE,40,10+0,1175,1528,-353,B23,4,Resign,Black
TRUE,17,10+0,1539,1178,361,C50,7,Mate,White
TRUE,37,10+0,1171,1016,155,C40,3,Mate,White
TRUE,25,10+0,1340,1178,162,C64,6,Resign,White
TRUE,26,10+0,1180,1586,-406,B25,4,Resign,Black
TRUE,97,10+0,1563,1183,380,C45,7,Resign,White
TRUE,65,10+0,1657,1185,472,C48,8,Mate,White
TRUE,54,10+0,1162,1610,-448,C46,7,Resign,White
TRUE,31,10+0,1163,1641,-478,B20,2,Resign,Black
TRUE,72,10+0,1336,1154,182,D01,4,Resign,White
TRUE,53,10+0,1136,1307,-171,C41,4,Mate,White
TRUE,24,10+0,1383,1141,242,A30,2,Resign,White
TRUE,116,10+0,1140,1129,11,C55,6,Out of Time,Black
TRUE,51,10+0,1147,957,190,C40,3,Resign,Black
TRUE,29,10+0,1137,1050,87,C41,5,Mate,White
TRUE,49,10+0,1147,1225,-78,C40,6,Resign,Black
TRUE,84,10+0,1129,1135,-6,C20,3,Mate,Black
TRUE,66,10+0,1443,1139,304,C44,5,Resign,White
TRUE,28,10+0,1142,1469,-327,A06,3,Mate,Black
TRUE,45,10+0,1483,1145,338,A00,1,Resign,White
TRUE,127,10+0,1281,1153,128,D30,4,Resign,White
TRUE,24,10+0,1156,1545,-389,C50,8,Resign,Black
TRUE,68,25+10,1652,1739,-87,B10,2,Resign,Black
TRUE,42,15+15,1761,1723,38,B10,2,Resign,Black
TRUE,47,30+30,2200,1725,475,B11,8,Resign,White
TRUE,56,15+15,1748,1505,243,D00,3,Out of Time,Black
TRUE,56,15+15,1677,1736,-59,B13,5,Mate,Black
TRUE,63,25+10,1577,1754,-177,B13,5,Resign,White
TRUE,65,30+30,1753,1179,574,D00,4,Resign,White
TRUE,73,25+10,1726,1711,15,A40,1,Resign,White
TRUE,97,15+15,1693,1743,-50,B10,2,Resign,White
TRUE,21,15+15,1696,1729,-33,D00,3,Resign,Black
TRUE,88,15+15,1732,1652,80,D00,3,Draw,Draw
TRUE,81,15+15,1718,1696,22,D00,3,Resign,White
FALSE,62,15+15,1718,1519,199,A40,2,Resign,Black
TRUE,76,15+15,1742,1533,209,D00,3,Out of Time,Black
TRUE,65,15+15,1712,1605,107,D00,3,Resign,White
TRUE,52,15+15,1733,1666,67,D00,3,Resign,Black
TRUE,75,15+15,1731,1735,-4,C02,8,Resign,White
TRUE,149,15+15,1722,1600,122,D00,3,Mate,White
TRUE,96,15+15,1746,1683,63,A40,2,Mate,Black
TRUE,89,15+15,1794,1765,29,C18,11,Resign,White
TRUE,48,15+15,1729,1564,165,A40,1,Resign,White
FALSE,46,5+8,1749,2119,-370,B12,5,Resign,Black
FALSE,21,5+8,2119,1991,128,C45,7,Out of Time,White
FALSE,58,5+8,1349,2119,-770,D12,8,Out of Time,Black
TRUE,38,10+0,846,2119,-1273,A04,2,Out of Time,Black
TRUE,72,10+0,2147,2113,34,C10,6,Mate,Black
TRUE,68,10+0,2044,2156,-112,D56,14,Draw,Draw
TRUE,132,10+0,2192,2103,89,B54,6,Mate,Black
TRUE,22,10+0,2178,1955,223,A05,4,Resign,White
TRUE,56,10+0,1928,2164,-236,E32,7,Resign,Black
TRUE,85,15+15,2203,2040,163,E15,8,Mate,White
TRUE,44,15+15,1833,2193,-360,E24,9,Resign,Black
TRUE,80,15+15,1980,2173,-193,D45,11,Out of Time,Black
TRUE,43,15+15,2147,2008,139,D87,16,Resign,White
TRUE,98,15+15,2104,2098,6,B19,15,Mate,Black
TRUE,43,15+15,2029,2117,-88,C48,7,Mate,White
TRUE,57,15+15,2120,2010,110,D43,8,Draw,Draw
TRUE,70,15+15,1706,1983,-277,D02,5,Mate,Black
TRUE,49,15+15,1906,1928,-22,C45,7,Resign,White
TRUE,107,15+15,1833,1719,114,A09,4,Resign,White
TRUE,52,15+15,1728,1662,66,B12,5,Mate,Black
TRUE,39,15+15,1500,1500,0,D45,10,Resign,White
TRUE,53,30+30,1757,1992,-235,A25,8,Resign,White
TRUE,46,30+30,2022,1865,157,C01,7,Resign,Black
TRUE,34,10+0,1708,2016,-308,C30,6,Resign,Black
TRUE,60,10+0,1608,2012,-404,C67,10,Resign,Black
TRUE,37,10+0,1806,2048,-242,C55,9,Mate,White
TRUE,118,10+0,1934,2031,-97,A04,2,Resign,Black
TRUE,182,10+0,1787,2020,-233,D07,6,Resign,Black
TRUE,2,15+15,1728,2012,-284,B00,2,Resign,Black
FALSE,77,15+0,2322,2012,310,D07,6,Mate,White
FALSE,65,5+5,2045,2012,33,A20,2,Resign,White
TRUE,38,10+0,1851,1996,-145,D07,6,Resign,Black
TRUE,51,10+0,1936,2001,-65,D07,6,Draw,Draw
TRUE,60,15+10,1957,1972,-15,C46,7,Out of Time,Black
TRUE,38,10+0,1858,1948,-90,C44,5,Out of Time,Black
TRUE,45,10+2,2027,1976,51,C30,6,Mate,White
TRUE,27,5+5,2094,2004,90,D00,3,Resign,White
FALSE,43,10+0,1949,2004,-55,C24,9,Draw,Draw
TRUE,82,10+0,2095,1947,148,B00,5,Resign,Black
TRUE,110,10+0,1964,1892,72,D02,4,Mate,Black
TRUE,65,10+0,1955,1942,13,C57,10,Mate,White
TRUE,35,10+0,2215,1966,249,C45,8,Resign,White
TRUE,75,10+0,2203,1997,206,C45,8,Mate,White
TRUE,147,15+10,1986,2001,-15,B00,5,Draw,Draw
TRUE,84,10+5,2047,1855,192,D00,3,Resign,Black
TRUE,62,5+7,1702,1748,-46,B00,2,Mate,Black
TRUE,87,12+0,1625,1500,125,B00,5,Resign,Black
TRUE,30,15+5,1644,1810,-166,B25,4,Resign,Black
TRUE,127,10+0,1725,1984,-259,B47,10,Mate,White
TRUE,36,10+0,1143,1984,-841,B20,2,Mate,Black
TRUE,49,10+0,1983,1281,702,D00,3,Resign,White
TRUE,28,10+0,1840,1975,-135,B40,5,Resign,Black
TRUE,64,10+0,2091,1985,106,B23,4,Resign,White
TRUE,138,10+0,1891,1974,-83,B40,4,Resign,Black
TRUE,111,10+0,1827,1994,-167,A15,4,Resign,White
TRUE,64,10+0,2003,2121,-118,A45,2,Mate,Black
TRUE,70,10+0,2002,1499,503,D10,4,Resign,White
TRUE,51,10+0,1986,2028,-42,D00,3,Resign,White
TRUE,132,10+0,1769,1980,-211,B20,2,Mate,Black
TRUE,93,10+0,2050,1973,77,D12,8,Draw,Draw
TRUE,91,10+0,1904,1976,-72,B47,10,Draw,Draw
TRUE,58,10+0,1659,1971,-312,B20,3,Resign,Black
TRUE,39,10+0,1965,1741,224,D00,3,Mate,White
TRUE,57,10+0,1962,1559,403,D00,3,Resign,White
TRUE,68,10+0,1839,1952,-113,A08,4,Mate,Black
TRUE,67,10+0,1702,1946,-244,D00,3,Resign,Black
TRUE,146,10+0,1974,1929,45,B44,8,Out of Time,Black
TRUE,61,10+0,1919,1798,121,A80,2,Resign,White
TRUE,132,10+0,1880,1904,-24,B48,11,Resign,Black
TRUE,52,5+10,1481,1659,-178,A17,4,Resign,Black
TRUE,91,5+10,1650,1488,162,B27,3,Resign,White
TRUE,29,15+15,1634,1611,23,B90,10,Out of Time,White
TRUE,22,30+0,1477,1088,389,B00,2,Resign,White
TRUE,69,4+20,1550,1105,445,A40,2,Mate,White
FALSE,33,5+8,1653,1105,548,C40,4,Resign,White
TRUE,110,8+0,1128,1514,-386,C20,3,Resign,Black
TRUE,25,7+2,1347,1213,134,C20,3,Resign,White
TRUE,44,8+8,1322,1500,-178,A04,2,Resign,White
TRUE,51,15+15,1814,1805,9,D02,4,Resign,White
TRUE,41,10+0,1904,1887,17,D31,5,Resign,White
TRUE,99,10+0,1872,2021,-149,D00,5,Resign,White
TRUE,164,10+0,1817,1863,-46,D31,11,Resign,Black
TRUE,40,10+0,1873,1887,-14,A40,2,Resign,Black
TRUE,21,10+0,1951,1882,69,C44,8,Resign,White
TRUE,45,5+12,2062,1888,174,D00,3,Resign,White
TRUE,115,10+0,1875,1975,-100,A45,2,Resign,White
TRUE,34,10+0,2109,1879,230,C53,9,Resign,White
TRUE,20,10+0,1893,1813,80,D00,5,Resign,Black
TRUE,53,10+0,1902,1904,-2,C50,6,Resign,White
TRUE,61,10+0,1857,1916,-59,C89,28,Resign,White
TRUE,79,10+0,1905,1902,3,A41,2,Resign,White
TRUE,19,10+0,2161,1910,251,D30,4,Resign,White
TRUE,83,10+0,1905,1690,215,D00,5,Mate,White
TRUE,91,10+0,1891,2006,-115,D00,5,Mate,White
TRUE,134,10+0,1900,1880,20,C30,4,Mate,Black
TRUE,85,10+0,1878,1927,-49,A45,2,Draw,Draw
FALSE,53,10+5,1738,1500,238,D00,3,Resign,White
FALSE,46,15+2,1488,1738,-250,C50,8,Resign,Black
FALSE,72,5+8,1738,1500,238,D00,3,Resign,Black
TRUE,63,45+45,1726,1738,-12,E92,13,Draw,Draw
FALSE,60,5+8,1500,1738,-238,B92,11,Out of Time,Black
TRUE,31,45+45,1726,1688,38,A46,5,Resign,White
TRUE,62,45+45,1646,1715,-69,B90,11,Mate,Black
FALSE,59,10+0,1500,1715,-215,B94,11,Mate,White
FALSE,48,30+0,1500,1715,-215,B50,4,Mate,Black
FALSE,76,15+15,1715,1652,63,D00,3,Resign,Black
FALSE,49,15+15,1715,1115,600,A41,2,Mate,White
TRUE,115,45+45,1712,1779,-67,A45,2,Draw,Draw
FALSE,58,5+8,1712,1500,212,D00,3,Resign,Black
FALSE,15,10+0,1712,1087,625,D00,3,Resign,White
FALSE,50,5+8,1500,1712,-212,B90,10,Mate,Black
FALSE,57,10+0,1430,1712,-282,A00,1,Mate,White
TRUE,74,45+45,1650,1699,-49,B30,4,Resign,Black
TRUE,69,10+0,1500,1713,-213,B50,5,Out of Time,White
TRUE,68,60+0,1410,1709,-299,B22,3,Mate,Black
FALSE,23,10+2,1709,1500,209,D00,3,Resign,White
TRUE,55,45+45,1692,1741,-49,D00,3,Resign,White
FALSE,57,60+0,1692,1500,192,D00,3,Mate,White
TRUE,88,10+15,1361,1688,-327,B20,2,Mate,Black
TRUE,81,15+10,1683,1366,317,D00,3,Resign,White
TRUE,25,15+0,1667,1480,187,A40,2,Resign,White
FALSE,61,20+0,1663,1500,163,D00,4,Mate,White
FALSE,74,7+7,1663,1487,176,A40,2,Out of Time,Black
FALSE,68,7+7,1487,1663,-176,B20,2,Mate,Black
FALSE,26,180+0,926,1663,-737,B20,3,Resign,Black
FALSE,25,15+15,1852,1663,189,A40,2,Resign,Black
FALSE,60,15+10,1663,1223,440,A44,4,Resign,White
FALSE,48,35+1,1500,1663,-163,B20,3,Mate,Black
TRUE,25,10+10,1653,1535,118,D20,5,Resign,White
FALSE,94,10+0,1653,1500,153,C50,6,Out of Time,Black
FALSE,58,15+0,1653,1500,153,C50,6,Resign,Black
FALSE,73,10+11,1653,1403,250,C41,5,Mate,White
FALSE,11,10+11,1403,1653,-250,B20,3,Resign,Black
FALSE,22,15+5,1500,1653,-153,B50,4,Out of Time,Black
TRUE,49,8+45,1645,1436,209,C55,7,Resign,White
TRUE,114,20+0,1370,1639,-269,A46,5,Mate,Black
TRUE,46,10+0,1659,1592,67,B20,2,Out of Time,Black
FALSE,22,25+5,1211,1659,-448,A03,2,Mate,Black
TRUE,201,30+15,1665,1526,139,D31,6,Draw,Draw
TRUE,65,10+0,1822,1767,55,C02,11,Resign,White
TRUE,67,10+0,1754,1835,-81,C03,5,Resign,White
TRUE,51,10+0,1732,1784,-52,B30,4,Resign,White
TRUE,135,10+0,1875,1739,136,C02,7,Resign,White
TRUE,63,10+0,1731,1653,78,C64,9,Mate,White
TRUE,69,10+0,1721,1697,24,C64,7,Resign,White
TRUE,121,10+0,1696,1733,-37,C02,6,Out of Time,White
TRUE,65,10+0,1722,1727,-5,B01,4,Mate,White
TRUE,129,10+0,1779,1731,48,A18,5,Out of Time,White
TRUE,85,10+0,1766,1741,25,C00,3,Resign,White
TRUE,56,10+0,1751,1745,6,C41,5,Mate,Black
TRUE,123,10+0,1793,1761,32,D30,4,Resign,White
TRUE,49,10+0,1737,1772,-35,C00,3,Resign,White
TRUE,55,10+0,1762,1747,15,C62,6,Mate,White
TRUE,62,10+0,1664,1754,-90,C00,3,Mate,Black
TRUE,95,10+0,1748,1614,134,C41,5,Resign,White
TRUE,160,10+0,1651,1740,-89,C00,2,Mate,Black
TRUE,96,10+0,1748,1813,-65,B03,6,Resign,Black
TRUE,85,10+0,1737,1752,-15,B22,6,Resign,White
TRUE,90,10+0,1802,1725,77,A40,2,Mate,Black
TRUE,33,10+0,1684,1715,-31,C02,7,Resign,Black
TRUE,107,10+0,1709,1726,-17,C00,3,Mate,White
TRUE,60,10+0,1731,1958,-227,C62,6,Resign,Black
TRUE,65,10+0,1721,1695,26,C41,5,Resign,White
TRUE,59,10+0,1611,1735,-124,C02,9,Resign,White
TRUE,69,10+0,1724,1735,-11,B01,4,Mate,White
TRUE,101,10+0,1671,1737,-66,C00,3,Mate,White
TRUE,85,10+0,1727,1680,47,C03,5,Out of Time,White
TRUE,47,10+0,1705,1718,-13,A40,2,Resign,Black
TRUE,73,10+0,1708,1696,12,B00,2,Out of Time,White
TRUE,59,10+0,1740,1709,31,E11,8,Mate,White
TRUE,68,8+0,1719,1737,-18,C60,5,Mate,Black
TRUE,96,8+0,1833,1705,128,A47,4,Mate,Black
TRUE,123,10+0,1751,1715,36,C01,5,Resign,White
TRUE,113,10+0,1698,1925,-227,B12,5,Out of Time,White
TRUE,44,10+0,1709,1706,3,C42,5,Mate,Black
TRUE,155,10+0,1600,1723,-123,C00,3,Mate,White
TRUE,74,10+0,1739,1712,27,C14,12,Out of Time,Black
TRUE,103,10+0,1705,1564,141,B22,6,Resign,White
TRUE,128,10+0,1744,1704,40,B20,2,Out of Time,Draw
TRUE,70,10+0,1715,1685,30,B22,3,Mate,Black
TRUE,74,10+0,1637,1707,-70,C00,2,Resign,Black
TRUE,79,8+0,1701,1500,201,C03,6,Mate,White
TRUE,81,8+0,1643,1714,-71,C02,7,Mate,White
TRUE,91,10+0,1706,1714,-8,C02,7,Draw,Draw
TRUE,121,10+0,1707,1585,122,C40,4,Out of Time,White
TRUE,180,8+0,1705,1783,-78,C42,5,Out of Time,Draw
TRUE,61,10+0,1694,1695,-1,B12,3,Mate,White
TRUE,82,10+8,2040,2020,20,E53,12,Resign,White
TRUE,92,12+15,2017,2008,9,E68,15,Resign,Black
TRUE,43,12+5,1846,2025,-179,B24,6,Mate,White
TRUE,25,14+14,2014,1999,15,D53,8,Resign,White
TRUE,68,10+0,1879,2007,-128,C44,5,Mate,Black
TRUE,34,12+5,2012,2216,-204,B35,13,Resign,Black
TRUE,41,12+5,2208,2018,190,C45,9,Resign,White
TRUE,26,12+5,2024,2200,-176,B35,13,Resign,Black
TRUE,51,15+0,2019,1778,241,A21,3,Resign,White
TRUE,118,20+0,2055,2007,48,E20,8,Resign,Black
TRUE,65,10+0,1997,1956,41,B94,11,Resign,White
TRUE,83,10+0,1840,2013,-173,E20,8,Out of Time,White
TRUE,45,10+0,2008,1795,213,C54,11,Resign,White
TRUE,30,10+0,2018,2053,-35,C54,11,Resign,Black
TRUE,58,15+10,1971,2019,-48,E17,15,Draw,Draw
TRUE,31,8+0,2006,2078,-72,B76,17,Resign,White
TRUE,129,10+0,1999,1863,136,C55,6,Mate,White
TRUE,36,10+0,1967,1989,-22,E35,10,Out of Time,Black
TRUE,41,10+0,1773,1984,-211,E20,8,Resign,Black
TRUE,32,10+0,1979,1778,201,C10,5,Resign,White
FALSE,28,10+30,1972,2447,-475,D57,16,Resign,Black
TRUE,64,15+0,1840,1972,-132,B22,6,Mate,Black
TRUE,144,10+5,1792,1977,-185,E27,10,Draw,Draw
TRUE,108,10+0,1990,1913,77,B32,7,Out of Time,Black
TRUE,34,10+0,2001,2006,-5,C42,15,Resign,Black
TRUE,38,10+0,2019,1989,30,C30,4,Resign,Black
TRUE,131,6+10,1981,1865,116,D55,11,Resign,White
TRUE,58,15+5,1878,1973,-95,C88,20,Resign,Black
TRUE,24,10+0,1987,1883,104,B43,10,Resign,Black
TRUE,63,10+0,1977,1948,29,D15,7,Resign,White
TRUE,45,15+15,1617,1437,180,C00,3,Resign,Black
TRUE,32,15+15,1471,1610,-139,C02,7,Resign,Black
TRUE,41,15+15,1599,1606,-7,C44,5,Resign,White
TRUE,37,15+15,1588,1612,-24,C02,9,Resign,White
TRUE,23,15+15,1520,1601,-81,C00,5,Resign,White
TRUE,20,15+15,1610,1635,-25,B54,6,Resign,Black
TRUE,84,15+15,1548,1601,-53,E20,6,Resign,Black
TRUE,21,15+15,1527,1614,-87,C00,3,Resign,White
TRUE,21,15+15,1623,1684,-61,B01,4,Resign,Black
TRUE,79,15+15,1524,1637,-113,C00,3,Resign,White
TRUE,71,15+15,1626,1624,2,B40,6,Mate,White
TRUE,53,15+15,1618,1525,93,B01,4,Resign,White
TRUE,72,15+15,1703,1604,99,C00,3,Resign,Black
TRUE,55,15+15,1494,1619,-125,C00,7,Resign,White
TRUE,32,15+15,1630,1629,1,B32,8,Resign,Black
TRUE,61,15+15,1594,1642,-48,C00,3,Resign,White
TRUE,56,15+15,1460,1636,-176,C02,7,Resign,Black
TRUE,87,15+15,1627,1573,54,C41,8,Mate,White
TRUE,55,15+15,1615,1662,-47,C00,3,Out of Time,White
TRUE,39,15+15,1636,1625,11,C03,5,Mate,White
TRUE,72,15+15,1610,1614,-4,C00,3,Mate,Black
TRUE,25,15+15,1602,1621,-19,C44,5,Mate,White
TRUE,128,15+15,1624,1602,22,E10,5,Draw,Draw
TRUE,19,15+15,1591,1575,16,B12,7,Resign,White
TRUE,57,15+15,1572,1869,-297,C44,11,Resign,White
TRUE,28,15+15,1561,1557,4,C00,3,Resign,Black
TRUE,60,30+30,1751,1539,212,E48,10,Mate,Black
TRUE,69,15+15,1530,1444,86,C44,5,Mate,White
TRUE,136,30+30,1922,1533,389,C03,5,Resign,White
TRUE,48,15+15,1468,1524,-56,C02,6,Mate,Black
TRUE,30,15+15,1524,1513,11,A22,6,Resign,Black
TRUE,57,30+30,1511,997,514,B32,5,Resign,White
TRUE,26,15+15,1511,1528,-17,C44,5,Draw,Draw
TRUE,69,15+15,1499,1519,-20,B94,11,Resign,White
TRUE,71,15+15,1474,1500,-26,E20,8,Draw,Draw
TRUE,114,15+15,1500,1492,8,C01,5,Mate,Black
TRUE,9,15+15,1482,1455,27,C42,6,Resign,White
TRUE,54,15+15,1310,1476,-166,C02,7,Resign,Black
TRUE,23,15+15,1466,1433,33,B32,5,Resign,White
TRUE,23,15+15,1506,1476,30,D35,7,Resign,White
TRUE,21,15+15,1514,1486,28,D15,8,Resign,White
TRUE,40,15+15,1495,1562,-67,C44,7,Resign,Black
TRUE,50,15+15,1306,1489,-183,D35,7,Mate,Black
TRUE,57,15+15,1479,1459,20,C44,5,Resign,White
TRUE,24,15+15,1490,1487,3,C44,5,Resign,Black
TRUE,40,15+15,1453,1503,-50,C02,5,Resign,White
TRUE,16,15+15,1516,1467,49,B12,7,Resign,Black
TRUE,77,30+30,2131,2103,28,B32,10,Resign,White
TRUE,68,30+30,2144,2079,65,C05,12,Resign,Black
TRUE,78,30+30,2046,2136,-90,E73,12,Resign,Black
FALSE,41,15+10,2136,2243,-107,B02,4,Resign,White
FALSE,109,5+5,2136,1931,205,C60,8,Resign,White
FALSE,30,5+5,1931,2136,-205,C44,5,Mate,Black
FALSE,33,5+5,2136,1931,205,C60,8,Resign,White
FALSE,43,5+5,1931,2136,-205,C55,7,Resign,White
FALSE,72,5+5,2136,1931,205,C60,8,Resign,Black
TRUE,109,60+30,2123,2214,-91,C60,6,Resign,White
TRUE,100,15+10,2004,2115,-111,E77,8,Resign,Black
TRUE,61,15+10,2108,1984,124,C03,6,Resign,White
TRUE,88,10+0,1935,2102,-167,E77,8,Resign,Black
TRUE,62,30+30,2109,2240,-131,B01,6,Resign,Black
TRUE,122,30+30,1902,2104,-202,E94,14,Resign,Black
TRUE,32,10+0,1980,2097,-117,A48,5,Resign,Black
FALSE,79,90+30,2204,2097,107,A04,3,Resign,White
FALSE,104,45+45,2097,2243,-146,B20,3,Resign,Black
TRUE,70,45+45,2085,2097,-12,C75,10,Draw,Draw
TRUE,136,15+0,2178,2094,84,E92,13,Draw,Draw
TRUE,144,15+0,2104,2124,-20,B56,11,Resign,Black
TRUE,66,15+0,2119,1959,160,C68,7,Resign,Black
TRUE,47,30+30,1595,1332,263,A45,2,Resign,White
TRUE,58,30+30,1334,1735,-401,E51,10,Resign,Black
FALSE,54,30+30,1334,2475,-1141,A40,4,Resign,Black
FALSE,38,10+0,2108,1334,774,C55,7,Out of Time,Black
TRUE,71,30+30,1738,1337,401,C68,9,Resign,White
FALSE,57,10+2,2549,1337,1212,C44,5,Resign,White
FALSE,53,10+0,1337,1331,6,D41,11,Mate,White
FALSE,43,10+0,1337,1331,6,A44,6,Resign,White
FALSE,67,10+0,1337,1331,6,D85,8,Resign,White
TRUE,147,10+0,1601,1341,260,C77,9,Mate,White
TRUE,38,10+0,1347,1546,-199,D20,5,Resign,Black
TRUE,76,10+0,1330,1653,-323,D20,5,Resign,Black
TRUE,86,10+0,1776,1735,41,B13,7,Resign,Black
TRUE,99,10+0,1721,1834,-113,D17,10,Resign,White
TRUE,47,10+0,1793,1730,63,B13,7,Resign,White
FALSE,44,10+0,1784,1812,-28,B08,8,Resign,Black
FALSE,62,10+0,1812,2012,-200,A43,2,Resign,Black
FALSE,44,5+5,1624,1812,-188,E61,9,Resign,Black
FALSE,85,10+0,1812,1897,-85,A46,5,Draw,Draw
FALSE,91,10+0,1791,1812,-21,B09,10,Resign,White
FALSE,71,10+0,1812,1704,108,D02,4,Mate,White
FALSE,63,10+0,1812,1812,0,D02,3,Resign,White
FALSE,53,10+0,1816,1812,4,E61,9,Resign,Black
FALSE,76,10+0,1812,1853,-41,D02,5,Resign,Black
FALSE,124,10+0,1156,1812,-656,A00,1,Mate,Black
FALSE,132,10+0,1757,1812,-55,E60,5,Mate,Black
FALSE,70,10+0,1812,1852,-40,D02,3,Mate,Black
FALSE,70,10+0,1285,1812,-527,A48,5,Mate,Black
FALSE,39,10+0,1812,1820,-8,D02,5,Resign,White
FALSE,61,10+0,1812,1500,312,D02,3,Mate,White
FALSE,62,10+0,1711,1812,-101,A00,1,Out of Time,Black
FALSE,38,10+0,1625,1812,-187,B07,6,Resign,Black
FALSE,95,10+0,1711,1812,-101,B07,2,Mate,White
FALSE,69,10+0,1812,1792,20,D02,4,Resign,White
FALSE,35,10+0,1812,1624,188,A41,2,Resign,White
FALSE,43,10+0,1742,1812,-70,A45,2,Resign,White
FALSE,109,10+0,1760,1812,-52,E91,11,Mate,White
FALSE,79,10+0,1812,1726,86,D02,3,Out of Time,White
FALSE,74,10+0,1800,1812,-12,B07,7,Resign,Black
FALSE,120,10+0,1812,1834,-22,A80,2,Out of Time,Black
FALSE,62,10+0,1812,2203,-391,D02,5,Mate,Black
FALSE,189,10+0,1500,1812,-312,A49,4,Draw,Draw
FALSE,86,10+0,1921,1812,109,B08,8,Draw,Draw
FALSE,88,10+0,1812,1921,-109,D02,5,Resign,Black
FALSE,35,10+0,1812,1664,148,A40,2,Resign,White
FALSE,39,10+0,1755,1812,-57,B07,6,Resign,White
FALSE,72,10+0,1500,1812,-312,A00,1,Resign,Black
FALSE,31,10+0,1812,1709,103,A40,2,Resign,White
FALSE,72,10+0,1812,1837,-25,A46,5,Resign,Black
FALSE,95,10+0,1695,1812,-117,E81,10,Mate,White
FALSE,94,10+0,1812,1975,-163,D02,5,Mate,Black
FALSE,48,10+0,1446,1812,-366,A00,5,Resign,Black
FALSE,126,10+0,1862,1812,50,E61,6,Resign,Black
FALSE,51,10+0,1812,1735,77,A40,1,Resign,White
FALSE,83,10+0,1787,1812,-25,A15,4,Resign,White
FALSE,65,20+0,983,1714,-731,C44,4,Resign,Black
TRUE,60,30+30,994,1192,-198,C10,6,Mate,Black
TRUE,57,30+30,1511,997,514,B32,5,Resign,White
TRUE,39,45+45,1616,998,618,C50,5,Mate,White
TRUE,62,30+30,999,1701,-702,B01,2,Mate,Black
FALSE,26,9+8,999,1368,-369,C77,9,Mate,Black
FALSE,93,20+20,1810,999,811,B20,2,Mate,White
FALSE,48,20+20,999,1810,-811,B01,6,Mate,Black
FALSE,43,20+20,1810,999,811,C67,8,Mate,White
FALSE,34,20+20,999,1810,-811,B00,2,Mate,Black
FALSE,35,20+20,1810,999,811,B20,2,Resign,White
FALSE,46,20+20,999,1810,-811,B20,2,Mate,Black
TRUE,45,20+20,1300,1006,294,C47,7,Mate,White
FALSE,28,45+45,1812,1006,806,B54,5,Resign,White
FALSE,26,5+5,1424,1006,418,C45,7,Resign,White
FALSE,27,5+5,1006,1293,-287,B00,2,Resign,Black
TRUE,76,9+4,1015,981,34,B20,2,Mate,Black
FALSE,61,45+45,1349,981,368,D10,4,Mate,White
FALSE,29,5+5,1601,981,620,C48,7,Mate,White
TRUE,28,15+0,1024,952,72,C44,5,Resign,Black
TRUE,73,6+7,965,1160,-195,C44,4,Resign,Black
TRUE,105,10+1,1366,970,396,B23,3,Mate,White
TRUE,49,10+8,1164,984,180,B20,2,Resign,White
TRUE,16,15+15,1003,1122,-119,C41,4,Mate,Black
FALSE,65,15+15,1003,1813,-810,B20,2,Draw,Draw
FALSE,52,15+15,1003,1623,-620,C42,4,Mate,Black
TRUE,82,45+45,2207,2079,128,C65,6,Resign,Black
TRUE,92,15+10,2017,2070,-53,C65,6,Resign,Black
TRUE,42,15+10,2088,1815,273,C50,9,Mate,Black
TRUE,86,15+10,1890,2083,-193,C54,11,Resign,Black
TRUE,86,15+10,2078,1843,235,D30,4,Resign,White
TRUE,102,15+10,2077,2090,-13,A40,4,Draw,Draw
TRUE,42,15+10,1842,2073,-231,A57,6,Out of Time,Black
TRUE,54,15+10,2064,1986,78,A60,6,Resign,White
TRUE,77,15+10,1818,2060,-242,C67,10,Resign,Black
TRUE,62,15+10,2052,1940,112,A40,2,Resign,White
TRUE,36,15+10,1949,2044,-95,C50,9,Resign,Black
TRUE,118,15+10,2060,1865,195,D02,5,Resign,Black
TRUE,122,15+10,2035,2050,-15,C67,8,Mate,Black
TRUE,75,15+10,2043,1898,145,A40,4,Resign,White
TRUE,90,15+10,2050,2028,22,E90,9,Resign,Black
TRUE,57,15+10,2044,1874,170,A40,6,Resign,White
TRUE,69,15+10,1877,2044,-167,C67,10,Resign,White
FALSE,101,10+5,2044,1491,553,D06,4,Mate,White
TRUE,62,15+10,2044,2122,-78,D35,6,Resign,Black
FALSE,66,10+5,2044,2022,22,E20,5,Draw,Draw
TRUE,107,15+10,2037,1882,155,B12,5,Resign,White
TRUE,25,15+10,1866,2054,-188,C54,13,Resign,White
TRUE,83,15+10,2041,2081,-40,A41,4,Resign,White
TRUE,117,15+10,1979,2055,-76,C45,9,Resign,White
TRUE,129,15+10,2047,1961,86,E97,17,Mate,White
TRUE,46,15+10,2041,2035,6,C54,19,Resign,Black
TRUE,46,15+10,2035,1910,125,A40,2,Resign,Black
TRUE,90,15+10,2043,2023,20,E59,19,Resign,Black
TRUE,45,15+10,2016,1880,136,B32,10,Resign,White
TRUE,31,15+10,1967,2028,-61,C45,8,Resign,White
TRUE,47,10+0,1599,1647,-48,B23,4,Resign,White
FALSE,9,180+180,1599,1647,-48,B23,3,Draw,Draw
TRUE,65,10+0,1612,1610,2,C42,5,Resign,White
TRUE,154,10+0,1382,1605,-223,C70,8,Out of Time,Black
TRUE,53,10+0,1592,1671,-79,B24,5,Mate,White
TRUE,19,10+0,1586,1416,170,C40,4,Resign,White
TRUE,47,10+0,1572,1597,-25,D00,2,Mate,White
TRUE,42,10+0,1667,1584,83,D06,8,Resign,Black
FALSE,52,5+5,1500,1833,-333,B30,4,Mate,Black
TRUE,108,10+0,1665,1826,-161,A01,5,Out of Time,Black
TRUE,64,10+0,1619,1820,-201,B22,3,Mate,Black
FALSE,31,5+5,1814,1500,314,A40,2,Mate,White
TRUE,64,10+0,1626,2082,-456,B01,4,Mate,Black
TRUE,48,8+7,1639,1728,-89,C48,7,Mate,Black
TRUE,33,5+5,1733,1661,72,C34,6,Mate,White
TRUE,69,10+0,1986,1666,320,D01,5,Resign,White
TRUE,63,10+0,1681,1488,193,B20,3,Resign,White
TRUE,47,10+0,1521,1709,-188,C24,4,Resign,White
TRUE,95,10+0,1686,1745,-59,B10,2,Resign,White
TRUE,15,10+15,1809,1701,108,C45,7,Resign,White
TRUE,68,10+0,1713,1882,-169,C11,7,Resign,Black
TRUE,14,10+5,1773,1685,88,C55,7,Resign,Black
TRUE,56,10+0,1706,1741,-35,C50,6,Resign,Black
TRUE,30,5+10,2076,1712,364,D06,4,Resign,White
TRUE,19,40+30,1735,1771,-36,C41,4,Resign,Black
TRUE,45,60+0,1053,840,213,C20,3,Resign,White
FALSE,5,10+0,1010,840,170,C41,5,Resign,White
FALSE,21,10+5,1381,840,541,C20,4,Resign,White
TRUE,129,10+2,966,857,109,C20,3,Mate,White
TRUE,30,25+15,860,1424,-564,D00,3,Resign,Black
FALSE,85,10+2,1314,860,454,D00,3,Resign,Black
TRUE,51,30+30,1871,2101,-230,B18,8,Resign,White
TRUE,44,30+30,2250,1793,457,B07,2,Resign,White
TRUE,58,10+0,1820,1543,277,A40,2,Mate,Black
TRUE,124,10+0,1826,2019,-193,A45,2,Mate,Black
TRUE,70,10+0,1531,1822,-291,A00,1,Out of Time,Black
TRUE,140,10+0,1826,2162,-336,A40,2,Mate,Black
TRUE,50,10+0,1626,1820,-194,B08,8,Resign,Black
FALSE,120,10+0,1812,1834,-22,A80,2,Out of Time,Black
TRUE,122,10+0,1716,1850,-134,B07,4,Resign,White
TRUE,42,10+0,1879,1837,42,B07,6,Out of Time,Black
TRUE,79,10+0,1825,1850,-25,D00,3,Mate,White
TRUE,70,10+0,1832,1983,-151,A80,2,Mate,Black
TRUE,80,10+0,1844,1783,61,D00,3,Resign,Black
TRUE,81,10+0,1837,1687,150,A45,2,Mate,White
TRUE,111,10+0,1861,1837,24,B07,7,Resign,White
TRUE,56,10+0,1808,1826,-18,B07,2,Resign,Black
TRUE,42,30+30,1821,1600,221,D00,3,Resign,White
TRUE,79,10+0,1818,1558,260,D00,3,Mate,White
TRUE,52,10+0,1540,1814,-274,B07,6,Out of Time,Black
TRUE,115,10+0,1797,1962,-165,A40,1,Resign,White
TRUE,59,10+0,1879,1806,73,A80,2,Resign,White
TRUE,96,10+0,1931,1790,141,B07,4,Out of Time,Black
TRUE,62,10+0,1800,1853,-53,D00,3,Resign,Black
TRUE,54,10+0,1802,2181,-379,A45,2,Mate,Black
TRUE,59,10+0,1744,1817,-73,B09,7,Resign,White
TRUE,126,10+0,1828,1834,-6,D00,3,Mate,Black
TRUE,44,10+0,1293,1827,-534,A00,1,Mate,Black
TRUE,85,10+0,1823,1560,263,D00,3,Resign,White
TRUE,85,10+0,1861,1833,28,A84,3,Out of Time,White
TRUE,46,10+0,1802,1822,-20,B07,2,Resign,Black
FALSE,47,14+15,1822,1324,498,A45,2,Mate,White
TRUE,70,30+30,2114,1826,288,B09,11,Resign,White
TRUE,81,20+20,1771,1840,-69,B07,2,Resign,White
TRUE,48,20+20,1877,1827,50,B07,2,Resign,Black
FALSE,76,12+10,1827,1812,15,A45,2,Out of Time,Black
TRUE,56,10+0,1803,1809,-6,A84,3,Resign,Black
TRUE,75,30+30,1802,1652,150,D00,4,Resign,White
TRUE,48,10+0,1804,2222,-418,A45,2,Resign,Black
TRUE,52,10+0,1810,1990,-180,D00,3,Resign,Black
TRUE,57,10+0,1795,1880,-85,A45,2,Resign,White
TRUE,88,10+0,1804,1783,21,A84,3,Resign,Black
TRUE,69,10+0,2020,1788,232,A04,2,Mate,White
TRUE,58,10+0,1510,1796,-286,B07,7,Draw,Draw
TRUE,58,10+0,1618,1572,46,B00,5,Resign,White
FALSE,53,10+5,1572,1720,-148,A06,2,Resign,White
TRUE,78,10+0,1589,1553,36,A15,3,Mate,Black
TRUE,76,10+10,1521,1580,-59,B20,3,Resign,Black
TRUE,21,5+8,1710,1587,123,A45,2,Resign,White
FALSE,114,3+10,1587,1562,25,A06,2,Mate,Black
TRUE,107,12+4,1586,1637,-51,A04,2,Draw,Draw
TRUE,54,12+4,1638,1584,54,B20,3,Draw,Draw
TRUE,95,15+0,1575,1527,48,A04,2,Mate,White
TRUE,28,5+10,1533,1565,-32,B33,11,Resign,Black
TRUE,28,10+0,1627,1574,53,C53,7,Resign,White
TRUE,91,10+0,1462,1589,-127,B00,2,Mate,White
TRUE,47,10+0,1572,1600,-28,C44,5,Mate,White
TRUE,88,5+10,1612,1579,33,D02,4,Mate,Black
TRUE,52,10+0,1620,1723,-103,D02,5,Mate,Black
TRUE,73,10+0,1351,1637,-286,E24,9,Mate,White
TRUE,68,10+0,1671,1626,45,E38,8,Mate,Black
FALSE,92,3+10,1626,1615,11,A06,3,Resign,Black
TRUE,33,10+0,1614,1649,-35,A28,7,Resign,White
TRUE,20,10+0,1610,1603,7,A00,2,Resign,Black
TRUE,41,10+0,1596,1463,133,C00,3,Mate,White
TRUE,93,10+0,1591,1607,-16,B30,4,Mate,White
TRUE,50,15+8,1618,1629,-11,D02,4,Resign,Black
TRUE,155,10+0,1641,1628,13,B02,4,Mate,White
TRUE,74,10+0,1636,1725,-89,B27,4,Out of Time,Black
FALSE,155,15+15,1636,1357,279,D02,4,Out of Time,White
TRUE,127,5+5,1725,1644,81,C20,3,Resign,White
FALSE,65,10+0,1500,1500,0,C70,8,Resign,White
FALSE,42,10+0,1500,1500,0,C50,5,Resign,Black
FALSE,60,10+0,1316,1500,-184,C42,5,Resign,Black
FALSE,44,8+0,1306,1500,-194,D11,6,Resign,Black
FALSE,145,8+0,1500,1500,0,C50,6,Out of Time,Draw
FALSE,68,10+0,1095,1500,-405,C50,9,Resign,White
FALSE,14,10+0,1500,1386,114,C42,5,Resign,Black
FALSE,68,10+10,1500,1500,0,C50,6,Resign,Black
FALSE,58,10+0,1500,1500,0,D02,3,Resign,Black
FALSE,25,10+0,1500,1500,0,D02,3,Mate,White
FALSE,57,10+0,1500,1500,0,C41,8,Resign,White
FALSE,24,10+0,1244,1500,-256,C20,3,Mate,Black
FALSE,41,10+0,1500,1334,166,C41,6,Out of Time,White
FALSE,37,10+0,1500,1595,-95,C40,4,Draw,Draw
FALSE,45,10+0,1500,1500,0,B20,3,Mate,White
FALSE,54,10+0,1306,1500,-194,C46,6,Mate,Black
FALSE,62,10+0,1017,1500,-483,C20,3,Mate,Black
FALSE,57,10+0,1316,1500,-184,C26,5,Mate,White
FALSE,60,10+0,1500,1230,270,C50,6,Draw,Draw
FALSE,95,10+0,1039,1500,-461,A01,2,Resign,White
FALSE,66,10+0,1500,1500,0,C02,9,Resign,Black
FALSE,171,10+0,1500,1500,0,C20,3,Out of Time,White
FALSE,3,10+0,1500,1229,271,C40,3,Resign,White
FALSE,126,10+0,1500,1500,0,C55,6,Resign,Black
FALSE,13,10+0,1500,1500,0,D15,7,Resign,Black
FALSE,49,10+0,1500,1500,0,C40,4,Resign,Black
FALSE,59,10+0,1294,1500,-206,C47,7,Resign,Black
FALSE,53,10+0,1491,1500,-9,C55,7,Mate,White
FALSE,66,10+0,1500,1500,0,C42,5,Resign,Black
FALSE,59,10+0,1500,1178,322,B20,3,Mate,White
FALSE,98,10+0,1500,1500,0,C41,7,Resign,Black
FALSE,64,10+0,1249,1500,-251,C44,4,Out of Time,Black
FALSE,43,10+0,1500,1095,405,B20,3,Resign,White
FALSE,29,10+0,1500,1449,51,B20,3,Mate,White
FALSE,30,10+0,1500,1500,0,C02,9,Resign,Black
FALSE,54,10+0,1500,1040,460,C41,5,Draw,Draw
FALSE,56,10+0,1500,1500,0,C68,7,Resign,Black
FALSE,47,10+0,1500,1500,0,C20,3,Resign,White
FALSE,46,10+0,929,1500,-571,A00,1,Mate,Black
FALSE,59,10+0,1500,1443,57,B12,7,Resign,White
FALSE,47,10+0,1567,1500,67,A00,1,Mate,White
FALSE,35,10+0,1500,1500,0,D05,6,Mate,White
FALSE,11,10+0,1500,1358,142,C42,6,Resign,White
FALSE,98,10+0,1500,1500,0,C02,10,Resign,Black
FALSE,31,8+1,1500,1144,356,C50,6,Draw,Draw
TRUE,39,15+0,1612,1552,60,C42,5,Resign,White
TRUE,70,15+0,1562,1602,-40,C40,4,Mate,Black
TRUE,52,15+0,1615,1548,67,C20,3,Mate,Black
TRUE,66,10+0,1605,1558,47,C42,5,Resign,White
TRUE,92,7+2,1571,1536,35,C43,6,Mate,Black
TRUE,59,7+2,2087,1572,515,C43,6,Mate,White
TRUE,43,7+2,1564,1476,88,C45,7,Resign,White
TRUE,110,10+0,1573,1633,-60,B54,6,Mate,Black
TRUE,51,10+0,2141,1574,567,C24,4,Resign,White
TRUE,117,10+0,1718,1581,137,C42,5,Resign,White
TRUE,113,10+0,1589,1694,-105,C45,7,Resign,Black
TRUE,29,10+0,1572,1782,-210,C45,7,Mate,White
TRUE,48,10+0,1377,1550,-173,A40,3,Resign,Black
TRUE,130,10+0,1553,1882,-329,B01,6,Mate,Black
TRUE,47,10+0,1539,1621,-82,C01,5,Resign,White
TRUE,55,10+0,1789,1544,245,A40,3,Resign,White
TRUE,146,10+0,1557,1496,61,C45,8,Resign,Black
TRUE,17,10+0,1697,1564,133,C42,5,Resign,White
TRUE,57,10+0,1554,1517,37,B32,6,Resign,White
TRUE,66,10+0,1559,1789,-230,B01,4,Mate,Black
TRUE,30,10+0,1462,1550,-88,C21,3,Resign,Black
TRUE,38,10+0,1561,1562,-1,C41,5,Resign,Black
TRUE,30,15+8,1567,1573,-6,A04,2,Resign,White
TRUE,48,10+0,1586,1558,28,C42,4,Mate,Black
TRUE,60,10+0,1439,1578,-139,C31,6,Resign,Black
TRUE,51,10+0,1577,1127,450,C40,4,Mate,White
TRUE,14,10+0,1508,1567,-59,A00,2,Mate,Black
TRUE,156,10+0,1568,2067,-499,C45,7,Mate,Black
TRUE,54,10+0,1099,1567,-468,C24,4,Mate,Black
TRUE,86,10+0,1579,1543,36,B44,8,Resign,Black
TRUE,59,10+0,1569,1542,27,C42,6,Mate,White
TRUE,64,10+0,1388,1563,-175,A21,3,Out of Time,Black
TRUE,71,10+0,1715,1569,146,C31,6,Mate,White
TRUE,105,10+0,1561,1491,70,B00,2,Out of Time,White
TRUE,72,10+0,1569,1653,-84,C45,7,Resign,Black
TRUE,46,10+0,1562,1558,4,C42,4,Resign,Black
TRUE,42,10+0,1456,1549,-93,C42,5,Resign,Black
TRUE,52,10+0,1559,1623,-64,B32,6,Resign,Black
TRUE,40,10+0,1563,1824,-261,C44,11,Mate,Black
TRUE,48,10+0,1480,1554,-74,C41,5,Mate,Black
TRUE,55,10+0,1842,1558,284,A40,4,Resign,White
TRUE,56,10+0,1570,1534,36,C41,7,Resign,Black
TRUE,60,10+0,1563,1582,-19,C26,7,Resign,White
TRUE,42,10+0,1652,1568,84,A21,3,Resign,Black
TRUE,69,10+0,1555,1591,-36,C40,4,Mate,White
TRUE,50,10+0,1558,1962,-404,C01,5,Resign,Black
TRUE,53,10+0,1651,1566,85,A22,4,Mate,White
TRUE,53,10+0,1653,1627,26,C00,3,Out of Time,White
TRUE,116,20+10,1729,1639,90,B22,3,Resign,Black
TRUE,105,15+10,1630,1651,-21,B50,4,Resign,White
TRUE,64,30+30,1653,2040,-387,D00,3,Resign,Black
TRUE,45,20+0,1645,1559,86,C64,6,Mate,White
TRUE,53,30+30,1860,1650,210,B50,4,Resign,White
TRUE,101,15+0,1583,1663,-80,B50,4,Out of Time,White
TRUE,51,30+30,1651,1709,-58,C88,14,Resign,White
TRUE,54,30+30,880,1651,-771,B20,3,Mate,Black
TRUE,159,25+0,1619,1662,-43,B51,5,Mate,White
TRUE,104,30+30,1669,1810,-141,B30,4,Resign,Black
TRUE,77,45+45,1588,1682,-94,E00,4,Resign,White
TRUE,95,15+10,1670,1727,-57,C64,6,Mate,White
TRUE,68,45+45,1606,1651,-45,A20,2,Resign,Black
TRUE,45,20+0,1639,1680,-41,C00,3,Mate,White
TRUE,107,20+20,1626,1705,-79,B54,6,Resign,White
TRUE,46,15+15,1641,1500,141,C66,8,Mate,Black
TRUE,81,45+45,1622,1652,-30,B90,11,Resign,White
TRUE,107,15+5,1653,1643,10,B12,5,Draw,Draw
TRUE,41,15+5,1611,1665,-54,B21,3,Resign,White
TRUE,39,25+0,1653,1706,-53,C60,6,Resign,White
TRUE,119,15+10,1644,1589,55,C78,9,Mate,White
TRUE,84,45+45,1652,1731,-79,C08,8,Resign,Black
TRUE,47,25+8,1662,1663,-1,B20,3,Mate,White
TRUE,113,25+15,1667,1663,4,B96,14,Draw,Draw
TRUE,87,15+10,1655,1553,102,B80,13,Resign,White
TRUE,61,5+5,1653,1222,431,C65,8,Resign,White
TRUE,171,20+5,1547,1667,-120,B57,8,Mate,White
TRUE,53,25+15,1659,1561,98,B06,4,Resign,White
TRUE,71,45+45,1728,1668,60,E01,6,Mate,White
TRUE,107,30+30,1804,1675,129,B90,11,Resign,White
TRUE,32,15+5,1621,1666,-45,B20,3,Resign,Black
TRUE,61,10+3,1659,1547,112,C02,10,Mate,White
TRUE,46,15+0,1543,1651,-108,B90,11,Mate,Black
TRUE,142,20+5,1665,1547,118,C88,13,Resign,Black
TRUE,18,20+5,1555,1658,-103,B22,3,Resign,Black
TRUE,56,45+45,1646,1684,-38,C67,8,Resign,White
TRUE,89,45+45,1711,1655,56,B90,11,Resign,White
TRUE,74,15+15,1606,1645,-39,B20,3,Out of Time,Black
TRUE,66,45+45,1656,1661,-5,C88,14,Resign,Black
TRUE,47,30+30,1558,1670,-112,B54,6,Resign,White
TRUE,67,15+10,1660,1614,46,C65,7,Mate,White
TRUE,54,15+10,1664,1649,15,B20,3,Mate,Black
TRUE,101,30+0,1638,1679,-41,C41,5,Mate,White
TRUE,99,25+0,1629,1566,63,C41,5,Resign,White
TRUE,51,30+30,1623,1428,195,C41,5,Mate,White
TRUE,128,25+0,1565,1614,-49,A45,3,Resign,Black
TRUE,114,30+30,2115,1910,205,B00,2,Resign,Black
TRUE,105,30+30,1891,2106,-215,A01,3,Resign,White
TRUE,54,30+30,1902,1878,24,A40,2,Resign,Black
TRUE,104,30+30,1882,2193,-311,A00,4,Out of Time,Black
TRUE,47,45+45,2006,1890,116,B00,2,Resign,White
TRUE,100,30+30,2047,1872,175,A40,4,Resign,Black
TRUE,49,45+45,1860,1851,9,A00,1,Resign,White
TRUE,121,45+45,1916,1871,45,A40,2,Mate,White
TRUE,102,45+45,1868,1949,-81,A00,1,Draw,Draw
TRUE,36,30+30,1584,1864,-280,A46,3,Resign,Black
TRUE,73,45+45,1928,1875,53,A42,5,Mate,White
TRUE,12,30+30,1882,2046,-164,A04,2,Resign,Black
TRUE,45,45+45,1870,1837,33,B01,4,Resign,White
TRUE,71,30+30,1958,1867,91,A45,2,Draw,Draw
TRUE,88,45+45,1865,1914,-49,B28,5,Draw,Draw
TRUE,112,45+45,1879,1850,29,B22,8,Resign,Black
TRUE,65,30+30,1834,1875,-41,A00,1,Resign,White
TRUE,91,30+30,2100,1840,260,E91,11,Resign,White
TRUE,119,30+30,1817,2050,-233,A00,1,Resign,White
TRUE,102,30+30,1978,2062,-84,B09,11,Resign,Black
TRUE,71,30+30,2057,1782,275,D55,13,Resign,White
TRUE,44,30+30,1770,2053,-283,B08,8,Mate,Black
TRUE,77,30+30,2048,1801,247,E17,13,Resign,White
TRUE,131,30+30,1883,2067,-184,B07,6,Resign,White
TRUE,8,30+0,1866,2088,-222,B07,6,Resign,White
TRUE,102,45+45,1999,2077,-78,B07,6,Resign,Black
TRUE,65,15+5,2070,1910,160,A84,5,Resign,White
TRUE,48,15+5,1816,2064,-248,B08,8,Resign,Black
TRUE,57,15+5,2058,1833,225,D08,7,Resign,White
TRUE,45,10+2,2050,1894,156,D20,5,Resign,White
TRUE,142,15+5,2076,2035,41,B07,6,Mate,Black
TRUE,78,15+5,2056,1873,183,A80,3,Resign,Black
TRUE,26,15+5,1996,2043,-47,D02,5,Resign,Black
TRUE,119,15+5,2049,1895,154,D31,5,Draw,Draw
TRUE,118,15+5,1798,2044,-246,B07,2,Resign,Black
TRUE,58,15+5,2001,2030,-29,B07,4,Resign,Black
TRUE,60,5+5,1980,2017,-37,A03,2,Resign,Black
TRUE,63,5+5,2010,1781,229,A49,5,Out of Time,White
TRUE,87,5+5,1998,1920,78,E20,8,Out of Time,White
TRUE,50,7+2,1684,1993,-309,D02,5,Resign,Black
TRUE,29,7+2,1989,1653,336,D19,15,Resign,White
TRUE,46,7+2,1838,1979,-141,B09,10,Mate,Black
TRUE,41,7+2,1972,1718,254,D31,6,Mate,White
TRUE,103,30+30,2283,2358,-75,B23,4,Draw,Draw
TRUE,109,30+30,2214,2286,-72,A03,2,Draw,Draw
TRUE,92,45+45,2232,2272,-40,C50,8,Resign,Black
TRUE,77,30+30,2264,2082,182,C06,15,Resign,White
TRUE,76,20+20,1826,2262,-436,C26,5,Resign,Black
TRUE,22,60+30,2255,2008,247,C50,6,Resign,White
TRUE,62,30+30,2007,2249,-242,E17,14,Resign,Black
TRUE,70,20+20,1801,2246,-445,E38,8,Resign,Black
TRUE,63,45+45,2239,2401,-162,B23,5,Draw,Draw
TRUE,58,20+20,1471,2239,-768,C53,12,Resign,Black
TRUE,95,45+45,2094,2228,-134,C60,6,Resign,Black
TRUE,109,45+45,2229,2220,9,C54,17,Draw,Draw
TRUE,42,7+30,2162,2214,-52,E11,8,Resign,Black
TRUE,102,7+30,2236,2148,88,B06,2,Resign,Black
TRUE,97,60+30,2268,2254,14,C59,17,Resign,White
TRUE,35,10+0,1787,1862,-75,B96,14,Mate,White
TRUE,44,10+0,1722,1855,-133,B20,3,Resign,Black
TRUE,45,10+0,1871,1866,5,B90,11,Mate,White
TRUE,56,10+0,1876,1913,-37,E67,12,Resign,Black
TRUE,37,30+30,2049,1882,167,B87,14,Mate,White
TRUE,107,10+0,1893,1902,-9,A15,2,Resign,Black
TRUE,118,10+0,1713,1887,-174,B20,3,Mate,Black
TRUE,37,10+0,1882,1683,199,A15,3,Resign,White
TRUE,80,10+0,1822,1872,-50,B50,4,Resign,Black
TRUE,47,10+0,1842,1885,-43,B21,5,Mate,White
TRUE,115,10+0,1878,1720,158,A10,2,Mate,White
TRUE,37,15+15,1890,1866,24,A11,2,Resign,Black
TRUE,82,15+15,1876,1879,-3,A42,5,Resign,Black
TRUE,50,45+45,1267,1616,-349,A16,4,Mate,Black
FALSE,53,15+15,1253,1267,-14,B07,5,Mate,White
FALSE,36,15+15,1267,1253,14,A40,2,Resign,Black
TRUE,100,45+45,1258,1620,-362,A28,6,Draw,Draw
TRUE,59,10+0,1427,1265,162,B07,5,Resign,White
TRUE,43,10+0,1247,1436,-189,A21,3,Mate,White
TRUE,32,10+0,1156,1238,-82,B07,2,Mate,Black
TRUE,36,15+15,1247,1359,-112,A21,4,Resign,Black
TRUE,57,45+45,1550,1250,300,C52,10,Resign,White
TRUE,87,10+10,1261,1461,-200,E20,6,Resign,Black
TRUE,58,10+10,1263,1770,-507,D00,3,Mate,Black
TRUE,53,10+10,1759,1265,494,B07,8,Resign,White
TRUE,11,10+10,1252,1290,-38,A16,4,Resign,White
TRUE,37,10+10,1523,1256,267,C02,5,Mate,White
TRUE,70,45+45,1246,1201,45,B22,3,Resign,White
TRUE,36,10+10,1250,1235,15,B07,4,Mate,Black
TRUE,73,10+10,1222,1262,-40,A10,2,Mate,White
TRUE,25,10+10,1252,1233,19,C01,5,Resign,White
TRUE,43,10+0,1328,1252,76,C00,5,Mate,White
TRUE,9,10+0,1243,1142,101,A20,2,Out of Time,White
TRUE,58,10+10,1237,1231,6,C00,3,Mate,Black
TRUE,37,10+10,1219,1250,-31,A40,4,Resign,White
TRUE,24,10+10,1691,1220,471,A80,2,Resign,White
TRUE,82,10+0,1233,1196,37,A41,2,Mate,Black
TRUE,35,10+0,1219,1286,-67,D00,3,Mate,White
TRUE,109,10+0,1360,1227,133,B07,4,Resign,White
TRUE,78,10+0,1235,1339,-104,D00,3,Mate,Black
